paper_id	affiliations
anguera13_interspeech	['telefonica research, edificio telefonica-diagonal 00, barcelona, spain']
can13_interspeech	['department of computer science and 2department of electrical engineering,', 'university of southern california, los angeles, ca']
katsurada13_interspeech	['toyohashi university of technology, toyohashi, japan', 'aichi prefectural university, nagakute, japan', 'waseda university, tokyo, japan']
mandal13_interspeech	['speech technology and research laboratory, sri international, menlo park, california, usa']
abad13_interspeech	['l2f - spoken language systems laboratory, inesc-id lisboa, portugal', 'gtts, dept. electricity and electronics, university of the basque country upv/ehu, spain']
narumi13_interspeech	['iwate prefectural university, japan', 'tsukuba university, japan', 'national institute of advanced industrial science and technology, japan']
kane13_interspeech	['phonetics and speech laboratory,', 'school of linguistic, speech and communication sciences,', 'trinity college, dublin']
kawahara13_interspeech	['department of design information sciences, wakayama university, japan', 'faculty of engineering, university of yamanashi, japan', 'nara advanced institute of science and technology, japan']
lee13_interspeech	['†department of electrical and electronics engineering, yonsei university, seoul, south korea', '‡microsoft research asia, beijing, china']
ramesh13_interspeech	['department of electronics and electrical engineering,', 'indian institute of technology guwahati, guwahati 781039, india,', 'cen, amrita university, coimbatore']
gowda13_interspeech	['department of signal processing and acoustics, aalto university, finland']
hezard13_interspeech	['institut de recherche et de creation acoustique-musique', '(ircam - cnrs umr 9912 - upmc), paris, france', 'lutherie-acoustique-musique (lam) - institut jean le rond dalembert (ijlra), paris, france']
godoy13_interspeech	['foundation of research and technology hellas, institute of computer science, crete, greece']
jensen13_interspeech	['oticon a/s, smoerum, and aalborg university, aalborg, denmark.', 'leiden university medical center, leiden, the netherlands']
jokinen13_interspeech	['department of signal processing and acoustics, aalto university, espoo, finland']
li13_interspeech	['institute of acoustics, chinese academy of sciences', 'division of speech and hearing sciences, the university of hong kong', 'school of information science, japan advanced institute of science and technology']
hines13_interspeech	['sigmedia, trinity college dublin, ireland', 'google, inc., mountain view, ca, usa']
yuan13_interspeech	['linguistic data consortium, university of pennsylvania']
slaney13_interspeech	['microsoft research, mountain view, ca, usa', 'microsoft online services division, sunnyvale, ca, usa']
gangamohan13_interspeech	['speech and vision laboratory', 'international institute of information technology, hyderabad, india 500032']
morise13_interspeech	['faculty of engineering, university of yamanashi, japan', 'department of design information sciences, wakayama university, japan']
taylor13_interspeech	['school of computing sciences, university of east anglia, norwich, uk']
pohjalainen13_interspeech	['department of signal processing and acoustics, aalto university, espoo, finland']
asgari13_interspeech	['center for spoken language understanding', 'oregon health & science university', 'portland, or, usa']
kane13b_interspeech	['phonetics and speech laboratory,', 'school of linguistic, speech and communication sciences, trinity college dublin, ireland', 'institute for creative technologies, university of southern california, united states']
kasess13_interspeech	['acoustics research institute, austrian academy of sciences, vienna, austria']
geiger13_interspeech	['institute for human-machine communication, technische universitat munchen, germany', 'institute for sensor systems, university of passau, germany']
sasou13_interspeech	['national institute of advanced industrial science and technology, aist, japan']
adiga13_interspeech	['department of electronics and electrical engineering,', 'indian institute of technology guwahati,', 'guwahati 781039, india.']
arya13_interspeech	['indian institute of technology kanpur']
patil13_interspeech	['dhirubhai ambani institute of information and communication technology (da-iict),', 'gandhinagar-382007, india']
satt13_interspeech	"['ibm haifa research lab, israel', 'school of computer science, tel aviv university, israel', 'centre of research & technology – hellas, greece', ""aristotle university of thessaloniki, greek association of alzheimer's disease and related"", 'disorders, greece']"
azarov13_interspeech	['department of computer engineering, belarusian state university', 'of informatics and radioelectronics', ', p.brovky str.', ', minsk, belarus']
babacan13_interspeech	['circuit theory and signal processing laboratory, university of mons, belgium', 'speech and cognition department, gipsa-lab, grenoble, france']
gomezgarcia13_interspeech	['universidad politecnica de madrid, spain', 'universidad nacional de colombia, manizales, colombia.']
cai13_interspeech	['department of communication science and disorders, northeastern university, usa', 'department of speech, language and hearing sciences, boston university, usa', 'nemours biomedical research and department of computer and information sciences,', 'university of delaware, usa']
mirzaei13_interspeech	['department of electrical engineering-esat, ku leuven, belgium', 'department of electrical engineering, amirkabir university of technology, tehran, iran']
liu13_interspeech	['tsinghua national laboratory for information science and technology', 'department of electronic engineering, tsinghua university, beijing 100084, china']
diez13_interspeech	['gtts , department of electricity and electronics, ztf/fct', 'university of the basque country upv/ehu, barrio sarriena', ' leioa, spain']
ma13_interspeech	['raytheon bbn technologies, usa', 'the john hopkins university, usa']
soufifar13_interspeech	['department of electronics and telecommunications, ntnu, trondheim, norway', 'politecnico di torino, italy']
behravan13_interspeech	['school of computing, university of eastern finland, joensuu, finland']
mclaren13_interspeech	['speech technology and research laboratory, sri international, california, usa']
paulik13_interspeech	['cisco systems inc., usa']
gehring13_interspeech	['interactive systems lab, karlsruhe institute of technology; germany', 'language technologies institute, carnegie mellon university; pittsburgh, pa; usa', 'silicon valley campus, carnegie mellon university; usa']
chang13_interspeech	['eecs department, university of california-berkeley, berkeley, ca, usa', 'international computer science institute, berkeley, ca, usa']
yan13_interspeech	['microsoft research asia, beijing, china']
rath13_interspeech	['department of engineering, university of cambridge, trumpington street, cambridge, uk.', 'center for language and speech processing, johns hopkins university, usa.']
vinyals13_interspeech	['international computer science institute, berkeley, california', 'department of electrical engineering and computer science, university of california at berkeley']
braun13_interspeech	['department of phonetics, university of trier, germany']
fox13_interspeech	['department of speech and hearing science, the ohio state university, columbus, oh, usa.']
lienard13_interspeech	['limsi-cnrs, univ. paris sud,  91403 orsay, france']
godoy13b_interspeech	['institute of computer science, foundation of research and technology hellas, crete, greece', 'the centre for speech technology research, university of edinburgh, uk']
motoki13_interspeech	['department of electronics and information engineering, hokkai-gakuen university, japan']
airaksinen13_interspeech	['department of signal processing and acoustics, aalto university, finland', 'speech acoustics laboratory, university of arizona, usa']
schuller13_interspeech	['universite de geneve, swiss center for affective sciences, switzerland', 'imperial college london, department of computing, england', 'tu munchen, machine intelligence & signal processing group, mmk, germany', 'fau erlangen-nuremberg, pattern recognition lab, germany', 'university of glasgow, school of computing science, scotland', 'idiap research institute, martigny, switzerland', 'universite de fribourg, document image and voice analysis group, switzerland', 'universite pierre et marie curie, isir, paris, france']
janicki13_interspeech	['institute of telecommunications, warsaw university of technology', 'ul. nowowiejska 15/19', '-665 warsaw, poland']
oh13_interspeech	['ccrma, department of music, stanford university, stanford, usa', 'department of electrical engineering, stanford university, stanford, usa', 'microsoft research, conversational systems research center, mountain view, usa']
krikke13_interspeech	['human media interaction, university of twente', 'enschede, the netherlands']
wagner13_interspeech	['university of augsburg, lab for human centered multimedia, germany']
gupta13_interspeech	['signal analysis and interpretation lab (sail), department of electrical engineering', 'university of southern california, los angeles, ca']
an13_interspeech	['department of computer science, cuny graduate center, usa', 'department of computer science, queens college (cuny), usa']
bone13_interspeech	['signal analysis and interpretation laboratory (sail), usc, los angeles, ca, usa', 'http://sail.usc.edu']
kirchhoff13_interspeech	['department of electrical engineering', 'university of washington', 'seattle, wa', ', usa']
asgari13b_interspeech	['center for spoken language understanding', 'oregon health & science university', 'portland, or, usa']
martinez13_interspeech	['aragon institute for engineering research (i3a), university of zaragoza, spain', 'advanced technologies application center (cenatav), la habana, cuba']
grezes13_interspeech	['department of computer science, the cuny graduate center, new york, usa', 'departement of linguistics, the cuny graduate center, new york, usa']
sethu13_interspeech	['the school of electrical engineering and telecommunications,', 'the university of new south wales, sydney nsw 2052, australia', 'national ict australia (nicta), australian technology park, eveleigh 1430, australia', 'human language technology, institute for infocomm research (i2r), singapore']
rasanen13_interspeech	['department of signal processing and acoustics, aalto university, finland']
lee13b_interspeech	['research center for information technology innovation, academia sinica', 'graduate institute of communication engineering, national taiwan university', 'department of computer science and engineering, tatung university']
gosztolya13_interspeech	['research group on artificial intelligence, szeged, hungary', 'department of mathematics and computer science, university of marburg, germany']
niebuhr13_interspeech	['department of general linguistics, isfas, christian-albrecht-university, kiel, germany']
mixdorff13_interspeech	['department of computer science and media, beuth university berlin, germany', 'department of general linguistics, isfas, christian-albrecht-university of kiel, germany']
smith13_interspeech	['department of linguistics, university of new mexico, albuquerque, nm, usa']
tsurutani13_interspeech	['school of languages and linguistics, griffith university, brisbane, australia', 'shenzhen institute of information technology, china,']
aalto13_interspeech	['university of helsinki, finland', 'bielefeld university, germany']
zellers13_interspeech	['institutionen for tal, musik & horsel, kungliga tekniska hogskolan, stockholm, sweden']
bissiri13_interspeech	['institut fur akustik und sprachkommunikation, technische universitat dresden, germany', 'institutionen for tal, music & horsel, kungliga tekniska hogskolan, stockholm, sweden']
walsh13_interspeech	['institute for natural language processing, university of stuttgart, germany']
braun13b_interspeech	['department of linguistics, university of konstanz, germany']
correia13_interspeech	['universidade de lisboa, portugal']
arnold13_interspeech	['quantitativ linguistics, university of tubingen, germany', 'faculty of linguistics and literature, university of bielefeld, germany']
pfitzinger13_interspeech	['pfitzinger voice design, lubeck, germany', 'dept. of computer science and media, beuth university, berlin, germany']
barbosa13_interspeech	['speech prosody studies group, dep. of linguistics, state univ. of campinas, brazil', 'dep. of linguistics, philosophy and theory of science, university of gothenburg, sweden']
lyu13_interspeech	['graduate institute of foreign literatures and linguistics, national chiao tung university,', 'hsinchu, taiwan']
tabain13_interspeech	"['la trobe university, melbourne, australia', ""monash university, and murdoch children's research institute, melbourne, australia"", 'flinders university, adelaide, australia']"
mahanta13_interspeech	['department of humanities and social sciences, indian institute of technology guwahati, india']
cruz13_interspeech	['university of lisbon, portugal']
nemoto13_interspeech	['institute of cybernetics at tallinn university of technology, tallinn, estonia', 'lpp cnrs/universite paris 3, paris, france', 'limsi-cnrs, orsay, france']
ashby13_interspeech	['instituto de linguistica teorica e computacional (iltec), lisbon, portugal', 'faculty of letters, eduardo mondlane university, maputo, mozambique']
sahkai13_interspeech	['institute of the estonian language, tallinn, estonia']
kisler13_interspeech	['institute of phonetics and speech processing, munich university, munich, germany']
cunha13_interspeech	['institute of phonetics and speech processing, ludwig-maximilians-university, munich, germany']
meister13_interspeech	['laboratory of phonetics and speech technology', 'institute of cybernetics at tallinn university of technology, estonia']
meynadier13_interspeech	['aix-marseille universite, cnrs umr 7309, lpl, aix-en-provence, france']
reichel13_interspeech	['institute of phonetics and speech processing, university of munich']
andreeva13_interspeech	['computational linguistics & phonetics, saarland university, germany', 'department for language and communication studies, ntnu, norway']
promon13_interspeech	"[""department of computer engineering, king mongkut's university of technology thonburi, thailand"", 'department of speech, hearing and phonetic sciences, university college london, united kingdom', 'department for phoniatrics, pedaudiology and communication disorders, university hospital aachen and', 'rwth aachen university, germany']"
kiss13_interspeech	['center for spoken language understanding, oregon health and science university']
sung13_interspeech	['school of electrical engineering and inmc,', 'seoul national university, korea']
takamichi13_interspeech	['† graduate school of information science, nara institute of science and technology,', '–5 takayama-cho, ikoma, nara', '-0192, japan', '‡ national institute of information and communications technology,', '–5 hikari–dai, seika–cho, soraku–gun, kyoto', '–0289, japan.']
nakashika13_interspeech	['graduate school of system informatics, kobe university', '-1 rokkodai, kobe, japan', 'organization of advanced science and technology, kobe university', '-1 rokkodai, kobe, japan']
silen13_interspeech	['department of signal processing, tampere university of technology, finland']
nose13_interspeech	['interdisciplinary graduate school of science and engineering,', 'tokyo institute of technology, yokohama', '-8502, japan']
hinterleitner13_interspeech	['quality and usability lab, tu berlin, germany', 'digital signal processing and system theory, cau kiel, germany']
nurminen13_interspeech	['department of signal processing, tampere university of technology, finland']
huckvale13_interspeech	['department of speech, hearing and phonetics, university college london, uk', 'department of mental health sciences, university college london, uk']
muthukumar13_interspeech	['language technologies institute, carnegie mellon university,pittsburgh, usa', 'nemours biomedical research wilmington, usa']
hovy13_interspeech	"['clt, university of copenhagen, denmark', 'language technologies institute, cmu, pittsburgh, pa', 'inesc-id/ist lisboa, portugal', ""usc's viterbi school of engineering, los angeles, ca""]"
mcloughlin13_interspeech	['national engineering laboratory on speech and language information processing', 'the university of science and technology of china, hefei, china']
niekerk13_interspeech	['centre for text technology, north-west university, potchefstroom, south africa', 'multilingual speech technologies, north-west university, vanderbijlpark, south africa']
azarov13b_interspeech	['computer engineering department, belarusian state university of informatics and radioelectronics,', ', p.brovky str.', ', minsk, belarus']
krityakien13_interspeech	['graduate school of information science and technology, university of tokyo, japan', 'graduate school of engineering, university of tokyo, japan']
chen13_interspeech	['toshiba research europe ltd., cambridge, uk']
nakajima13_interspeech	['ntt media intelligence labs., ntt corporation, yokosuka, kanagawa, japan']
ni13_interspeech	['spoken language communication laboratory, universal communication research institute', 'national institute of information and communications technology, kyoto, japan']
kobayashi13_interspeech	['graduate school of information science, nara institute of science and technology (naist), japan1', 'national institute of advanced industrial science and technology (aist), japan2']
bollepalli13_interspeech	['department of speech, music and hearing, kth, stockholm, sweden', 'department of signal processing and acoustics, aalto university, espoo, finland']
doi13_interspeech	['graduate school of information science,', 'nara institute of science and technology, nara, japan', 'national institute of advanced industrial science and technology (aist), ibaraki, japan']
koriyama13_interspeech	['interdisciplinary graduate school of science and engineering', 'tokyo institute of technology, japan']
mohammadi13_interspeech	['ozyegin university, istanbul, turkey']
cabral13_interspeech	['school of computer science and informatics, university college dublin, ireland']
tran13_interspeech	['international research institute mica, hust - cnrs/umi2954 - grenoble inp, hanoi', 'university of sciences and technology, hanoi, vietnam', 'laboratoire dynamique du langage - universite de lyon 2 - cnrs/urm5596 - lyon, france']
candea13_interspeech	['ea 1483 - clesthia, sorbonne nouvelle university, paris, france', 'umr 7018 - lpp, cnrs/sorbonne nouvelle university, paris, france', 'upr 3251 - limsi, cnrs, orsay, france']
zimmerer13_interspeech	['institute of phonetics, goethe-university, frankfurt, germany', 'institute of phonetics, saarland university, saarbrucken, germany', 'graduate school of language and culture, osaka university, japan']
plummer13_interspeech	['dept. of linguistics, the ohio state university, columbus, oh, usa', 'departement de linguistique, universite du quebec a montreal, montreal, canada', 'dept. of speech-language-hearing sciences, university of minnesota, minneapolis, mn, usa']
babel13_interspeech	['department of linguistics, university of british columbia, vancouver, british columbia', 'department of linguistics, university of california at santa cruz, santa cruz, california']
wang13_interspeech	['school of foreign languages, shenzhen university, shenzhen, p.r. china', 'phonetics laboratory, leiden university centre for linguistics, leiden, the netherlands']
lu13_interspeech	['national institute of information and communications technology, japan', 'research center for information technology innovation, academic sinica, taiwan']
saruwatari13_interspeech	['nara institute of science and technology, nara', '-0192 japan', 'yamaha corporate research & development center, shizuoka', '-0192 japan']
lyubimov13_interspeech	['moscow state university, moscow, russia', 'stel - computer systems ltd., moscow, russia']
tseng13_interspeech	['university of minnesota, minneapolis, usa', 'starkey hearing technologies, eden prairie, usa', 'nanjing university, nanjing, china']
mirbagheri13_interspeech	['institute for system research, university of maryland college park, usa', 'department of electrical and computer engineering, university of maryland college park, usa']
mccallum13_interspeech	['department of electrical and computer engineering', 'the university of auckland, auckland, new zealand']
knuuttila13_interspeech	['department of signal processing and acoustics, school of electrical engineering,', 'aalto university, espoo, finland']
daubigney13_interspeech	['ims-malis – supelec (metz, france)', 'umi 2958 – georgiatech/cnrs (metz, france)', 'team project maia – loria (nancy, france)']
lison13_interspeech	['language technology group, department for informatics, university of oslo, norway']
ghigi13_interspeech	['dpto. electricidad y electronica. universidad del pais vasco, spain', 'instituto tecnologico de informatica. universitat politecnica de valencia, spain']
chen13b_interspeech	['school of computer science, carnegie mellon university', 'forbes ave., pittsburgh, pa 15213, usa']
su13_interspeech	['# graduate institute of communication engineering, national taiwan university', '∗graduate institute of electrical engineering, national taiwan university']
hahn13_interspeech	['human language technology and pattern recognition,', 'computer science department, rwth aachen university, aachen, germany', 'spoken language processing group, limsi cnrs, paris, france']
do13_interspeech	['school of computer engineering, nanyang technological university, singapore', 'institute for infocomm research, a*star, singapore']
rasipuram13_interspeech	['idiap research institute, ch-1920 martigny, switzerland', 'ecole polytechnique federale de lausanne (epfl), ch-1015 lausanne, switzerland']
motlicek13_interspeech	['idiap research institute, martigny, switzerland', 'ecole polytechnique federale, lausanne (epfl), switzerland']
vu13_interspeech	['institute for anthropomatics, karlsruhe institute of technology (kit)']
rosenberg13_interspeech	['computer science department, queens college cuny, nyc, usa']
schweitzer13_interspeech	['institute for natural language processing (ims), university of stuttgart, germany']
pardo13_interspeech	['department of psychology, montclair state university, new jersey, united states']
wodarczak13_interspeech	['faculty of linguistics and literary studies', 'bielefeld university, germany']
bonin13_interspeech	['trinity college dublin, dublin 2, ireland', 'university of glasgow, school of computing science, g128qq glasgow, uk', 'idiap research institute, cp592', ' martigny, switzerland']
kim13_interspeech	['the marcs institute, university of western sydney, australia']
podlipsky13_interspeech	['department of english and american studies, palacky university, olomouc, czech republic', 'amsterdam center for language and communication, university of amsterdam, the netherlands']
hsieh13_interspeech	['graduate institute of linguistics, national tsing hua university, taiwan']
hoffmann13_interspeech	['chair for system theory and speech technology, tu dresden, dresden, germany']
kohtz13_interspeech	['department of general linguistics, isfas, christian-albrechts-universitat zu kiel, germany']
wang13b_interspeech	['school of computer science and technology, tianjin university, tianjin, china', 'school of information science, japan advanced institute of science and technology, japan', 'tianjin key laboratory of cognitive computing and application, tianjin university, china']
hirst13_interspeech	['laboratoire parole et langage, umr 7309 cnrs, aix-marseille university, france', 'school of foreign languages, tongji university, shanghai, china']
proctor13_interspeech	['school of humanities and communications arts, university of western sydney, australia', 'department of linguistics, university of southern california, usa', 'viterbi school of engineering, university of southern california, usa', 'http://sail.usc.edu/span']
huckvale13b_interspeech	['dept. of speech, hearing and phonetic sciences, university college london, london, uk.']
lucero13_interspeech	['department of computer science, university of brasilia, brasilia df 70910-900, brazil', 'laboratories of images, signal and acoustics, universite libre de bruxelles,', 'faculty of applied sciences', ', av. f d. roosevelt, b-1050, brussels, belgium', 'center for voice studies, r machado bittencourt 361, sao paulo 04044-001, brazil']
dapolito13_interspeech	['universita del salento – cril (centro di ricerche interdisciplinare del linguaggio), lecce, italy']
samlowski13_interspeech	['faculty of linguistics and literary studies, bielefeld university, germany', 'department of computational linguistics and phonetics, saarland university, germany']
lancia13_interspeech	['department of linguistics, max planck institute for evolutionary anthropology, leipzig,', 'germany']
rusaw13_interspeech	['department of linguistics, university of illinois at urbana-champaign, usa']
wong13_interspeech	['department of linguistics', 'department of electrical and computer engineering,', 'department of bioengineering, university of illinois at urbana-champaign']
fujimoto13_interspeech	['national institute for japanese language and linguistics, tokyo, japan', 'faculty of intelligence and informatics, konan university, kobe, japan', 'department of mechanical systems engineering, takushoku university, hachioji, japan']
lammert13_interspeech	['university of southern california, los angeles, ca, usa)', 'university of western sydney, penrith, nsw, australia']
hsieh13b_interspeech	['department of linguistics, university of southern california, usa', 'viterbi school of engineering, university of southern california, usa']
yang13_interspeech	['signal analysis and interpretation lab (sail), university of southern california, los angeles, ca', 'department of linguistics, university of southern california, los angeles, ca']
yamakawa13_interspeech	['department of human informatics, aichi shukutoku university, japan']
drozdova13_interspeech	['centre for language and speech technology, radboud university, nijmegen, the netherlands']
signorello13_interspeech	['grenoble alps university, gipsa-lab, grenoble, france', 'educational department, roma tre university, rome, italy']
rose13_interspeech	['waseda university faculty of science and engineering, tokyo japan']
preu13_interspeech	['clinic of phoniatrics, pedaudiology, and communication disorders,', 'university hospital aachen and rwth aachen university, aachen, germany']
siddins13_interspeech	['institute of phonetics and speech processing, ludwig-maximilians-universitat munich, germany']
ding13_interspeech	['school of foreign languages, tongji university, china', 'laboratory of acoustics and speech communication, tu dresden, germany']
richmond13_interspeech	['centre for speech technology research, informatics, university of edinburgh, edinburgh, uk', 'national engineering laboratory of speech and language information processing,', 'university of science and technology of china, hefei, p.r.china']
gupta13b_interspeech	['centre de recherche informatique de montreal (crim)']
stein13_interspeech	['fraunhofer iais, schloss birlinghoven, germany']
shi13_interspeech	['intelligent system department, delft university of technology, netherlands', 'create-it applied research, amsterdam university of applied sciences, netherlands']
torbati13_interspeech	['department of electrical and computer engineering, temple university, philadelphia, usa', 'department of statistics, temple university, philadelphia, usa']
georges13_interspeech	['nuance communications, mobile r&d research, aachen,germany', 'spoken language systems, saarland university, saarbrucken, germany']
kubo13_interspeech	['ntt communication science laboratories, ntt corporation, kyoto 619–0237, japan']
jouvet13_interspeech	['speech group, loria', 'inria, villers-les-nancy, f-54600, france', 'universite de lorraine, loria, umr 7503, villers-les-nancy, f-54600, france', 'cnrs, loria, umr 7503, villers-les-nancy, f-54600, france']
siohan13_interspeech	['google inc., new york']
lei13_interspeech	['google inc., mountain view, ca usa', 'google inc., new york, ny usa']
allauzen13_interspeech	['google research', ' ninth avenue, new york, ny, usa']
kurniawati13_interspeech	['stmicroelectronics asia pacific pte. ltd.']
sak13_interspeech	['google']
versteegh13_interspeech	['international max planck research school for language sciences, nijmegen', 'centre for language studies, radboud university nijmegen, the netherlands']
burlick13_interspeech	['computer vision laboratory, stevens institute of technology, hoboken, nj, usa.', 'at&t labs - research, florham park, nj, usa.']
geiger13b_interspeech	['institute for human-machine communication, technische universitat munchen, germany', 'multimedia communications department, eurecom, sophia antipolis, france', 'institute for sensor systems, university of passau, germany']
ye13_interspeech	['national institute of advanced industrial science and technology (aist), japan']
chung13_interspeech	['electronics and telecommunications research institute, daejeon, korea']
segbroeck13_interspeech	['signal analysis and interpretation lab,', 'university of southern california, los angeles, usa']
graciarena13_interspeech	['speech technology and research laboratory, sri international, menlo park, ca, usa', 'international computer science institute (icsi), berkeley, ca, usa', 'center for robust speech systems (crss), u.t. dallas, richardson, tx, usa', 'speech processing and auditory perception lab., univ. of california, los angeles, ca, usa', 'labrosa, columbia university, ny, usa']
coz13_interspeech	['irit - 118, route de narbonne - 31062 toulouse cedex 9, france']
tsiartas13_interspeech	['signal analysis and interpretation lab, ming hsieh electrical engineering,', 'university of southern california, los angeles ,usa', 'ibm research india, new delhi, india', 'ece department, technical university of crete, chania, greece']
lezzoum13_interspeech	['ecole de technologie superieure', ' notre dame west, montreal (qc) h3c 1k3 canada']
ryant13_interspeech	['linguistic data consortium, pa, usa']
germain13_interspeech	['center for computer research in music and acoustics, stanford university, ca 94305', 'department of statistics, stanford university, stanford, ca', 'adobe research, san francisco, ca 94103']
tsai13_interspeech	['eecs department, university of california at berkeley, berkeley, ca, usa', 'international computer science institute, berkeley, ca usa']
kanai13_interspeech	['school of information science, japan advanced institute of science and technology']
almoubayed13_interspeech	['department of speech, music and hearing', 'kth royal institute of technology, stockholm, sweden']
gelin13_interspeech	['a-lab, aldebaran robotics, paris, france']
hueber13_interspeech	['gipsa-lab, umr 5216/cnrs/inp/ujf/u.stendhal, grenoble, france']
oh13b_interspeech	['ccrma, department of music, stanford university, stanford, usa']
bikel13_interspeech	['google research, new york, ny']
sosi13_interspeech	['fondazione bruno kessler, center for information and communication technology', 'via sommarive 18', ' povo, italy']
meltzner13_interspeech	['bae systems, inc.  burlington, ma, usa', 'massachusetts general hospital department of surgery, boston, ma, usa']
scobbie13_interspeech	['casl research centre, queen margaret university, edinburgh, scotland, uk', 'linguistics and english language, university of edinburgh, scotland, uk', 'department linguistik, universitat potsdam, germany', 'cstr, university of edinburgh, scotland, uk']
sityaev13_interspeech	['angel incorporated, united states of america']
ouni13_interspeech	['universite de lorraine, loria, umr 7503,vandoeuvre-les-nancy, f-54500, france']
soury13_interspeech	['limsi-cnrs', 'universite paris xi orsay', 'universite sorbonne nouvelle - paris 3', 'universite paris sorbonne - paris 4', 'france']
schleicher13_interspeech	['reichmuth, sebastian moller', 'quality and usability lab, telekom innovation laboratories, tu berlin, germany']
metze13_interspeech	['language technologies institute, carnegie mellon university, pittsburgh, pa; u.s.a.', 'dept. of computer science and engineering, the ohio state university, columbus, oh; u.s.a.', 'computer science department, minnesota state university, mankato, mn; u.s.a.']
chen13c_interspeech	['at&t labs - research', 'park avenue, florham park, nj 07932, usa']
ferragne13_interspeech	['clillac-arp, ea 3967, universite paris 7, france', 'laboratoire dynamique du langage, umr 5596, cnrs – universite de lyon, france']
burkhardt13_interspeech	['deutsche telekom laboratories, berlin, germany']
novak13_interspeech	['department of computer science, university of illinois at chicago, chicago il, usa', 'department of communication, university of illinois at chicago, chicago il, usa', 'communication disorders and sciences, rush university medical center, chicago il, usa']
mowlaee13_interspeech	['† signal processing and speech communication laboratory,', 'graz university of technology, graz, austria', '‡ centre for language and speech technology, radboud university nijmegen, the netherlands']
hirano13_interspeech	['‡ northeast normal university, jilin, china', '† the university of tokyo, tokyo, japan', '∗waseda university, tokyo, japan', '⋆tokyo university of foreign studies, tokyo, japan']
astrinaki13_interspeech	['circuit theory and signal processing lab, university of mons, belgium', 'the centre for speech technology research, university of edinburgh, edinburgh, uk', 'national institute of informatics, tokyo, japan']
berkling13_interspeech	['department of computer science,', 'baden-wurttemberg cooperative state university, karlsruhe (germany)']
clark13_interspeech	['the', 'simple4all project', 'consortium', 'www.simple4all.org', 'copyright © 2013 isca', '-29 august 2013, lyon, france', 'interspeech 2013: show & tell contribution']
pointeau13_interspeech	['robot cognition laboratory', 'inserm stem cell and brain research institute, lyon, france']
miyakoda13_interspeech	['department of english, tsuda college, tokyo, japan']
azarov13c_interspeech	['computer engineering department, belarusian state university of informatics and radioelectronics,', ', p.brovky str.', ', minsk, belarus']
csala13_interspeech	['department of telecommunications and media informatics', 'budapest university of technology and economics, budapest, hungary']
wan13_interspeech	['toshiba research europe limited, cambridge research laboratory, cambridge, uk', 'department of engineering, university of cambridge, cambridge, uk', 'corporate research and development center, toshiba corporation, kawasaki, japan']
maddieson13_interspeech	['department of linguistics, university of new mexico, albuquerque, nm, usa', 'laboratoire dynamique du langage, cnrs – universite de lyon, lyon, france']
boyce13_interspeech	['department of comm. sciences and disorders, university of cincinnati, cincinnati, oh, usa', 'speech technology and applied research corporation, bedford, ma, usa']
catanese13_interspeech	['inria centre de rennes - bretagne atlantique – campus de beaulieu', ' rennes, france', 'irisa/cnrs umr 6074 – campus de beaulieu', ' rennes, france', 'inria nancy - grand est', ' villers-les-nancy, france']
eriksson13_interspeech	['department of philosophy, linguistics and theory of science, university of gothenburg, sweden', 'speech prosody studies group, department of linguistics, state university of campinas, brazil']
michelas13_interspeech	['aix-marseille universite, cnrs, lpl, umr 7309, aix-en-provence, france']
ishimoto13_interspeech	['department of corpus studies, national institute for japanese language and linguistics, tokyo, japan', 'school of media science, tokyo university of technology, tokyo, japan']
simard13_interspeech	['department of linguistics, school of oriental and african studies, london, united kingdom']
vullinghs13_interspeech	['tilburg center for cognition and communication (ticc), school of humanities,', 'tilburg university, the netherlands']
kousidis13_interspeech	['dialogue systems group, bielefeld university, germany', 'general linguistics group, bielefeld university, germany']
grais13_interspeech	['faculty of engineering and natural sciences', 'sabanci university, orhanli tuzla', ', istanbul, turkey.']
kim13b_interspeech	['korea advanced institute of science and technology (kaist), south korea', '∗2ulsan national institute of science and technology (unist), south korea', 'mokwon university, south korea']
tran13b_interspeech	['institute for telecommunications research, university of south australia']
kinoshita13_interspeech	['ntt communication science laboratories, ntt corporation, japan']
barker13_interspeech	['department of signal processing, tampere university of technology, finland']
watanabe13_interspeech	['signal processing and speech communication laboratory', 'graz university of technology, graz, austria']
yao13_interspeech	['department of media science, graduate school of nagoya university, nagoya-shi, aichi, japan', 'department of media informatics, aichi university of technology, gamagori-shi, aichi, japan']
rakov13_interspeech	['linguistics department, the graduate center cuny, new york, usa', 'computer science department, queens college cuny, new york, usa']
scherer13_interspeech	['university of southern california,', 'institute for creative technologies, los angeles']
pellegrini13_interspeech	['inesc-id, lisbon, portugal', 'microsoft language development center, portugal / microsoft / adetti-iscte, iul, portugal', 'limsi-cnrs, france - 4microsoft / university of washington', 'instituto superior tecnico, portugal - 6instituto de telecomunicac˜oes, portugal']
cummins13_interspeech	['school of elec. eng. and telecomm., the university of new south wales, sydney australia', 'atp research laboratory, national ict australia (nicta), australia', 'black dog institute and school of psychiatry, the university of new south wales, australia', 'division of mental health research, queensland institute of medical research, australia', 'faculty of education, science, technology and mathematics, university of canberra, australia']
perezrosas13_interspeech	['computer science and engineering', 'university of north texas, denton, tx']
shepstone13_interspeech	['bang and olufsen a/s,', 'peter bangs vej 15', ' struer, denmark', 'department of electronic systems, aalborg university,', 'niels jernes vej 12', ' aalborg, denmark']
malandrakis13_interspeech	['signal analysis and interpretation laboratory (sail), usc, los angeles, ca 90089, usa', 'audyssey laboratories, los angeles, ca 90071, usa', 'dept. of ece, technical univ. of crete', ' chania, greece']
jeon13_interspeech	['department of computer science', 'the university of texas at dallas, richardson, tx, usa']
han13_interspeech	['⋆school of computer science and technology, harbin institute of technology, harbin, china', '§ department of computer science and technology, tsinghua university, beijing, china', '‡ school of humanities and social sciences, harbin institute of technology, harbin, china', '† machine intelligence & signal processing group, mmk,', 'technische universitat munchen, munchen, germany', '+ department of computing, imperial college london, london, u k.']
kelly13_interspeech	['department of electronic & electrical engineering, trinity college dublin, ireland']
alam13_interspeech	['department of information engineering and computer science, university of trento, italy']
zhang13_interspeech	['machine intelligence & signal processing group, mmk,', 'technische universitat munchen, germany', 'institute for sensor systems, university of passau, germany']
xiao13_interspeech	['sail, dept. electrical engineering, university of southern california, u.s.a.', 'dept. educational psychology, university of utah, u.s.a.', 'dept. psychiatry & behavioral sciences, university of washington, u.s.a.']
miyazaki13_interspeech	['ntt media intelligence laboratories', '-1 hikarinooka, yokosuka, kanagawa, japan']
arias13_interspeech	['speech processing and transmission laboratory, dept. of electrical engineering,', 'universidad de chile, santiago, chile', 'multimodal signal processing (msp) laboratory, dept. of electrical engineering,', 'the university of texas at dallas, richardson, tx 75080, usa']
mishra13_interspeech	['at&t labs research', ' park ave, florham park, new jersey 07932']
hanilci13_interspeech	['department of electronic engineering, uludag university', ', bursa, turkey', 'school of computing, university of eastern finland, joensuu, finland', 'department of signal processing and acoustics, aalto university, espoo, finland']
abdelaziz13_interspeech	['institute of communication acoustics, digital signal processing group,', 'ruhr-universitat bochum, germany']
gibson13_interspeech	['panayiotis georgiou, and shrikanth narayanan', 'signal and image processing institute, university of southern california, los angeles, ca']
xiao13b_interspeech	['school of computer engineering, nanyang technological university, singapore', 'department of human language technology, institute for infocomm research, singapore']
joshi13_interspeech	['department of electrical engineering, indian institute of technology, madras', 'ibm india research labs, bangalore']
mitra13_interspeech	['speech technology and research laboratory, sri international, menlo park, ca, usa.']
alam13b_interspeech	['inrs-emt, university of quebec, montreal (qc), canada', 'crim, montreal (qc), canada']
lu13b_interspeech	['centre for speech technology research, university of edinburgh, edinburgh, uk']
saon13_interspeech	['ibm t j. watson research center, yorktown heights, ny']
sehr13_interspeech	['department vii, beuth university of applied sciences berlin, germany', 'ntt communication science laboratories, kyoto, japan', 'multimedia communications and signal processing,', 'university of erlangen-nuremberg, erlangen, germany']
wolf13_interspeech	['talp research center, department of signal theory and communications', 'universitat politecnica de catalunya (upc), barcelona, spain']
ishii13_interspeech	['division of information sciences, graduate school of advanced integration science,', 'chiba university, chiba, japan', 'department of information processing,', 'interdisciplinary graduate school of science and engineering,', 'tokyo institute of technology, tokyo, japan']
maymon13_interspeech	['ibm t.j. watson research center, yorktown heights, ny, usa']
kao13_interspeech	['department of computer science and information engineering,', 'national taiwan normal university, taipei, taiwan']
liu13b_interspeech	['school of computing, national university of singapore, singapore']
li13b_interspeech	['shenzhen institutes of advanced technology, chinese academy of sciences /the chinese', 'university of hong kong, hong kong, china', 'cambridge university engineering dept, trumpington st., cambridge, cb2 1pz u.k.']
brakel13_interspeech	['department of electronics and information systems, ghent university, ghent, belgium']
variani13_interspeech	['johns hopkins university', 'center for language and speech processing', 'human language technology center of excellence', 'baltimore, md']
fujimoto13b_interspeech	['ntt communication science laboratories, ntt corporation, japan']
nathwani13_interspeech	['department of electrical engineering,', 'indian institute of technology kanpur, india']
delcroix13_interspeech	['ntt communication science laboratories, ntt corporation,', '-4, hikaridai, seika-cho (keihanna science city), soraku-gun, kyoto 619-0237 japan']
hsieh13c_interspeech	['national chi nan university, taiwan', 'national taiwan normal university, taiwan']
li13c_interspeech	['school of computing, computing 1, national university of singapore, singapore', 'research center for information technology innovation (citi), academia sinica, taipei, taiwan']
remes13_interspeech	['department of information and computer science, aalto university school of science, finland']
cui13_interspeech	['ibm t j. watson research center, yorktown heights, ny 10598, usa']
liu13c_interspeech	['center for robust speech systems, university of texas at dallas, richardson, texas 75083', 'at&t research', ' park ave, florham park, new jersey 07932']
poblete13_interspeech	['speech processing and transmission laboratory, universidad de chile, santiago, chile', 'department of electrical and computer engineering, and language technologies institute,', 'carnegie mellon university, pittsburgh, pa 15213, usa', 'institute of acoustics, universidad austral de chile, valdivia, chile']
sadakata13_interspeech	['radboud university nijmegen, donders institute for brain, cognition and behaviour, the', 'netherlands', 'division of cognitive psychology, kumamoto university, japan']
bedoin13_interspeech	['laboratoire dynamique du langage, umr 5596, cnrs – universite de lyon, france', 'clillac-arp, ea 3967, universite paris 7, france', 'paris-diderot.fr']
bellier13_interspeech	['dycog team, lyon neuroscience research center, france', 'department of audiology, hospices civils de lyon, france']
manca13_interspeech	"[""dipartimento di storia, societa e studi sull'uomo, university of salento (lecce), italy"", 'centro di ricerca interdisciplinare sul linguaggio (cril), university of salento (lecce), italy']"
grohe13_interspeech	['department of linguistics, university of konstanz']
evans13_interspeech	['eurecom, sophia antipolis, france', 'university of eastern finland, finland', 'university of edinburgh, uk', 'national institute of informatics, japan']
hautamaki13_interspeech	['school of computing, university of eastern finland, joensuu, finland', 'speech and voice research laboratory, school of education, university of tampere, finland']
gomezbarrero13_interspeech	['atvs biometric recognition group, c/ francisco tomas y valiente 11,', 'universidad autonoma de madrid', ' madrid, spain']
alegre13_interspeech	['multimedia communications department, eurecom, sophia antipolis, france', 'nuance communications, cambridge, uk']
kons13_interspeech	['ibm research - haifa, haifa, israel']
wu13_interspeech	['school of computer engineering, nanyang technological university, singapore', 'human language technology department, institute for infocomm research, singapore', 'school of computing, university of eastern finland, finland']
sperber13_interspeech	['karlsruhe institute of technology, institute for anthropomatics, germany', 'nara institute of science and technology, ahc laboratory, japan', 'mobile technologies gmbh, germany']
kim13c_interspeech	['dsp lab., yonsei university, seoul, korea', 'sail lab., university of southern california, los angeles, usa']
higashinaka13_interspeech	['† ntt media intelligence laboratories', '‡ ntt communication science laboratories']
arimoto13_interspeech	['okanoya emotional information project, jst, erato, saitama', 'brain science institute, riken, saitama', 'graduate school of arts and sciences, the university of tokyo, tokyo']
wechsung13_interspeech	['quality & usability lab, tu berlin, deutsche telekom innovation laboratories, berlin, germany', 'potsdam institute for climate impact research, potsdam, germany']
riccardi13_interspeech	['disi - university of trento', ' povo (trento), italy']
fox13b_interspeech	['department of computer science, university of sheffield, sheffield, s1 4dp, uk', 'centre for speech technology research, university of edinburgh, edinburgh, eh8 9ab, uk', 'eads iw, appleton tower, edinburgh, eh8 9le, uk']
kumar13_interspeech	['human-computer interaction institute, carnegie mellon university, pittsburgh, pa, usa', 'language technologies institute, carnegie mellon university, pittsburgh, pa, usa', 'american institutes for research, washington, d.c., usa']
moubayed13_interspeech	['kth speech, music and hearing, sweden']
galibert13_interspeech	"[""laboratoire national de metrologie et d'essais, trappes, france""]"
sangwan13_interspeech	['center for robust speech systems (crss), the university of texas at dallas,', 'richardson, tx, u.s.a.', 'college of information studies and umiacs, university of maryland,', 'college park, md, u.s.a.']
matousek13_interspeech	['dept. of cybernetics, faculty of applied sciences, university of west bohemia, czech rep.']
ahmed13_interspeech	['tcs innovation labs - mumbai, yantra park, thane (west), maharashtra, india']
hoffmann13b_interspeech	['speech processing group, eth zurich, switzerland']
stan13_interspeech	['communications department, technical university of cluj-napoca, romania', 'centre for speech technology research, university of edinburgh, united kingdom', 'national institute of informatics, japan']
sapru13_interspeech	['idiap research institute', ', martigny, switzerland', 'ecole polytechnique federale de lausanne, lausanne, switzerland']
draxler13_interspeech	['institute of phonetics and speechprocessing,', 'ludwig-maximilian university munich, germany', 'bavarian state criminal police office, munich, germany']
hofe13_interspeech	['department of computer science, the university of sheffield, sheffield, uk', 'hull and east yorkshire hospitals trust, castle hill hospital, cottingham, uk', 'department of engineering, university of hull, kingston upon hull, uk']
andrademiranda13_interspeech	['circuits and systems engineering department, universidad politecnica de madrid, ctra. de', 'valencia, km. 7', ' madrid, spain']
bocklet13_interspeech	['chair of pattern recognition, friedrich-alexander-university erlangen-nuremberg, erlangen, germany', 'ece, faculty of engineering, king abdulaziz university, jeddah 21589, saudi arabia', 'knappschaftskrankenhaus bochum, bochum, germany']
orosanu13_interspeech	['speech group, loria', 'inria, villers-les-nancy, f-54600, france']
christensen13_interspeech	['computer science, university of sheffield, sheffield, united kingdom']
lopezludena13_interspeech	['speech technology group. e.t.s.i. telecomunicacion. upm.', 'grupo de sistemas inteligentes aplicados, dpto. de tecnologias y sistemas de informacion. uclm.', 'fundacion para la supresion de la barreras de comunicacion. fundacion cnse']
vaerenberg13_interspeech	['the eargroup, antwerp-deurne, belgium', 'laboratory of biomedical physics, university of antwerp, belgium', 'cls/clst, radboud university nijmegen, the netherlands', 'liacs, leiden university, the netherlands', 'vrije universiteit amsterdam, the netherlands', 'karel de grote hogeschool, antwerp, belgium']
hammer13_interspeech	['paul govaerts2', 'applied linguistics, vu university amsterdam, the netherlands', 'the eargroup, deurne-antwerpen, belgium', 'leiden institute for advanced computer science, the netherlands', 'department of linguistics, radboud university, nijmegen, the netherlands', 'laboratory of biomedical physics, university of antwerp, belgium']
lopezludena13b_interspeech	['speech technology group. e.t.s.i. telecomunicacion. upm.', 'fundacion para la supresion de la barreras de comunicacion. fundacion cnse']
kim13d_interspeech	['department of electrical engineering', 'korea advanced institute of science and technology (kaist), daejeon, republic of korea']
muhammad13_interspeech	['department of computer engineering, college of computer and information sciences,', 'king saud university, riyadh 11543, saudi arabia']
kacha13_interspeech	['laboratoire de physique de rayonnement et applications, university of jijel, algeria', 'laboratory list, universite libre de bruxelles, brussels, belgium', 'national fund for scientific research, belgium']
aihara13_interspeech	['graduate school of system informatics, kobe university, japan']
christensen13b_interspeech	['department of computer science, university of sheffield, sheffield, s1 4dp, uk', 'centre for speech technology research, university of edinburgh, edinburgh, eh8 9ab, uk']
mai13_interspeech	['language engineering laboratory, department of electronic engineering, the chinese university', 'of hong kong, hong kong']
schwenk13_interspeech	['lium, university of le mans, france']
shi13b_interspeech	['online service division, microsoft, china', 'intelligent systems department, delft university of technology, netherlands']
chang13b_interspeech	['microsoft corporation, sunnyvale, california']
kobayashi13b_interspeech	['nhk (japan broadcasting corporation)', 'science & technology research laboratories, tokyo, japan']
dikici13_interspeech	['department of electrical and electronics engineering, bogazici university, istanbul, turkey', 'department of computer science, university of rochester, rochester, ny, usa', 'center for spoken language understanding, oregon health & science university, portland, or, usa']
oba13_interspeech	['ntt media intelligence laboratories, ntt corporation, yokosuka, japan', 'ntt communication science laboratories, ntt corporation, kyoto, japan']
rath13b_interspeech	['department of engineering, university of cambridge, trumpington street, cambridge, uk.']
wang13c_interspeech	['engineering department, cambridge university', 'trumpington st. cambridge university, cb2 1pz, u.k.']
saz13_interspeech	['speech and hearing group, university of sheffield, sheffield uk']
yu13_interspeech	['institute of intelligent human-machine interaction', 'moe-microsoft key lab. of intelligent computing and intelligent systems', 'department of computer science and engineering', 'shanghai jiao tong university', ', shanghai, p r. china']
abdelhamid13_interspeech	['department of computer science and engineering', 'york university, toronto, ontario, canada']
kintzley13_interspeech	['dept. of electrical and computer engineering', 'hlt center of excellence', 'johns hopkins university, baltimore, maryland, usa']
gregory13_interspeech	['linguistics, school of humanities, la trobe university, melbourne, australia', 'department of communication disorders, university of canterbury, christchurch, new zealand']
yang13b_interspeech	['department of speech and hearing science, the ohio state university, columbus, oh, usa']
moulinfrier13_interspeech	['inria, flowers team, bordeaux, france']
hazan13_interspeech	['department of speech hearing and phonetic sciences, university college london, london, uk']
barbier13_interspeech	['speech and cognition department, gipsa-lab & grenoble university, grenoble, france', 'department of linguistics, universite du quebec a montreal, montreal, quebec, canada', 'timc-imag laboratory, grenoble university & cnrs, la tronche, france', 'haskins laboratories, new haven, connecticut, usa', 'massachusetts institute of technology, cambridge, massachusetts, usa']
kinsman13_interspeech	['department of psychology, university of lethbridge, lethbridge, canada']
berry13_interspeech	['department of robotics, brain and cognitive science, italian institute of technology, genoa, italy', 'section of human physiology, university of ferrara, ferrara, italy']
zhu13_interspeech	['department of electrical engineering, university of southern california, los angeles, usa', 'department of linguistics, university of southern california, los angeles, usa']
canevari13_interspeech	['rbcs, istituto italiano di tecnologia, genova, italy']
tomaschek13_interspeech	['quantative linguistics, university of tubingen']
silva13_interspeech	['deti/ ieeta, university of aveiro (aveiro, portugal)', 'essua/ ieeta, university of aveiro (aveiro, portugal)']
vaz13_interspeech	['ming hsieh department of electrical engineering', 'university of southern california, los angeles, ca – 90089']
stella13_interspeech	['dipartimento di matematica e fisica, universita del salento, lecce, italy', 'centro di ricerca interdisciplinare sul linguaggio (cril), universita del salento, lecce, italy', 'dipartimento di studi linguistici e letterari, universita di padova, padova, italy']
badin13_interspeech	['gipsa-lab / dpc, umr 5216, cnrs – grenoble-alps university, france', 'irmage, ums inserm us 17 / cnrs ums 3552 – grenoble-alps university, france']
schotz13_interspeech	['lund university humanities lab, centre for languages & literature, sweden', 'dept. of logopedics, phoniatrics and audiology, lund university, sweden']
green13_interspeech	['\x03mgh institute of health professions, boston, ma, united states', 'callier center for communication disorders', 'university of texas at dallas, dallas, tx, united states', 'waisman center, university of wisconsin-madison, madison, wi, united states']
lin13_interspeech	['department of computer science and information engineering', 'national cheng kung university, tainan, taiwan']
altrov13_interspeech	['institute of the estonian language, tallinn, estonia']
brunelliere13_interspeech	['unite de recherche en sciences cognitive et affectives, universite de lille3, france', 'aix marseille universite, cnrs, lpl, umr 7309', ' aix-en-provence, france']
ogane13_interspeech	['graduate school of sport sciences, waseda university, japan', 'faculty of sport sciences, waseda university, japan']
nwe13_interspeech	['human language technology department, institute for infocomm research (i2r), a*star,', 'singapore 138632']
prego13_interspeech	['program of electrical engineering, federal university of rio de janeiro, brazil.', 'program of electrical engineering, federal center for technological education, brazil.']
gussenhoven13_interspeech	['radboud university nijmegen, netherlands', 'max planck institute for psycholinguistics, nijmegen, netherlands']
guiraud13_interspeech	['laboratoire dynamique du langage, cnrs/universite lyon 2 umr 5596, lyon, france', 'clillac-arp, ea 3967, universite paris diderot, paris, france']
windmann13_interspeech	['faculty of linguistics and literary studies, bielefeld university, germany', 'faculty of technology, bielefeld university, germany']
emond13_interspeech	['departement de linguistique, universite du quebec a montreal, canada', 'departement de lettres et communication sociale, universite du quebec a trois-rivieres, canada']
raake13_interspeech	['aipa, telekom innovation laboratories (t-labs), tu berlin, germany', 'telecommunications research center, vienna, austria']
kouklia13_interspeech	['laboratoire de phonetique et de phonologie', 'umr 7018 cnrs / university sorbonne nouvelle paris 3, france']
morchid13_interspeech	['lia, university of avignon, france', 'mcgill university, school of computer science, montreal, quebec, canada']
rao13_interspeech	['school of electrical and computer engineering, georgia institute of technology, atlanta, ga, usa', 'school of interactive computing, georgia institute of technology, atlanta, ga, usa']
truong13_interspeech	['human media interaction, university of twente', 'enschede, the netherlands']
kim13e_interspeech	['idiap research institute, martigny, switzerland', 'dsp lab., yonsei university, seoul, korea', 'vision objects, versailles, france', 'university of glasgow, glasgow, united kingdom']
schiel13_interspeech	['bavarian archive for speech signals, munich, germany', 'universita degli studi di napoli federico ii, naples, italy']
baumeister13_interspeech	['institute of phonetics and speech processing, bavarian archive for speech signals,', 'ludwig-maximilians-universitat, munchen, germany']
hou13_interspeech	['institute of linguistics, chinese academy of social sciences, beijing, china', 'institute of linguistic studies, shanghai international studies university, shanghai, china']
harrat13_interspeech	['ens bouzareah, algiers, algeria', 'crstdla, algiers, algeria', 'badji mokhtar university-annaba, algeria', 'campus scientifique loria , nancy, france']
wodarczak13b_interspeech	['faculty of linguistics and literary studies', 'bielefeld university, germany']
kachkovskaia13_interspeech	['saint petersburg state university, russia']
reichel13b_interspeech	['institute of phonetics and speech processing, university of munich']
caelenhaumont13_interspeech	['mica institute, hust – cnrs/umi2954 - grenoble inp, hanoi university of sciences and', 'technology, hanoi, vietnam', 'atilf-umr 7118, universite de lorraine, france']
leonarduzzi13_interspeech	['aix marseille universite, laboratoire parole et langage, umr 7309', ' aix-en-provence, france']
nouri13_interspeech	['institute for creative technologies, university of southern california', 'marshall school of business, university of southern california']
poignant13_interspeech	['ujf-grenoble 1 / upmf-grenoble 2 / grenoble inp / cnrs, lig umr 5217,', 'grenoble, f-38041, france', 'vocapia research', ' rue jean rostand, parc orsay universite', ' orsay, france', 'univ paris-sud, limsi-cnrs, spoken language processing group, bp 133', ', orsay, france']
bredin13_interspeech	['cnrs / limsi upr 3251', 'universite paris-sud, orsay, france', 'johann poignant', 'ujf-grenoble 1 / upmf-grenoble 2 / grenoble inp', 'cnrs / lig umr 5217, grenoble, france']
demarco13_interspeech	['school of computing sciences, university of east anglia, norwich, england']
rouvier13_interspeech	['lunam universite, lium, le mans, france']
kons13b_interspeech	['ibm research – haifa, haifa university mount carmel, haifa 31905, israel']
liang13_interspeech	['department of computer science and information engineering,', 'national cheng kung university, tainan, taiwan']
hirayama13_interspeech	['graduate school of informatics, kyoto university, japan', 'academic center for computing and media studies, kyoto university, japan']
rodriguezfuentes13_interspeech	['agnitio research, south africa']
han13b_interspeech	['ibm t j. watson research center, yorktown heights, ny, usa', 'university of southern california, los angeles, ca, usa']
lawson13_interspeech	['speech technology and research laboratory, sri international, california, usa']
kang13_interspeech	"['multimedia department, baidu, inc.', 'research and development center, toshiba (china) co., ltd.', 'abstract\x02', 'a novel method is proposed to improve the duration prediction', 'for hmm based speech synthesis. based on the decision tree', 'trained by the conventional hts training method, the duration', 'instances of every leaf node are further clustered into several', 'classes by the k-means clustering method, and the mapping', 'functions between the context features and class labels are', 'trained by crf. instead of using the mean value of the', 'gaussian distribution of a leaf node in the decision tree as the', 'predicted duration, the weighted summation of the multi-', 'centroids from these several clustered classes is used to predict', 'the phoneme duration. the weights are given by the output', 'probability provided by crf according to input context', 'features and the prior probability from the clustering results.', 'compared with conventional hts method,   experiments show', 'that the proposed method can significantly reduce rmse in', 'objective evaluations and achieves better preference scores in', 'the subjective evaluations.', 'index terms: duration prediction, hts, crf', '. introduction', 'the hidden markov model (hmm)-based speech synthesis', 'has been widely used in recent years. in this method, f0,', 'duration and spectrum are modeled simultaneously within a', 'unified framework [1]. by taking account of constraints', 'between the static and dynamic features, smooth speech', 'parameter trajectories can be generated with high intelligibility', '[2].', 'currently, one of the main drawbacks of hmm-based', 'speech synthesis is that the synthesized voice does not sound', 'natural enough because of the bland prosody. duration is an', 'important prosodic factor to control the speaking speed and', 'further rhythm of the synthesized voice. further in the systems,', 'the state duration also plays an important role to determine the', 'best state sequence to generate parameters such as spectrum', 'and f0. the monotonous state durations generated by hmms', 'are lack of prosodic variance and naturalness.', 'the state of the art of hsmm duration prediction method', '[3] models the duration distribution of each leaf node in the', 'decision tree by a single gaussian distribution. in the synthesis', 'stage, each target unit traverses the decision tree and reaches a', 'leaf node, and then the mean value of the leaf node is applied', 'as the predicted duration for that target unit. the duration', 'values for all possible target units can only come from the', 'mean values of leaf nodes in the duration tree. although the', 'size of the duration decision tree may be controlled by tuning', 'the parameters when training, the total number of leaf nodes', 'will not be very large and is not enough to present all possible', '\x02 the work has been done when kang yongguo was at toshiba.', 'target units. suffering from the synthesized voice with', 'monotonous durations, many researchers have proposed', 'methods to improve the duration prediction such as multi-level', 'duration models including phoneme and syllable duration', 'distributions [4], full covariance gaussian distributions [5],', 'multi-level exemplar based duration generation method [6]', 'and explicit duration modeling [9].', 'in this paper, a new duration prediction method is', 'proposed to generate the duration from multiple centroids', 'instead of predicting just from a single centroid, i.e. the', 'gaussian mean in a leaf node of duration decision tree in the', 'conventional hsmm. phoneme duration instances in a leaf', 'node of the duration decision tree will be clustered into several', 'classes, and centroids of these classes will be used as multi-', 'centroids to predicted duration. conditional random field', '(crf) [7] is used to build the mapping function between', 'context features of duration instances and class tags for every', 'leaf node. in synthesis stage when predicting duration for a', 'target phoneme in the test sentence, the corresponding leaf', 'node is firstly visited by tracing the duration decision tree', ""using the phoneme's context feature, then the output"", 'probability of each class in the leaf node will be given by crf', 'for the input context features, and finally the phoneme', 'duration is predicted by using these multi-centroids, output', 'probabilities and prior probabilities of these classes.', 'there are many works [4', '] to improve the duration', 'prediction with limits of multi-level linguistic units such as', 'syllable and phoneme. while the present study is to expand the', 'duration generation from single centroid to multi-centroids, it', 'uses crf to dynamically build the relationship between', 'context features and the duration class in a leaf node, which', 'was not considered in these earlier studies. a similar work is', 'the rich context model [8] proposed to deal with the spectral', ""and pitch's over smoothing problem introduced by decision"", 'tree based parameter tying.', 'the rest of this paper is organized as follows. in section 2', 'the conventional state duration generation for hmm-based', 'speech synthesis is reviewed. then the crf training is', 'described in section 3. section 4 presents our duration', 'prediction method from multi-centroids in detail. experimental', 'results including the objective and subjective tests are', 'introduced in section 5, and the last section concludes the', 'paper.', '. conventional state duration generation', 'duration prediction is performed on state level in hmm based', 'speech synthesis, because the predicted duration provides not', 'only the occupying time of linguistic units but also the best', 'state sequence which is the base for the spectrum and f0', 'parameters generation. state durations are initially estimated', 'from statistical variables obtained at the last iteration of the', 'forward-backward algorithm, and then derived from hidden', 'multi-centroidal duration generation algorithm for hmm-based tts', 'copyright © 2013 isca', '-29 august 2013, lyon, france', 'interspeech 2013', '.21437/interspeech.2013-390']"
raitio13_interspeech	['department of signal processing and acoustics, aalto university, espoo, finland', 'department of behavioural sciences, university of helsinki, helsinki, finland']
nagata13_interspeech	['graduate school of engineering, utsunomiya university, japan', 'graduate school of science and engineering, tokyo institute of technology, japan']
brognaux13_interspeech	['cental, icteam - universite catholique de louvain, belgium', 'tcts - universite de mons, belgium']
mehrabani13_interspeech	['at&t labs research', 'florham park, nj, usa']
charfuelan13_interspeech	['dfki gmbh, language technology lab', 'berlin and saarbrucken, germany']
ward13_interspeech	['department of computer science, university of texas at el paso']
chen13d_interspeech	['school of electrical and computer engineering, georgia institute of technology', 'atlanta, ga 30332-0250, usa']
wintrode13_interspeech	['center for language and speech processing', 'johns hopkins university, baltimore, maryland']
senay13_interspeech	"[""laboratoire informatique d'avignon, university of avignon, avignon, france""]"
szaszak13_interspeech	['idiap research institute, martigny, switzerland', 'research institute of linguistics, hungarian academy of sciences, budapest, hungary']
heck13_interspeech	['microsoft research']
cumani13_interspeech	['dipartimento di automatica e informatica, politecnico di torino, torino, italy', 'brno university of technology, brno, czech republic']
simonchik13_interspeech	['department of speaker verification and identification,', 'speech technology center ltd., st. petersburg, russia']
hautamaki13b_interspeech	['university of eastern finland, finland', 'institute for infocomm research, singapore,', 'radboud university nijmegen, the netherlands,4 university of texas at dallas,usa,', 'validsoft ltd, london, uk']
li13d_interspeech	['signal analysis and interpretation laboratory, university of southern california, los angeles, usa', 'department of electrical engineering, indian institute of science (iisc), bangalore, india']
leeuwen13_interspeech	['netherlands forensic institute, the hague and radboud university nijmegen, the netherlands', 'agnitio research, somerset west, south africa']
kelly13b_interspeech	['department of electronic & electrical engineering, trinity college dublin, ireland', 'agnitio research, somerset west, south africa']
sarkar13_interspeech	['limsi-cnrs, universite paris-sud, bp 133', ' orsay, france']
perera13_interspeech	['computer science department, tecnologico de monterrey, monterrey nuevo leon, mexico', 'language technology institute, carnegie mellon university, pittsburgh, pa, usa']
wang13d_interspeech	['. center for speech and language technologies, division of technical innovation and development,', 'tsinghua national laboratory for information science and technology', 'center for speech and language technologies, research institute of information technology', 'department of computer science and technology, tsinghua university, beijing, china', '. human computer technology laboratory, universidad autonoma de madrid, spain']
kanagasundaram13_interspeech	['⋆speech research laboratory, queensland university of technology, australia', '† atvs biometric recognition group, universidad autonoma de madrid, spain']
aronowitz13_interspeech	['ibm research – haifa, haifa, israel', 'school of computer science, tel aviv university, tel aviv, israel']
zhang13b_interspeech	['tsinghua national laboratory for information science and technology,', 'department of electronic engineering, tsinghua university, beijing 100084, china']
garciaromero13_interspeech	['human language technology center of excellence, johns hopkins university, baltimore, md']
do13b_interspeech	['limsi-cnrs, universite paris-sud', ' orsay cedex, france', 'vocapia research, parc orsay universite', ' orsay cedex, france']
rajan13_interspeech	['school of computing, university of eastern finland, finland', 'dept. of electronic engineering, uludag university, turkey', 'dept. of signal processing and acoustics, aalto university, finland']
portelo13_interspeech	['inesc-id lisboa, portugal', ' instituto superior tecnico, lisboa, portugal', 'language technologies institute, carnegie mellon university, pittsburgh, pa, usa']
taghia13_interspeech	['† communication theory lab., kth royal institute of technology,', '‡ pattern recognition and intelligent system lab.,']
diez13b_interspeech	['gtts, department of electricity and electronics, ztf/fct', 'university of the basque country upv/ehu, barrio sarriena', ' leioa, spain']
villalba13_interspeech	['gtc, aragon institute for engineering research (i3a),', 'university of zaragoza, spain', 'gtts, department of electricity and electronics', 'university of the basque country upv/ehu, spain']
fang13_interspeech	['mit computer science and artificial intelligence laboratory,', 'cambridge, massachusetts 02139, usa']
hautamaki13c_interspeech	['school of computing, university of eastern finland, joensuu, finland']
erjavec13_interspeech	['department of cognition, language and interaction, university of paris viii, france']
tiippana13_interspeech	['institute of behavioural sciences, university of helsinki, finland']
davis13_interspeech	['the marcs institute, university of western sydney, australia']
chandrashekara13_interspeech	['gipsa-lab – dpc, umr 5216 –cnrs university of grenoble, france']
rilliard13_interspeech	['limsi-cnrs, orsay, france', ' showa university of music, kawasaki, japan;', 'sofia university, tokyo, japan', ' clle-errsab, umr 5263, bordeaux, france;', 'laboratorio de fonetica acustica, fl/ufrj/cnpq, brazil']
bailly13_interspeech	['gipsa-lab, umr 5216 cnrs/universite de grenoble -france']
toth13_interspeech	['research group on artificial intelligence', 'hungarian academy of sciences and university of szeged, hungary']
hirsch13_interspeech	['institute for pattern recognition, niederrhein university of applied sciences, krefeld, germany']
rodriguez13_interspeech	['jose luis oropeza rodriguez']
jaitly13_interspeech	['department of computer science, university of toronto, toronto, m5s 3g4, canada', 'google inc, canada']
yeh13_interspeech	['graduate institute of communication engineering, national taiwan university, taiwan', 'research center for information technology innovation, academia sinica, taiwan']
qi13_interspeech	['department of electronic engineering, tsinghua university, beijing', ', china', 'center for speech and language technologies, division of technical innovation', 'and development, tsinghua national for information science and technology', 'center for speech and language technologies, research institute of information technology, tsinghua', 'department of computer science and technology, tsinghua university, beijing', ', china', 'human computer technology laboratory, universidad autonoma de madrid, spain']
qi13b_interspeech	['jun qi1, dong wang2,3,4, ji xu1, javier tejedor5']
golik13_interspeech	['human language technology and pattern recognition, computer science department,', 'rwth aachen university', ' aachen, germany', 'spoken language processing group, limsi cnrs, paris, france']
patil13b_interspeech	['department of electrical engineering, indian institute of technology bombay, india.']
palaz13_interspeech	['idiap research institute, martigny, switzerland', 'ecole polytechnique federale de lausanne (epfl), lausanne, switzerland']
olaso13_interspeech	['departamento de electricidad y electronica, universidad del pais vasco, spain']
tomar13_interspeech	['department of electrical and computer engineering, mcgill university, montreal, qc, canada']
schatz13_interspeech	['lscp, ens/ehess/cnrs, paris, france', 'sierra project-team, inria/ens/cnrs, paris, france', 'hlt center of excellence, john hopkins university, baltimore, maryland']
chiang13_interspeech	['department of communication engineering, national taipei university, new taipei city, taiwan', 'department of electrical engineering, national chiao tung university, hsinchu, taiwan', 'department of telematics, kore university of enna, enna, italy', 'school of electrical and computer engineering, georgia institute of technology, atlanta, ga, usa']
heckmann13_interspeech	['honda research institute europe gmbh, d-63073 offenbach/main, germany']
liu13d_interspeech	['school of computing, national university of singapore, singapore']
alumae13_interspeech	['institute of cybernetics at tallinn university of technology, tallinn, estonia']
ahmadi13_interspeech	['school of computer engineering, nanyang technological university, singapore', 'faculty of computer science and information technology, university of malaya, malaysia', 'department of electronic engineering, university of science and technology, china']
li13e_interspeech	['human-computer communications laboratory', 'department of system engineering and engineering management', 'the chinese university of hong kong, hong kong sar, china']
qian13_interspeech	['institute of intelligent human-machine interaction, moe-microsoft key lab. of intelligent', 'computing and intelligent systems,', 'department of computer science and engineering, shanghai jiao tong university, shanghai,china', 'tsinghua national laboratory for information science and technology,', 'department of electronic engineering, tsinghua university, beijing, china']
novak13b_interspeech	['graduate school of information science and technology, the university of tokyo, japan']
kameoka13_interspeech	['graduate school of information science and technology, the university of tokyo', 'ntt communication science laboratories, nippon telegraph and telephone corporation']
davel13_interspeech	['multilingual speech technologies, north-west university, vanderbijlpark, south africa']
jin13_interspeech	['university of colorado, boulder', 'rosetta stone, usa', '* first author was an intern at rosetta stone at the time this work was completed.']
liu13e_interspeech	['department of electrical engineering, university of washington, seattle, wa, usa']
shen13_interspeech	['department of electronic, electrical and computer engineering, university of birmingham, uk']
abdelhamid13b_interspeech	['department of computer science and engineering, york university, toronto, ontario, canada', 'microsoft research, redmond, wa usa']
coene13_interspeech	['paul govaerts2', 'applied linguistics, vu university amsterdam, the netherlands', 'the eargroup, deurne-antwerpen, belgium', 'leiden institute for advanced computer science, the netherlands', 'department of linguistics, radboud university, nijmegen, the netherlands', 'laboratory of biomedical physics, university of antwerp, belgium']
kawahara13b_interspeech	['school of informatics, kyoto university,', 'sakyo-ku, kyoto 606-8501, japan']
hu13_interspeech	['microsoft research asia, beijing, p.r.c.', 'university of science and technology of china, hefei, p.r.c.']
planells13_interspeech	['departament de sistemes informatics i computacio. universitat politecnica de valencia', 'cami de vera s/n', ', valencia, spain.']
todo13_interspeech	['department of computer sciences and engineering, toyohashi university of technology, japan', 'nagoya institute of technology, japan']
skantze13_interspeech	['kth speech, music and hearing, stockholm, sweden']
xi13_interspeech	['media experience analytics business unit, cisco systems']
song13_interspeech	['key laboratory of speech acoustics and content understanding', 'chinese academy of sciences', 'beijing 100190, china']
kubo13b_interspeech	['graduate school of information science,', 'nara institute of science and technology (naist), japan']
naghibi13_interspeech	['speech processing group, eth zurich, switzerland']
basson13_interspeech	['multilingual speech technologies, north-west university, vanderbijlpark, south africa']
jyothi13_interspeech	['department of computer science and engineering, the ohio state university, usa', 'toyota technological institute at chicago, usa']
karanasou13_interspeech	['limsi/cnrs, b.p. 133', ' orsay, france', 'universite paris-sud', ' orsay, france']
greenberg13_interspeech	['national institute of standards and technology', 'gaithersburg, maryland, usa', 'us department of defense', 'fort meade, maryland, usa']
brummer13_interspeech	['agnitio research, somerset west, south africa', 'walnut creek, ca, usa']
ferrer13_interspeech	['speech technology and research laboratory, sri international, menlo park, ca 94025, u.s.a.']
sun13_interspeech	['institute for infocomm research (i2r), a*star, singapore 138632']
colibro13_interspeech	['nuance communications, inc.', 'politecnico di torino, italy']
chen13e_interspeech	['department of electrical engineering, university of california, los angeles, usa', 'department of linguistics, university of california, los angeles, usa', 'department of head and neck surgery, school of medicine, university of california, los angeles, usa']
smith13b_interspeech	['department of linguistics, university of southern california, los angeles, ca, usa', 'department of linguistics, university of western sydney, sydney, nsw, australia', 'department of electrical engineering, university of southern california, los angeles, ca, usa']
ramanarayanan13_interspeech	['†signal analysis and interpretation laboratory, university of southern california, los angeles, usa', '‡department of linguistics, university of southern california, los angeles, usa']
rochetcapellan13_interspeech	['gipsa-lab, umr 5216 cnrs/universite de grenoble –france', 'centre for general linguistics, berlin – germany']
arai13_interspeech	['department of information and communication sciences', 'sophia university, tokyo, japan']
laprie13_interspeech	['loria/cnrs, nancy, france', 'lpp, paris, france', 'ips, strasbourg, france', 'praxiling, montpellier, france']
bellegarda13_interspeech	['apple inc.', 'cupertino, california 95014, usa']
weiss13_interspeech	['quality & usability lab, telekom innovation laboratories, tu berlin, germany']
gemmeke13_interspeech	['esat, ku leuven, leuven, belgium', 'clips - computational linguistics group, university of antwerp, antwerp, belgium', 'cuo | social spaces, iminds, ku leuven, leuven, belgium', 'mobilab, thomas more kempen, geel, belgium', 'iminds, future health department, ku leuven, leuven, belgium']
eyben13_interspeech	['audeering ug (haftungsbeschrankt), gilching, germany', 'institute for sensor systems, university of passau, germany']
principi13_interspeech	['department of information engineering, universita politecnica delle marche, ancona, italy', 'fbt elettronica spa, recanati (mc), italy']
zinovieva13_interspeech	['speech, language and multimedia business unit', 'raytheon bbn technologies, cambridge, ma']
burkhardt13b_interspeech	['deutsche telekom laboratories, berlin, germany']
vacher13_interspeech	['lig, ujf/cnrs/grenoble-inp/upmf, umr5217', ' grenoble, france', 'esigetel', ' avon, france', 'theoris', ' paris, france']
aman13_interspeech	['lig, umr5217 ujf/cnrs/grenoble-inp/umpf', ' grenoble, france']
liu13f_interspeech	['nuance communications inc., burlington, ma']
gouvea13_interspeech	['at&t labs – research, bedminster nj, usa']
dhoore13_interspeech	['mobile division, nuance communications, merelbeke, belgium']
gautreau13_interspeech	['laboratoire language, cerveau et cognition (l2c2),', 'cnrs umr5304, university of lyon.', 'lyon neuroscience research center, brain dynamics and cognition team,', 'cnrs umr5292, inserm u1028, university lyon 1.']
jacewicz13_interspeech	['department of speech and hearing science, the ohio state university, columbus, oh, usa.']
tokuma13_interspeech	['department of english, faculty of commerce, chuo university, japan', 'faculty of social innovation, seijo university, japan']
sisinni13_interspeech	['centro di ricerca interdisciplinare sul linguaggio, university of salento, lecce, italy', 'marcs institute, university of western sydney, penrith, australia']
rauber13_interspeech	['catholic university of pelotas, pelotas, brazil', 'university of minho, braga, portugal', 'federal university of parana, curitiba, brazil']
chen13f_interspeech	['division of speech and hearing sciences, the university of hong kong', 'key laboratory of speech acoustics and content understanding, institute of acoustics, chinese', 'academy of sciences']
moon13_interspeech	['department of linguistics, stanford university, stanford, ca, usa']
ying13_interspeech	['the marcs institute, university of western sydney, australia', 'school of humanities and communication arts, university of western sydney, australia']
wong13b_interspeech	['the chinese university of hong kong']
kartushina13_interspeech	['laboratoire de la psycholinguistique experimentale, universite de geneve, suisse']
halle13_interspeech	['laboratoire phonetique et phonologie, cnrs-paris 3, france', 'laboratoire de psycholinguistique  experimentale, universite de geneve, suisse', 'laboratoire memoire et cognition, paris 5, france']
best13_interspeech	['marcs institute, university of western sydney, australia']
martinez13b_interspeech	['aragon institute for engineering research (i3a), university of zaragoza, spain', 'computer science, university of sheffield, united kingdom']
ghio13_interspeech	['aix marseille university, cnrs, laboratoire parole et langage, aix-en-provence, france']
balciuniene13_interspeech	['department of lithuanian language, vytautas magnus university, kaunas, lithuania']
munson13b_interspeech	['department of speech-language-hearing science,', 'university of minnesota, minneapolis, mn usa']
antolik13_interspeech	['laboratoire de phonetique et phonologie, umr7018 cnrs/univ. sorbonne nouvelle, paris']
verdurand13_interspeech	['univ. grenoble alpes, gipsa-lab, grenoble, france', 'univ. grenoble alpes, lig, grenoble, france', 'univ. paris renee descartes lpp, paris, france', 'univ. di padova, padova, italia', 'cnr-istc, padova, italia']
clapham13_interspeech	['netherlands cancer institute', 'atos medical, horby, sweden', 'aclc, university of amsterdam, the netherlands']
mauclair13_interspeech	['† universite paris descartes', ' rue des saints peres 75006 paris, france', '⋆irit - universite de toulouse', ' route de narbonne', ' toulouse cedex 9, france', '‡service orl et de chirurgie de la face et du cou, hˆopital de la pitie salpetriere', ' paris, france']
helfer13_interspeech	['mit lincoln laboratory, lexington, massachusetts, usa', 'ctr. for laryngeal surgery & voice rehab., mass. general hospital, boston, massachusetts, usa']
fraser13_interspeech	['department of computer science, university of toronto, toronto, canada', 'toronto rehabilitation institute, toronto, canada', 'department of speech-language pathology, university of toronto, toronto, canada']
alumae13b_interspeech	['institute of cybernetics at tallinn university of technology, tallinn, estonia']
long13_interspeech	['cambridge university engineering dept, trumpington st., cambridge, cb2 1pz u.k.']
cerisara13_interspeech	['loria-umr7503, nancy, france', 'dept of computer science and engineering, univ. of west bohemia, plzeˇn, czech republic', 'ntis - new technologies for the information society, univ. of west bohemia, plzeˇn, czech rep.']
nussbaumthom13_interspeech	['computer science dept. 6, rwth aachen university, aachen, germany', 'spoken language processing group, limsi cnrs, paris, france']
premkumar13_interspeech	['department of computer technology, anna university, chennai, india', 'cognitive systems lab, institute for anthropomatics, karlsruhe institute of technology (kit).']
thangthai13_interspeech	['national electronics and computer technology center, thailand']
chien13_interspeech	['department of electrical and computer engineering', 'national chiao tung university, hsinchu, taiwan 30010, roc']
asami13_interspeech	['ntt media intelligence laboratories, ntt corporation, japan']
tuske13_interspeech	['ahuman language technology and pattern recognition, computer science department,', 'rwth aachen university', ' aachen, germany', 'bspoken language processing group, limsi cnrs, paris, france']
chang13c_interspeech	['at&t labs – research, austin, tx 78795, usa']
fohr13_interspeech	['cnrs, loria umr 7503, vandoeuvre-les-nancy, f-54506, france', 'universite de lorraine, loria umr 7503, vandoeuvre-les-nancy, f-54506, france', 'inria, villers-les-nancy, f-54600, france']
miao13_interspeech	['language technologies institute, school of computer science, carnegie mellon university', 'pittsburgh, pa, usa']
qin13_interspeech	['language technologies institute, carnegie mellon university, pittsburgh, pa, usa']
chiu13_interspeech	['language technologies institute, carnegie mellon university, pittsburgh, pa. usa']
acher13_interspeech	"['alexandre', 'krainik², georges bettega³, christian adrien righini4, brice carlot5, muriel brix³', 'and pascal perrier¹', '¹ gipsa-lab, dpt. parole & cognition, umr 5216 cnrs/universite grenoble-alpes, france', '² sfr1 rmn biomedicale et neurosciences – unite irm recherche 3t, chu grenoble, france', '³ service de chirurgie plastique et maxillo-faciale – chu grenoble, france', ""clinique universitaire d'orl, pôle tete et cou et chirurgie reparatrice – chu grenoble, france"", 'hôpital prive de la casamance – aubagne, france']"
mertens13_interspeech	['laboratory of images, signals and telecommunication devices,', 'universite libre de bruxelles, brussels, belgium', 'national fund for scientific research, belgium', 'department of neurology, knappschaftskrankenhaus,', 'ruhr university of bochum, germany']
tantibundhit13_interspeech	['department of electrical and computer engineering, thammasat university, thailand', 'department of linguistics, thammasat university, thailand', 'department of otorhinolarygology, thammasat university, thailand', 'national electronics and computer technology center (nectec), thailand']
kagomiya13_interspeech	['health research institute,', 'national institute of advanced industrial science and technology (aist), japan']
garrapa13_interspeech	['centro di ricerca interdisciplinare sul linguaggio (cril), university of salento, lecce, italy', 'dipartimento di studi linguistici e letterari (disll), university of padova, italy', 'department of biological psychology and neuropsychology, university of hamburg, germany', 'centro interdipartimentale mente/cervello (cimec), university of trento, italy', 'department of linguistics, university of connecticut, usa', 'operative unit of otorhinolaryngology (orl), asl/le, hospital “fazzi”, lecce, italy']
cosentino13_interspeech	['ear institute, university college london, united kingdom', 'inrs-emt, university of quebec, montreal, canada']
huang13_interspeech	['school of ece, georgia institute of technology, atlanta, ga. 30332-0250, usa', 'school of computing, university of eastern finland, finland, fi-80101']
vuuren13_interspeech	['department of electrical and electronic engineering, university of stellenbosch, south africa', 'department of linguistics, radboud university, nijmegen, the netherlands']
prasad13_interspeech	['speech and vision labs, iiit hyderabad']
wang13e_interspeech	['department of electronic engineering, the chinese university of hong kong, hong kong', 'institute for infocomm research, a⋆star, singapore']
kalinli13_interspeech	['sony computer entertainment us r&d, foster city, california, usa']
yuan13b_interspeech	['university of pennsylvania', 'microsoft research', 'sri international']
nguyen13_interspeech	['limsi-cnrs (upr 3251), france', 'mica, hust - cnrs/umi2954 - grenoble inp, vietnam']
raitio13b_interspeech	['department of signal processing and acoustics, aalto university, espoo, finland', 'phonetics and speech laboratory, trinity college dublin, ireland', 'tcts lab, university of mons, belgium']
wang13f_interspeech	['school of computing, national university of singapore']
lehnen13_interspeech	['human language technology and pattern recognition,', 'computer science department, rwth aachen university, aachen, germany', 'univ. paris-sud, france and limsi/cnrs - spoken language processing group']
stan13b_interspeech	['communications department, technical university of cluj-napoca, romania', 'the centre for speech technology research, university of edinburgh, uk', 'national institute of informatics, japan']
maia13_interspeech	['†toshiba research europe limited, cambridge research laboratory, cambridge, uk', '‡toshiba corporation, corporate research and development, kawasaki, japan']
hifny13_interspeech	['university of helwan, egypt']
vesely13_interspeech	['brno university of technology, czech republic', 'centre for speech technology research, university of edinburgh, uk', 'center for language and speech processing, johns hopkins university, usa']
zhang13c_interspeech	['hkust', 'human language technology center', 'department of electronic and computer engineering', 'university of science and technology, clear water bay, hong kong']
tachioka13_interspeech	['information technology r&d center, mitsubishi electric, kamakura, japan', 'mitsubishi electric research laboratories, cambridge, us']
huang13b_interspeech	['microsoft corporation, one microsoft way, redmond, wa 98052']
xue13_interspeech	['microsoft corporation, one microsoft way, redmond, wa 98052']
chen13g_interspeech	['†institute for infocomm research, singapore §nanyang technological university, singapore', '∗massachusetts institute of technology, cambridge, ma, usa']
delvaux13_interspeech	['laboratoire de phonetique', 'institut de recherche en sciences et technologies du langage,', 'umons, belgium']
netelenbos13_interspeech	['department of psychology, university of lethbridge, lethbridge, canada']
burgos13_interspeech	['department of linguistics, radboud university nijmegen, the netherlands']
graham13_interspeech	['department of theoretical and applied linguistics, university of cambridge, uk']
benoistlucy13_interspeech	['laboratoire de phonetique et phonologie, umr 7018, cnrs/ univ sorbonne nouvelle-paris 3']
bone13b_interspeech	['signal analysis and interpretation laboratory (sail), usc, los angeles, ca, usa', 'university center for excellence in developmental disabilities, keck school of medicine of usc', 'zilka neurogenic institute, keck school of medicine of usc', 'http://sail.usc.edu']
boril13_interspeech	['center for robust speech systems (crss), university of texas at dallas, u.s.a.', 'lena foundation, boulder, colorado, usa']
claus13_interspeech	['dresden university of technology, chair for system theory and speech technology,', 'dresden, germany', 'autonomous university of zacatecas', ', zacatecas, mexico', 'linguwerk gmbh, research & development', ' dresden, germany']
kouloumenta13_interspeech	['dept. of ece, technical univ. of crete, chania 73100, greece']
alam13c_interspeech	['inrs-emt, university of quebec, montreal (qc), canada', 'crim, montreal (qc), canada', 'ecole de technologie superieure, montreal, canada']
bone13c_interspeech	['signal analysis and interpretation laboratory, university of southern california, los angeles, ca', 'department of psychology, university of north carolina, chapel hill, nc', 'http://sail.usc.edu']
chaspari13_interspeech	['sail, university of southern california, los angeles, ca, usa', 'chai lab, university of michigan, ann arbor, mi, usa']
evanini13_interspeech	['educational testing service', 'princeton, nj, usa']
safavi13_interspeech	['school of electronic, electrical & computer engineering, university of birmingham, uk']
arai13b_interspeech	['department of information and communication sciences', 'sophia university, tokyo, japan']
yao13b_interspeech	['online services division, microsoft, china', 'microsoft research, usa', 'interactive intelligence group, delft university of technology, nl']
riedhammer13_interspeech	['international computer science institute, berkeley, usa', 'school of computer engineering, nanyang technological university, singapore']
alghowinem13_interspeech	['australian national university, canberra, australia', 'university of canberra, canberra, australia', 'university of new south wales, sydney, australia', 'queensland institute of medical research, brisbane, australia', 'ministry of higher education: kingdom of saudi arabia']
bigot13_interspeech	['university of avignon, ceri/lia, france.']
chen13h_interspeech	['school of electrical and computer engineering, georgia institute of technology, atlanta, usa']
womack13_interspeech	['dept. of asl & interpreting edu.', ' dept. of english', ' college of health sciences & tech.', 'center for imaging science', ' computing & information sciences', 'rochester institute of technology, rochester, ny, usa']
nakamura13_interspeech	['† the university of tokyo, tokyo, japan', '‡ northeast normal university, jilin, china', '∗waseda university, tokyo, japan', '⋆tokyo university of foreign studies, tokyo, japan']
shriberg13_interspeech	['microsoft research, mountain view, ca, u.s.a.', 'international computer science institute, berkeley, ca, u.s.a.']
hatano13_interspeech	['atr intelligent robotics and communication labs.']
celikyilmaz13_interspeech	['microsoft silicon valley, usa']
cheng13_interspeech	['knowledge technologies, pearson', 'campbell ave., menlo park, california 94025, usa']
tur13_interspeech	['microsoft silicon valley, usa']
strombergsson13_interspeech	['department of speech, music and hearing, kth, stockholm, sweden']
karafiat13_interspeech	['martin karafiat, frantisek grezl, mirko hannemann, karel vesely, and jan ”honza” cernocky']
norouzian13_interspeech	['department of electrical engineering, mcgill university, montreal, canada', 'human language technology center of excellence, baltimore, usa']
li13g_interspeech	['department of electronic and computer engineering', 'the hong kong university of science and technology, clear water bay, hong kong']
strombergsson13b_interspeech	['department of speech music and hearing, kth, stockholm, sweden', 'swedish agency for accessible media, johanneshov, sweden']
womack13b_interspeech	['dept. of asl & interpreting edu.', ' dept. of english', ' college of health sciences & tech.', 'center for imaging science', ' computing & information sciences', 'rochester institute of technology, rochester, ny, usa']
cutugno13_interspeech	['dept. of electrical engineering and information technology', 'university of naples ”federico ii” - italy']
hatmi13_interspeech	['lina, university of nantes, france,', 'lium, university of le mans, france']
ohno13_interspeech	['department of computer science and engineering', 'toyohashi university of technology']
jung13_interspeech	['electronics and telecommunication research institute(etri)', 'gajeongno, yuseong-gu, daejeon, korea']
nakatani13_interspeech	['graduate school of system informatics, kobe university, japan']
negi13_interspeech	['ibm research india', 'carnegie mellon university', 'indian institute of technology, delhi']
bost13_interspeech	['lia, university of avignon, france', 'mcgill university, school of computer science, montreal, quebec, canada']
chen13i_interspeech	['speech, language and multimedia business unit', 'raytheon bbn technologies', 'cambridge, ma 02138, u.s.a.']
kun13_interspeech	['electrical and computer engineering, university of new hampshire, durham, nh, usa', 'center for spoken language understanding, ohsu, beaverton, or, usa']
mesnil13_interspeech	['university of montreal, quebec, canada', 'microsoft research, redmond, wa, usa', 'university of rouen, france']
liu13g_interspeech	['microsoft corporation, bellevue, usa', 'microsoft research, redmond, usa']
hakkanitur13_interspeech	['microsoft research']
xu13_interspeech	['microsoft corporation']
skowronek13_interspeech	['assessment of ip-based applications - telekom innovation laboratories', 'berlin university of technology, germany']
imoto13_interspeech	['ntt media intelligence laboratories, ntt corporation, tokyo, japan']
kano13_interspeech	['graduate school of information science, nara institute of science and technology']
ohgushi13_interspeech	['graduate school of information science, nara institute of science and technology']
ostendorf13_interspeech	['electrical engineering department', 'computer science & engineering department', 'university of washington, seattle, wa, usa']
medeiros13_interspeech	['spoken language systems lab - inesc-id, lisbon, portugal', 'iscte - instituto universitario de lisboa, portugal', 'flul/clul, universidade de lisboa, portugal', 'ist, lisboa, portugal', 'instituto de telecomunicac˜oes, lisboa, portugal']
meyer13_interspeech	['medical physics, carl-von-ossietzky universitat oldenburg, germany']
gubian13_interspeech	['centre for language & speech technology, radboud university nijmegen, the netherlands', 'centre for language studies, radboud university nijmegen, the netherlands', 'international max planck research school for language sciences, nijmegen, the netherlands']
castan13_interspeech	['university of zaragoza, spain', 'microsoft, sunnyvale, ca, usa']
kousidis13b_interspeech	['dialogue systems group, bielefeld university, germany', 'artificial intelligence group, bielefeld university, germany']
favre13_interspeech	['aix-marseille univ.', 'columbia univ.', 'univ. of toronto', 'city univ. of new york', 'univ. of texas', 'at dallas', 'univ. of pennsylvania', 'duke univ.', 'army research laboratory', 'univ. college london']
sridhar13_interspeech	['at&t labs - research', 'park avenue, florham park, nj 07932, usa']
cho13_interspeech	['international center for advanced communication technologies, institute for anthropomatics', 'karlsruhe institute of technology, germany', 'mobile technologies gmbh, germany']
wu13b_interspeech	['human language technology center', 'department of computer science and engineering', 'hong kong university of science and technology']
tsiartas13b_interspeech	['signal analysis and interpretation lab,', 'ming hsieh department of electrical engineering,', 'university of southern california, los angeles, ca 90089']
fujita13_interspeech	['graduate school of information science, nara institute of science and technology']
haidar13_interspeech	['inrs-emt', '-800 de la gauchetiere ouest, montreal (quebec), h5a 1k6, canada']
chen13j_interspeech	['* national taiwan normal university, taipei, taiwan', 'ƈ institute of information science, academia sinica, taipei, taiwan']
bayer13_interspeech	['signals and interactive systems lab - university of trento, italy']
mansikkaniemi13_interspeech	['aalto university, school of science, department of information and computer science', 'aalto university, school of electrical engineering, department of signal processing and acoustics']
schlippe13_interspeech	['cognitive systems lab, karlsruhe institute of technology (kit), germany']
wen13_interspeech	['national taiwan university,', 'academic sinica, taipei, taiwan']
ayadi13_interspeech	['dept. of eng. math. & physics, f of eng., cairo university, giza, egypt', 'orange labs cairo, giza, egypt']
deoras13_interspeech	['microsoft corporation', ' la avenida, mountain view, ca']
jabaian13_interspeech	['lia, university of avignon']
lai13_interspeech	['centre for speech technology research,', 'school of informatics, university of edinburgh, united kingdom']
shiang13_interspeech	['graduate institute of electrical engineering, national taiwan university', 'research center for information technology innovation, academia sinica']
klasinas13_interspeech	['dept. of electronic & computer engineering, tech. univ. of crete, chania, greece', '†expert system, trento, italy']
toutios13_interspeech	['signal analysis & interpretation laboratory (sail), university of southern california, usa']
zhang13d_interspeech	['microsoft research asia, beijing, china', 'department of computer science, shanghai jiao tong university, shanghai, china']
wang13g_interspeech	['microsoft research asia, beijing, china', 'department of computer science, shanghai jiao tong university, shanghai, china']
hueber13b_interspeech	['gipsa-lab, umr 5216/cnrs/inp/ujf/u.stendhal, grenoble, france']
benyoussef13_interspeech	['centre for speech technology research, university of edinburgh, united kingdom']
braude13_interspeech	['centre for speech technology research,', 'univeristy of edinburgh, united kingdom']
larcher13_interspeech	['institute for infocomm research - a⋆star, singapore', ' university of avignon - lia, france', 'validsoft ltd, uk', ' swansea university, uk', ' multitel, belgium']
senoussaoui13_interspeech	['ecole de technologie superieure (ets), canada', 'centre de recherche informatique de montreal, canada', 'mit computer science and artificial intelligence laboratory (csail), cambridge, ma, usa']
charlet13_interspeech	['orange labs, lannion, france', 'university of avignon, ceri/lia, france']
knox13_interspeech	['international computer science institute, berkeley, california, usa', 'department of electrical engineering and computer sciences, university of california, berkeley, usa']
price13_interspeech	['department of computer science, tokyo institute of technology, tokyo, japan']
schindler13_interspeech	['institute of phonetics and speech processing, ludwig maximilians university, munich, germany']
laurent13_interspeech	"[""laboratoire d'informatique de grenoble, umr 5217 cnrs, universite de grenoble, france"", 'gipsa-lab, departement parole et cognition, umr 5216 cnrs, universite de grenoble, france', 'laboratoire de psychologie et neurocognition, umr 5105 cnrs, universite de grenoble, france', 'lppa, umr 7152 cnrs, college de france, paris, france']"
theodore13_interspeech	['department of speech, language, and hearing sciences, university of connecticut, storrs,', 'connecticut, united states']
lecumberri13_interspeech	['language and speech laboratory, university of the basque country, vitoria, spain', 'basque foundation for science, bilbao, spain']
cutler13_interspeech	['marcs institute, university of western sydney, australia', 'max planck institute for psycholinguistics, nijmegen, the netherlands']
bagou13_interspeech	['laboratoire de psycholinguistique experimentale, university of geneva, switzerland']
bosch13_interspeech	['cls/clst, radboud university', 'max planck institute for psycholinguistics, nijmegen, nl']
athanasopoulos13_interspeech	['⋆vrije universiteit brussel, dept. of electronics and informatics, pleinlaan 2, brussels, belgium', '†iminds, dept. of future media and imaging, gaston crommenlaan 8, ghent, belgium']
xue13b_interspeech	['national laboratory of pattern recognition, institute of automation, chinese academy of sciences,', 'beijing 100190, china']
harte13_interspeech	['sigmedia, department of electrical & electronic engineering, trinity college dublin, ireland', 'trinity centre for biodiversity research & department of zoology, trinity college dublin, ireland']
nishigaki13_interspeech	['graduate school of systems engineering, wakayama university, wakayama, japan', 'department of communication disorders, health science university of hokkaido, sapporo, japan', 'faculty of engineering, university of yamanashi, kofu, japan', 'department of design information sciences, wakayama university, wakayama, japan']
mehrabani13b_interspeech	['center for robust speech systems (crss)', 'erik jonsson school of engineering & computer science, university of texas at dallas, usa']
molla13_interspeech	['graduate school of information science and technology, the university of tokyo, tokyo, japan', 'department of computer science and eng., the university of rajshahi, rajshahi, bangladesh']
lin13b_interspeech	['¹department of electrical and computer engineering, national chiao tung university, taiwan.', '²telecommunication laboratories, chunghwa telecom co., ltd., taiwan.']
ludenachoez13_interspeech	['dept. of signal theory and communications, universidad carlos iii de madrid,', 'avda. de la universidad 30', ' - leganes (madrid), spain', 'facultad de ingenierias, universidad catolica san pablo, arequipa, peru']
rawat13_interspeech	['language technologies institute, carnegie mellon university, pittsburgh, pa 15213, usa']
altaf13_interspeech	['center for signal and image processing, school of electrical and computer engineering,', 'georgia institute of technology, atlanta, georgia, usa']
mynarski13_interspeech	['max-planck institute for mathematics in the sciences, leipzig, germany']
oualil13_interspeech	['spoken language systems, saarland university, saarbrucken, germany']
chakraborty13_interspeech	['talp research centre, department of signal theory and communications', 'universitat politecnica de catalunya, barcelona, spain']
zhuang13_interspeech	['speech, language and multimedia business unit', 'raytheon bbn technologies']
maddieson13b_interspeech	['department of linguistics, university of new mexico, albuquerque, nm, usa', 'laboratoire dynamique du langage, cnrs – universite de lyon, lyon, france']
barbosa13b_interspeech	['speech prosody studies group, dep. of linguistics, state univ. of campinas, brazil']
oh13c_interspeech	['laboratoire dynamique du langage, universite de lyon and cnrs, france']
maekawa13_interspeech	['dept. corpus studies, national institute for japanese language and linguistics, tokyo']
carignan13_interspeech	['department of french', 'department of linguistics,', 'department of electrical and computer engineering,', 'department of bioengineering, university of illinois at urbana-champaign']
renwick13_interspeech	['phonetics laboratory, university of oxford, oxford, united kingdom']
chen13k_interspeech	['national engineering laboratory of speech and language information processing,', 'university of science and technology of china, hefei, p.r. china']
wu13c_interspeech	['nanyang technological university, singapore', 'tampere university of technology, tampere, finland', 'university of eastern finland, joensuu, finland', 'institute for infocomm research, singapore']
hwang13_interspeech	['dept. of electrical and computer engineering, national chiao tung university, hsinchu, taiwan', 'research center for information technology innovation, academia sinica, taipei, taiwan', 'institute of information science, academia sinica, taipei, taiwan']
tanaka13_interspeech	['graduate school of information science, nara institute of science and technology, japan']
moriguchi13_interspeech	['graduate school of information science, nara institute of science and technology, japan', 'foster electronic company, limited, japan']
aryal13_interspeech	['department of computer science and engineering, texas a&m university, usa']
audhkhasi13_interspeech	['signal analysis and interpretation lab (sail), electrical engineering department', 'university of southern california, los angeles, ca, usa.']
bell13_interspeech	['centre for speech technology research, university of edinburgh, edinburgh eh8 9ab, uk', 'spoken language communication laboratory,', 'national institute of information and communications technology, kyoto, japan']
soltau13_interspeech	['ibm t j. watson research center, yorktown heights, ny 10598, usa']
ueffing13_interspeech	['nuance communications, inc., burlington, ma, united states']
roy13_interspeech	"['spoken language processing group, cnrs-limsi, orsay, france.', ""laboratoire national de metrologie et d'essais (lne), paris, france.""]"
golik13b_interspeech	['human language technology and pattern recognition, computer science department,', 'rwth aachen university', ' aachen, germany', 'spoken language processing group, limsi cnrs, paris, france']
kanda13_interspeech	['central research laboratory, hitachi ltd.', '-280, higashi-koigakubo, kokubunji-shi, tokyo, japan']
vandyke13_interspeech	['human-centered computing laboratory, university of canberra, australia', 'college of engineering and computer science, australian national university, australia']
kinnunen13_interspeech	['school of computing, university of eastern finland (uef), joensuu, finland', 'centre de recherche informatique de montreal (crim), montreal, canada', 'brno university of technology (but), brno, czech republic', 'inrs-emt, montreal, canada']
hasan13_interspeech	['center for robust speech systems (crss)', 'erik jonsson school of engineering & computer science', 'the university of texas at dallas (utd), richardson, tx 75080-3021, usa']
villalba13b_interspeech	['communications technology group (gtc),', 'aragon institute for engineering research (i3a),', 'university of zaragoza, spain']
zhu13b_interspeech	['ibm t j. watson research center', 'yorktown heights, ny 10598']
lee13c_interspeech	['institute for infocomm research, agency for science, technology and research (a*star), singapore']
godin13_interspeech	['center for robust speech systems (crss)', 'the university of texas at dallas, richardson, tx 75080-3021, u.s.a.']
yamada13_interspeech	['graduate school of engineering, shizuoka university, hamamatsu 432-8561, japan', 'nagaoka university of technology, nagaoka 940-2188, japan']
brutti13_interspeech	['fondazione bruno kessler-cit irst, via sommarive 18 trento, italy']
mcclanahan13_interspeech	['sandia national laboratories, albuquerque, n.m., u.s.a.', 'new mexico state university, klipsch school of elect. and comp. eng., las cruces, n.m., u.s.a.']
kanagasundaram13b_interspeech	['⋆speech research laboratory, queensland university of technology, australia', '† atvs biometric recognition group, universidad autonoma de madrid, spain']
villalba13c_interspeech	['communications technology group (gtc),', 'aragon institute for engineering research (i3a),', 'university of zaragoza, spain']
stafylakis13_interspeech	['centre de recherche informatique de montreal (crim), canada,', 'ecole de technologie superieure (ets), canada,', 'voicetrust, germany']
mallidi13_interspeech	['center for language and speech processing, johns hopkins university, baltimore, md, usa.', 'ibm t.j. watson research center, yorktown heights, ny, usa.']
rajan13b_interspeech	['school of computing, university of eastern finland']
mclaren13b_interspeech	['speech technology and research laboratory, sri international, california, usa']
mitra13b_interspeech	['speech technology and research laboratory, sri international, menlo park, ca, usa.']
hautamaki13d_interspeech	['school of computing, university of eastern finland, finland', 'ece, georgia institute of technology, usa']
fowler13_interspeech	['department of mathematics, clarkson university, potsdam, new york', 'school of electrical and computer engineering, georgia institute of technology, atlanta, ga', 'department of electrical and computer engineering, clarkson university, potsdam, new york']
shaw13_interspeech	['marcs institute, university of western sydney, australia', 'school of social sciences and psychology, university of western sydney, australia', 'school of humanities and communication arts, university of western sydney, australia']
scharenborg13_interspeech	['centre for language studies and donders institute for brain, cognition and behaviour, radboud', 'university nijmegen, the netherlands', 'max planck institute for psycholinguistics, nijmegen, the netherlands']
yasu13_interspeech	['faculty of science and technology, sophia university, japan', 'faculty of medical and health sciences, the university of auckland, new zealand', 'faculty of foreign studies, sophia university, japan']
gao13_interspeech	['laboratoire de phonetique et phonologie – cnrs / universite paris 3', 'laboratoire memoire et cognition – universite paris 5']
dekerle13_interspeech	['lassus-sangosse 2, sophie donnadieu 3', 'laboratoire l2c2, cnrs - umr 5304, auditory language processing (alp) research group,', 'lyon, france', 'chu de grenoble, centre du langage, grenoble, france', 'universite de savoie, chambery, france', 'laboratoire de psychologie et neurocognition, cnrs - umr 5105, grenoble, france']
varnet13_interspeech	['lyon neuroscience research center, cnrs umr 5292,', 'auditory language processing (alp) research group, lyon, france.', 'stem cell and brain research institute, inserm u 846,', 'integrative neuroscience department, bron, france.', 'laboratoire sur le langage le cerveau et la cognition, cnrs umr 5304,', 'auditory language processing (alp) research group, lyon, france.', 'universite de lyon, lyon 1, lyon, france']
brackhane13_interspeech	['institut fur deutsche sprache (ids), mannheim, germany', 'computational linguistics and phonetics, saarland university, saarbrucken, germany']
ghosh13_interspeech	['department of electrical engineering, indian institute of science (iisc), bangalore, india', 'department of electrical engineering, university of southern california, los angeles, u.s.a.']
fejlova13_interspeech	['institute of phonetics, faculty of arts, charles university in prague, czech republic']
liu13h_interspeech	['tianjin university, tianjin, china', 'japan advanced institute of science and technology, ishikawa, japan', 'institute of linguistics, chinese academy of social sciences, beijing, china', '\x02 corresponding author']
skarnitzl13_interspeech	['institute of phonetics, faculty of arts, charles university in prague, czech republic']
maeda13_interspeech	['cnrs ltci; telecom paristech, paris, france', 'loria cnrs umr7503, villers-les-nabcy, france']
grootswagers13_interspeech	['artificial intelligence department, radboud university nijmegen, the netherlands', 'max planck institute for psycholinguistics nijmegen, the netherlands', 'cls/clst, radboud university nijmegen,the netherlands', 'radboud university nijmegen, donders institute for brain, cognition and behaviour,', 'the netherlands', '∗these authors contributed equally']
gowda13b_interspeech	['department of signal processing and acoustics, aalto university, finland']
tajima13_interspeech	['department of psychology, hosei university, tokyo, japan', 'riken brain science institute, saitama, japan', 'department of psychology and neuroscience, duke university, durham, nc, usa']
chen13l_interspeech	['department of electrical engineering, university of california, los angeles, usa', 'department of head and neck surgery, school of medicine, university of california, los angeles, usa']
kim13f_interspeech	['school of electrical and computer engineering', 'georgia institute of technology', 'atlanta, ga 30332, usa']
yasuda13_interspeech	['institute of phonetics, goethe-university, frankfurt, germany', 'graduate school of language and culture, osaka university, japan', 'institute of phonetics, saarland university, saarbrucken, germany']
smith13c_interspeech	['department of linguistics, university of southern california, los angeles, ca, usa', 'department of computer science, university of southern california, los angeles, ca, usa']
deng13_interspeech	['speech and audio signal processing laboratory,', 'school of electronic information and control engineering,', 'beijing university of technology, beijing 100124, china']
zheng13_interspeech	"[""department of electrical & computer engineering, queen's university, kingston, canada""]"
turan13_interspeech	['multimedia, vision and graphics laboratory,', 'college of engineering, koc university, istanbul, turkey']
roman13_interspeech	['department of computer science and engineering, the ohio state university, lima, usa', 'department of computer science and engineering, the ohio state university, usa']
kim13g_interspeech	['school of information and communications', 'gwangju institute of science and technology (gist), gwangju 500-712, korea']
lu13c_interspeech	['national institute of information and communications technology, japan']
khan13_interspeech	['school of computing sciences, university of east anglia, norwich, uk']
chuang13_interspeech	['department of electrical and computer engineering', 'national chiao tung university, hsinchu, taiwan 300, r.o.c.']
abrol13_interspeech	['uiet, panjab university, chandigarh, india', 'iit mandi, india']
grais13b_interspeech	['faculty of engineering and natural sciences', 'sabanci university, orhanli tuzla', ', istanbul, turkey.']
kaewtip13_interspeech	['department of electrical engineering, university of california, los angeles, california, usa']
mccallum13b_interspeech	['department of electrical and computer engineering', 'the university of auckland, auckland, new zealand']
maymon13b_interspeech	['ibm t j. watson research center, yorktown heights, ny, usa']
uezu13_interspeech	['kyushu university, fukuoka, japan', 'ntt communication science laboratories, kyoto, japan']
yang13c_interspeech	['department of engineering, university of cambridge', 'trumpington street, cambridge, cb2 1pz, uk']
giuliani13_interspeech	['human language technology research unit', 'fbk-irst - fondazione bruno kessler', 'via sommarive 18', ' trento, italy']
telaar13_interspeech	['cognitive systems lab, karlsruhe institute of technology, germany', 'm*modal inc., pittsburgh, pa, usa']
wiesler13_interspeech	['human language technology and pattern recognition', 'computer science department, rwth aachen university', ' aachen, germany', 'microsoft corporation, redmond, wa', ', usa']
saiko13_interspeech	['spoken language communication laboratory,', 'national institute of information and communication technology, kyoto, japan', 'information and media processing laboratories, nec corporation, kanagawa, japan']
fujimura13_interspeech	['corporate research and development center, toshiba corporation']
ogawa13_interspeech	['dept. of computer science, waseda university,', 'center for language and speech processing, johns hopkins university,', 'human language technology center of excellence, johns hopkins university']
yoma13_interspeech	['speech processing and transmission laboratory, department of electrical engineering,', 'universidad de chile, santiago, chile', 'department of electrical engineering, universidad de la frontera, temuco, chile']
triefenbach13_interspeech	['elis multimedia lab, ghent university/iminds, sint-pietersnieuwstraat 41, b-9000, ghent, belgium']
fragasilva13_interspeech	['limsi - cnrs, b.p. 133', ' orsay, france', 'universite paris-sud', ' orsay, france']
tahir13_interspeech	['human language technology and pattern recognition', 'computer science department, rwth aachen university, germany', 'centre for language and speech technology, radboud university nijmegen, the netherlands', 'spoken language processing group, limsi cnrs, paris, france']
parinam13_interspeech	['department of electrical and computer engineering', 'binghamton university, binghamton, ny 13902, usa']
sanand13_interspeech	['norwegian university of science and technology, trondheim, norway']
abdelhamid13c_interspeech	['department of computer science and engineering, york university, toronto, ontario, canada', 'microsoft research, redmond, wa usa']
mariani13_interspeech	['limsi-cnrs', 'immi-cnrs', 'tagmatica']
shaik13_interspeech	['human language technology and pattern recognition,', 'computer science department, rwth aachen university, aachen, germany', 'spoken language processing group, limsi cnrs, paris, france']
mousa13_interspeech	['human language technology and pattern recognition,', 'computer science department, rwth aachen university, aachen, germany', 'spoken language processing group, limsi cnrs, paris, france']
lambert13_interspeech	['language technologies institute, carnegie mellon university, usa']
si13_interspeech	['the key laboratory of speech acoustics and content understanding,', 'chinese academy of sciences, beijing 100190, p.r.china']
liu13i_interspeech	['cambridge university engineering dept,', 'trumpington st., cambridge, cb2 1pz u.k.']
masumura13_interspeech	['ntt media intelligence laboratories, ntt corporation, japan']
backstrom13_interspeech	['international audio labs erlangen, fraunhofer iis, erlangen, germany']
moller13_interspeech	['quality and usability lab, telekom innovation labs, tu berlin, germany', 'institute of electronics, microelectronics and nanotechnology, isen department, lille, france', 'institute for communications technology, technische universitat braunschweig, germany', 'institut fur nachrichtengerate und datenverarbeitung, rwth aachen, germany', 'dept. of signal processing and acoustics, aalto university, finland', 'nokia smart devices, finland']
xia13b_interspeech	['speech and audio signal processing lab, school of electronic information and control', 'engineering, beijing university of technology, beijing 100124, china']
cernak13_interspeech	['idiap reseach institute', 'beijing institute of technology']
duy13_interspeech	['the university of tokyo, tokyo, japan', '. abstract', 'artificial bandwidth extension (abe) has been introduced to', 'improve perceived speech quality and intelligibility of narrow-', 'band telephone speech. most of the existing algorithms divided', 'abe into 2 sub-problems, namely extension of the excitation', 'signal and that of the spectral envelope. in this paper, we pro-', 'pose a new method for spectral envelope extension based on', 'regularized piecewise linear mapping with discriminative re-', 'gion weighting and long-span features (redial). redial is', 'a revised version of splice, a well-known method for speech', 'enhancement. in redial, however, discriminative model is', 'introduced for space division step of the original splice.', 'the proposed redial-based method approximates non-linear', 'transformation from narrowband features to their wideband', 'counterpart by a summation of piecewise linear transforma-', 'tions. the proposed method was compared with the widely used', 'gmm-based method, through objective and subjective evalua-', 'tions in both speaker-dependent and speaker-independent con-', 'ditions. both evaluations showed that the proposed method sig-', 'nificantly outperforms the conventional gmm-based method.', 'index terms: artificial bandwidth extension, redial, spec-', 'tral envelope extension, objective and subjective evaluations', '. introduction', 'although human ears are able to perceived sound at much', 'higher ferquencies than 8 khz, and often more than 15 khz,', 'traditional telephone networks were designed to limit the fre-', 'quency to a lower range, approximately below 3.4 khz, in order', 'to conserve the bandwidth and increase the number of voice', 'streams transmittable by a transmission channel. this results', 'in degradation of perceptual speech quality of the narrowband', 'speech at receiving end. true wideband transmission is there-', 'fore desirable, but this requires a significant amount of cost and', 'time, since the whole transmission chain including terminals', 'and network elements need to be upgraded. this challenge can', 'be overcome with artificial bandwidth extension (abe) tech-', 'nique. abe is a technique that tries to recover missing low and', 'high frequency components of the speech signal only from the', 'narrowband speech. by integrating abe into terminals of the', 'telephone networks, we can easily realize wideband transmis-', 'sion without modifying the networks.', 'a number of techniques have been proposed over the years', 'for bandwidth extension of narrowband speech signals, includ-', 'ing methods based on codebook mapping [1] and statistical ap-', 'proaches [2', '', ']. most of these abe algorithms are based', 'on the source-filter model [5] of speech production whereby the', 'speech signal is regarded as output of the vocal tract filter which', 'takes excitation source signals as input. this model breaks the', 'problem down into two subtasks: one is to extend the spec-', 'tral envelope, and the other is to extend the excitation signal.', 'the extension of spectral envelope is typically considered as', 'the main problem of abe since it had been shown that exten-', 'sion of the spectral envelope has a large effect on speech quality', 'of the reconstructed wideband speech [6].', 'it is known that the gaussian mixture model (gmm) [7]', 'represents robustly the acoustic space of speech and was suc-', 'cessfully applied to the problem of spectral transformation, es-', 'pecially voice conversion [8]. based on the successes in voice', 'conversion, in [4] an effective approach to the problem of ex-', 'tending the spectral envelope was proposed. in this approach,', 'the spectral envelope of wideband speech was estimated using', 'a gmm trained by parallel data of narrowband speech and its', 'corresponding wideband speech. this approach showed that', 'there was a large improvement in speech quality from the orig-', 'inal narrowband speech to the reconstructed wideband speech.', 'however, the gap between the reconstructed wideband and the', 'original wideband speech was still large.', 'stereo-based piecewise linear compensation for environ-', 'ments (splice) [9], in which non-linear transformation be-', 'tween two feature vectors is approximated by the summation', 'of piecewise linear transformations, is an effective and widely', 'used method in speech enhancement.', 'a revised version of', 'splice, in which a discriminative model, long-span features', 'and regularization are introduced into splice, was proposed', '[10', '] and has been shown to outperform the original splice.', 'this revised version was named regularized piecewise linear', 'mapping with discriminative region weighting and long-span', 'features (redial). the aim of spectral envelope extension,', 'which is to make a transformation from spectral envelope of', 'narrowband speech to that of wideband speech, is very similar', 'to the scheme of redial. this suggests that we can apply re-', 'dial to the problem of spectral envelope extension as it is. in', 'this paper, we propose an approach to the problem of spectral', 'envelope extension based on redial and describe its effec-', 'tiveness through objective and subjective evaluations.', 'this paper is organized as follow. section. 3 describes the', 'conventional abe method based on gmm. section. 4 gives', 'a brief view of splice and our proposed redial-based', 'method. the general process of abe is discussed in section. 5.', 'section. 6 describes experiments and results.', '. gmm-based bandwidth extension [4', ']', 'let x = [x⊤', ', x⊤', ', ..., x⊤', 'n]⊤be the feature vectors charac-', 'terizing the narrowband and y = [y⊤', ', y⊤', ', ..., y⊤', 'n]⊤be the', 'feature vectors characterizing the wideband speech.', 'xt =', '[x⊤', 't , ∆x⊤', 't ]⊤and yt = [y⊤', 't , ∆y⊤', 't ]⊤define feature vectors', 'consisting of static and dynamic features at frame t of narrow-', 'band and wideband speech, respectively.', 'in the training step, we model the joint probability density', 'of the source and the target features by a gmm as follows:', 'p(zt; θ) =', 'm', '∑', 'm=1', 'ωmn(zt; µ(z)', 'm , σ(z)', 'm )', '(1)', 'θ defines a parameter set of gmm, which consisting of weights', 'ωm, mean vectors µ(z)', 'm', 'and covariance matrices σ(z)', 'm . m is', 'the total number of mixture components of gmm, and m is', 'copyright © 2013 isca', '-29 august 2013, lyon, france', 'interspeech 2013', '.21437/interspeech.2013-756']
lee13d_interspeech	['department of electronics computer engineering', 'hanyang university, seoul, korea']
nguyen13b_interspeech	['international research institute mica, hust – cnrs/umi-2954 – grenoble inp,', 'hanoi university of science and technology', 'langues et civilisations a tradition orale (lacito), cnrs – univ. paris 3 sorbonne nouvelle']
nichasaide13_interspeech	['phonetics and speech laboratory, centre for language and communication studies', 'trinity college dublin, ireland']
lee13e_interspeech	"['dept. of speech, hearing and phonetic sciences, university college london, uk', ""dept. of computer engineering, king mongkut's university of technology thonburi, thailand.""]"
lvenbruck13_interspeech	['mathilde', 'spini6, maud champagne-lavau6', 'gipsa-lab, speech & cognition department, umr cnrs 5216, univ. grenoble-alpes', ' lpnc,', 'umr cnrs 5105, univ. grenoble-alpes', ' lne, paris', ' limsi upr 3251, paris', ' lpp umr', ', paris', ' aix-marseille universite, cnrs, lpl, umr 7309, aix-en-provence, france,', 'institut universitaire de france']
menard13_interspeech	['laboratoire de phonetique, departement de linguistique, uqam, montreal, canada', 'haskins laboratories, new haven, usa']
georgeton13_interspeech	['laboratoire de phonetique et de phonologie, umr 7018 cnrs/univ. sorbonne nouvelle paris 3']
cooke13_interspeech	['basque foundation for science, bilbao, spain', 'language and speech laboratory, university of the basque country, vitoria, spain', 'centre for speech technology research, university of edinburgh, uk']
erro13_interspeech	['aholab, university of the basque country, bilbao, spain', 'ikerbasque, basque foundation for science, bilbao, spain', 'politehnica university of bucharest, bucharest, romania', 'forth & university of crete, heraklion, greece']
suni13_interspeech	['department of behavioural sciences, university of helsinki, helsinki, finland', 'department of signal processing and acoustics, aalto university, espoo, finland']
valentinibotinhao13_interspeech	['centre for speech technology research, university of edinburgh, edinburgh, uk', 'national institute of informatics, tokyo, japan', 'institute of computer science, foundation of research and technology hellas, crete, greece']
godoy13c_interspeech	['institute of computer science, foundation of research and technology hellas, crete, greece']
schepker13_interspeech	['university of oldenburg, department of medical physics and acoustics,', 'signal processing group, oldenburg, germany', 'fraunhofer idmt, project group hearing-, speech-, and audio technology,', 'oldenburg, germany']
taal13_interspeech	['leiden university medical center, leiden, the netherlands', 'aalborg university, aalborg, denmark', 'oticon a/s, smoerum, denmark']
zhang13e_interspeech	['school of electrical engineering, kth-royal institute of technology, stockholm, sweden', 'school of engineering and computer science, victoria university of wellington, new zealand']
aubanel13_interspeech	['language and speech laboratory, university of the basque country, vitoria, spain', 'ikerbasque (basque foundation for science)']
petkov13_interspeech	['school of electrical engineering, kth-royal institute of technology, stockholm, sweden', 'school of engineering and computer science, victoria university of wellington, new zealand']
brouckxon13_interspeech	['vrije universiteit brussel, dept. etro-dssp, pleinlaan 2, b-1050 brussels, belgium', 'iminds, dept. of future media and imaging, g crommenlaan 8, b-9050 ghent, belgium']
takou13_interspeech	['nhk (japan broadcasting corporation)', 'science and technology research laboratories, tokyo, japan']
