paper_id	affiliations
zhang14_interspeech	['mit computer science and artificial intelligence laboratory,', 'cambridge, massachusetts 02139, usa']
do14_interspeech	['school of computer engineering, nanyang technological university, singapore', 'institute for infocomm research, a*star, singapore']
vu14_interspeech	['karlsruhe institute of technology, germany']
knill14_interspeech	['department of engineering, university of cambridge', 'trumpington street, cambridge cb2 1pz, uk.']
bell14_interspeech	['centre for speech technology research, university of edinburgh, edinburgh eh8 9ab, uk']
razavi14_interspeech	['idiap research institute, ch-1920 martigny, switzerland', 'ecole polytechnique federale de lausanne (epfl), ch-1015 lausanne, switzerland']
tanaka14_interspeech	['graduate school of information science, nara institute of science and technology, japan']
niekerk14_interspeech	['centre for text technology, north-west university, potchefstroom, south africa', 'multilingual speech technologies, north-west university, vanderbijlpark, south africa']
vadapalli14_interspeech	['speech and vision lab, iiit hyderabad']
che14_interspeech	['institute of automation, chinese academy of sciences, beijing, china']
dall14_interspeech	['the centre for speech technology research, university of edinburgh, uk', 'cambridge university engineering department, university of cambridge, uk']
dall14b_interspeech	['the centre for speech technology research, university of edinburgh, uk', 'ppls, university of edinburgh, uk']
khoury14_interspeech	['†idiap research institute, switzerland', '∗school of computing, university of eastern finland, finland', '‡school of computer engineering, nanyang technological university, singapore']
leary14_interspeech	['raytheon bbn technologies']
fredouille14_interspeech	['university of avignon, ceri/lia, france', 'orange labs, lannion, france']
laurent14_interspeech	['limsi-cnrs, orsay, france', 'lium, universite du maine, le mans, france', 'irisa-insa, rennes, france']
raimond14_interspeech	['bbc r&d']
kelly14_interspeech	['department of electronic & electrical engineering, trinity college dublin, ireland', 'speech and image processing unit, school of computing, university of eastern finland', 'centre for language and speech technology, radboud university nijmegen, the netherlands']
versteegh14_interspeech	['lscp, ehess, dec-iec-ens-psl*, cnrs, france', 'speech, language, and hearing sciences, purdue university, usa', 'lscp, cnrs, dec-iec-ens-psl*, ehess, france']
airaksinen14_interspeech	['department of signal processing and acoustics, aalto university, finland']
rose14_interspeech	['division of humanities, hong kong university of science and technology', 'college of asia and the pacific, australian national university']
hamzah14_interspeech	['division of linguistics & multilingual studies', 'nanyang technological university, singapore']
reichel14_interspeech	['institute of phonetics and speech processing, university of munich', 'institute for linguistics, hungarian academy of sciences, budapest, hungary']
christodoulides14_interspeech	['centre valibel, institute for language & communication, universite de louvain, belgium', 'umr 7110-llf (laboratoire de linguistique formelle), universite paris-diderot']
chen14_interspeech	['department of electrical engineering, university of california, los angeles, usa', 'department of head and neck surgery, school of medicine, university of california, los angeles, usa']
delaisroussarie14_interspeech	['umr 7110-llf (laboratoire de linguistique formelle), universite paris-diderot', 'irisa, university of rennes 1, lannion, france', 'voxygen, lannion, france']
sung14_interspeech	['university of arizona, tucson, az, u.s.a.']
archangeli14_interspeech	['university of hong kong', 'university of arizona']
amino14_interspeech	['national research institute of police science, japan', 'konan university, japan']
brown14_interspeech	['university of auckland']
jackschina14_interspeech	['forschungsstelle ¨osterreichisches deutsch, university of graz, austria', 'signal processing and speech communication laboratory, graz university of technology, austria']
hu14_interspeech	['institute of linguistics, chinese academy of social sciences', 'department of linguistics, graduate school, chinese academy of social sciences']
dellwo14_interspeech	['department of comparative linguistics, university of zurich', 'department of linguistics and modern languages, the chinese university of hong kong']
braun14_interspeech	['department of phonetics, university of trier, germany']
kasisopa14_interspeech	['marcs institute, university of western sydney, australia']
pappu14_interspeech	['language technologies institute', 'carnegie mellon university']
misu14_interspeech	['honda research institute usa', 'mountain view, ca']
higashinaka14_interspeech	['ntt media intelligence laboratories', 'ntt communication science laboratories']
bechet14_interspeech	['aix marseille universite, cnrs-lif']
gasic14_interspeech	['cambridge university engineering department, trumpington street, cambridge, uk']
robichaud14_interspeech	['microsoft corporation, redmond wa 98052, usa']
ramanarayanan14_interspeech	['department of electrical engineering, university of southern california, los angeles, ca', 'department of linguistics, university of southern california, los angeles, ca']
yeh14_interspeech	['department of linguistics and languages, michigan state university, usa', 'department of asian languages and civilizations, university of colorado boulder, usa', 'center of learning technology for chinese, national taiwan normal university, taiwan']
windmann14_interspeech	['faculty for linguistics and literary studies, bielefeld university, germany', 'institute of behavioral sciences, university of helsinki, finland']
kim14_interspeech	['signal analysis and interpretation laboratory, university of southern california, los angeles, usa']
sudhakar14_interspeech	['icteam/elen, universite catholique de louvain, belgium.', 'department of electrical engineering, indian institute of science (iisc), bangalore, india.']
wang14b_interspeech	['department of bioengineering', 'callier center for communication disorders', 'university of texas at dallas, dallas, texas, usa']
liu14b_interspeech	['leiden university center for linguistics, leiden university, the netherlands', 'center for studies of chinese as a second language, beijing language and culture', 'university, beijing, china', 'school of computer science, beijing language and culture university, beijing, china']
abuoudeh14_interspeech	['laboratoire de linguistique de nantes −lling / ea3827', 'universite de nantes, chemin de la censive du tertre', 'nantes cedex −france']
roberts14_interspeech	['faculty of linguistics, philology and phonetics, university of oxford, united kingdom', 'institut fur phonetik, goethe-universitat frankfurt, germany']
bush14_interspeech	['center for spoken language understanding, oregon health & science university, portland, or']
daoudi14_interspeech	['inria bordeaux-sud ouest. geostat team', 'av. de la vieille tour. 33405 talence. france.', 'university of bordeaux 1', 'cours de la liberation. 33405 talence. france.']
bukmaier14_interspeech	['institute of phonetics and speech processing, university of munich, germany']
gupta14_interspeech	['signal analysis and interpretation lab (sail), department of electrical engineering', 'university of southern california, los angeles, ca', 'department of psychiatry and behavioral sciences, university of washington, seattle, wa, usa']
xiao14_interspeech	['sail, dept. electrical engineering, university of southern california, u.s.a.', 'dept. educational psychology, university of utah, u.s.a.', 'dept. psychiatry & behavioral sciences, university of washington, u.s.a.', 'http://sail.usc.edu']
bone14_interspeech	['signal analysis and interpretation laboratory (sail), usc, los angeles, ca, usa', 'electrical engineering department, national tsing hua university, taiwan.', 'http://sail.usc.edu']
han14_interspeech	['department of computer science and engineering,', 'the ohio state university, columbus', ', oh, usa', 'microsoft research, one microsoft way,', 'redmond', ', wa, usa']
truong14_interspeech	['university of twente, human media interaction group, enschede, the netherlands', 'university of twente, dept. of psychology, health and technology, enschede, the netherlands', 'erasmus university rotterdam, erasmus studio, rotterdam, the netherlands']
he14_interspeech	['phonetics laboratory, university of zurich, switzerland']
mariooryad14_interspeech	['multimodal signal processing (msp) laboratory, department of electrical engineering', 'the university of texas at dallas, richardson tx 75080, usa']
safavi14_interspeech	['school of electronic, electrical & computer engineering, university of birmingham, uk']
morchid14_interspeech	['†lia, university of avignon, france', '‡mcgill university, school of computer science, montreal, quebec, canada']
marin14_interspeech	['university of washington, seattle, wa 98195', 'microsoft corporation, redmond, wa 98052']
xu14_interspeech	['microsoft corporation, redmond wa 98052, usa']
shiang14_interspeech	['graduate institute of electrical engineering, national taiwan university', 'graduate institute of communication engineering, national taiwan university']
sarikaya14_interspeech	['microsoft corporation, redmond, wa 98052']
shi14_interspeech	['ipe, microsoft']
zhang14b_interspeech	['speech and hearing research center', 'school of electronics engineering and computer science', 'peking university, beijing, china']
tur14_interspeech	['microsoft, usa']
georgiladakis14_interspeech	['school of electronic & computer eng., technical university of crete, chania, greece', 'cognitive interaction technology - center of excellence (citec), bielefeld university, germany', 'school of electrical & computer eng., national technical univ. of athens, zografou, greece']
katerenchuk14_interspeech	['cuny graduate center, new york, usa', 'cuny queens college, new york, usa']
ravuri14_interspeech	['international computer science institute, berkeley, ca, usa', 'microsoft research, mountain view, ca, usa']
freeman14_interspeech	['department of linguistics', 'department of electrical engineering', 'university of washington', 'seattle, wa usa']
ghigi14_interspeech	['dpto. electricidad y electronica, universidad del pais vasco, bilbao, spain', 'language technologies institute, carnegie mellon university, pittsburgh, pennsylvania']
hotta14_interspeech	['graduate school of engineering, nagoya university, japan', 'honda research institute japan, co., ltd., japan']
hassan14_interspeech	['microsoft research']
watanabe14_interspeech	['mitsubishi electric research laboratories (merl), cambridge, ma, usa', 'information technology r&d center, mitsubishi electric, kamakura, japan']
kim14b_interspeech	['department of engineering, university of cambridge, cambridge, uk']
kane14_interspeech	['phonetics and speech laboratory,', 'school of linguistic, speech and communication sciences,', 'trinity college dublin, ireland', 'dublin institute of technology, ireland']
sak14_interspeech	['google, usa']
saon14_interspeech	['ibm t j. watson research center, yorktown heights, ny']
tomar14_interspeech	['department of electrical and computer engineering, mcgill university, montreal, qc, canada']
li14_interspeech	['school of computing, national university of singapore, singapore']
li14b_interspeech	['center for language and speech processing', 'johns hopkins university, baltimore, md']
seps14_interspeech	['faculty of mechatronics, informatics, and interdisciplinary studies,', 'technical university of liberec, studentska 2', ' 17 liberec, czech republic.']
banse14_interspeech	['national institute of standards and technology, gaithersburg, md', 'human language technology center of excellence, johns hopkins university, baltimore, md', 'mit lincoln laboratory, lexington, ma', '*guest researcher']
leeuwen14_interspeech	['netherlands forensic institute, the hague and radboud university nijmegen, the netherlands', 'agnitio research, somerset west, south africa']
novoselov14_interspeech	['department of speaker verification and identification,', 'speech technology center ltd., st. petersburg, russia', 'itmo university, russia']
shum14_interspeech	['mit computer science and artificial intelligence laboratory, cambridge, ma, usa']
brummer14_interspeech	['agnitio research, south africa']
ishihara14_interspeech	['department of linguistics, the australian national university, australia']
airaksinen14b_interspeech	['department of signal processing and acoustics, aalto university, finland', 'international audio laboratories erlangen, friedrich-alexander university (fau), germany']
rosa14_interspeech	['departamento academico de eletrotecnica', 'universidade tecnologica federal do parana', 'av. sete de setembro', ', reboucas', '-901, curitiba, parana, brazil']
takemoto14_interspeech	['national institute of information and communications technology, japan', 'faculty of intelligence and informatics, konan university, japan']
kim14c_interspeech	['signal analysis and interpretation laboratory, university of southern california, los angeles, usa', 'kanazawa medical university, kanazawa, japan']
hewer14_interspeech	['cluster of excellence multimodal computing and interaction, saarland university, germany', 'dfki language technology lab, saarbrucken, germany', 'computation linguistics & phonetics, saarland university, germany', 'saarbrucken graduate school of computer science, germany']
kaburagi14_interspeech	['kyushu university', '-9-1 shiobaru, minami-ku, fukuoka, japan']
benitez14_interspeech	['†department of linguistics, university of southern california, usa', '‡ming hsieh department of electrical engineering, university of southern california, usa']
arai14_interspeech	['department of information and communication sciences', 'sophia university, tokyo, japan']
rong14_interspeech	['mgh institute of health professions, boston, usa', 'department of speech-language pathology, university of toronto, toronto, canada', 'mda als clinic, massachusetts general hospital, boston, usa', 'als/mnd clinic, sunnybrook health sciences centre,', 'department of neurology, university of toronto, toronto, canada']
p14_interspeech	['department of electrical communication engineering, iisc, bangalore, india', 'department of electrical engineering, iisc, bangalore, india']
ji14_interspeech	['electrical and computer engineering, marquette university, milwaukee, wi, usa', 'speech pathology and audiology, marquette university, milwaukee, wi, usa']
uchida14_interspeech	['graduate school of design, kyushu university', '-9-1 shiobaru, minami-ku, fukuoka, japan', 'faculty of design, kyushu university', '-9-1 shiobaru, minami-ku, fukuoka, japan']
schuller14_interspeech	['imperial college london, department of computing, machine learning group, uk', 'tu munchen, machine intelligence & signal processing group, germany', 'fau erlangen-nurnberg, pattern recognition lab, germany', 'the university of new south wales, australia', 'national ict australia, australia']
pohjalainen14_interspeech	['department of signal processing and acoustics, aalto university, espoo, finland']
li14c_interspeech	['sysu-cmu joint institute of engineering, sun yat-sen university, guangzhou, china', 'sysu-cmu shunde international joint research institute, shunde, china']
kaya14_interspeech	['department of computer engineering, bogazici university', ', bebek, ˙istanbul, turkey', 'marmara research center, t ub˙itak', ', gebze, kocaeli, turkey']
jing14_interspeech	['research center for information technology innovation, academia sinica', 'graduate institute of communication engineering, national taiwan university', 'institute of information science, academia sinica', 'department of electrical engineering, national tsing hua university']
gosztolya14_interspeech	['mta-szte research group on artificial intelligence, szeged, hungary']
montacie14_interspeech	['stih laboratory, paris sorbonne university', ' rue serpente', ', paris, france']
nwe14_interspeech	['human language technology department, institute for infocomm research (i2r), a*star,', 'singapore 138632']
huckvale14_interspeech	['speech, hearing and phonetic sciences, university college london, london, u.k.']
kua14_interspeech	['the school of electrical engineering and telecommunications,', 'the university of new south wales, sydney nsw 2052, australia', 'national ict australia (nicta), australian technology park, eveleigh 1430, australia']
segbroeck14_interspeech	['signal analysis & interpretation laboratory, univ. of southern california, los angeles, ca', 'information sciences institute, univ. of southern california, marina del rey, ca', 'behavioral informatix, llc, los angeles, ca', 'http://sail.usc.edu,', 'www.isi.edu,', 'www.behavioralinformatix.com']
iyer14_interspeech	['air force research laboratory', ' ball aerospace; wright patterson air force base, oh']
bosch14_interspeech	['radboud university nijmegen', 'max planck institute for psycholinguistics']
andrei14_interspeech	['university “politehnica” of bucharest, romania']
li14d_interspeech	['department of linguistics and modern languages, cuhk', 'department of linguistics and modern languages, and joint research centre for language and', 'human complexity, cuhk;', 'shenzhen institutes of advanced technology, cas']
lin14_interspeech	['research center for information technology innovation, academia sinica, taipei, taiwan', 'division of speech & hearing sciences, the university of hong kong, hong kong']
lai14_interspeech	['research center for information technology innovation, academia sinica, taipei, taiwan', 'division of speech and hearing sciences, the university of hong kong, hong kong, china']
helfer14_interspeech	['mit lincoln laboratory, lexington, massachusetts, usa', 'purdue university, west lafayette, indiana, usa', 'usariem, natick, ma, usa', 'abstract1', 'speech analysis has shown potential for identifying', 'neurological impairment. with brain trauma, changes in brain', 'structure or connectivity may result in changes in source,', 'prosodic, or articulatory aspects of voice. in this work, we', 'examine the articulatory components of speech reflected in', 'formant tracks, and how changes in track dynamics and', 'coordination map to cognitive decline. we address a', 'population of athletes regularly receiving impacts to the head', 'and showing signs of preclinical mild traumatic brain injury', '(mtbi), a state indicated by impaired cognitive performance', 'occurring prior to concussion. we hypothesize that this', 'preclinical damage results in 1) changes in average vocal tract', 'dynamics measured by formant frequencies, their velocities,', 'and acceleration, and 2) changes in articulatory coordination', 'measured by a novel formant-frequency cross-correlation', 'characterization. these features allow machine learning', 'algorithms to detect preclinical mtbi identified by a battery of', 'cognitive tests. a comparison is performed of the effectiveness', 'of', 'vocal', 'tract', 'dynamics', 'features', 'versus', 'articulatory', 'coordination features.  this evaluation is done using receiver', 'operating characteristic (roc) curves along with confidence', 'bounds.  the articulatory dynamics features achieve area', 'under the roc curve (auc) values between 0.72 and 0.98,', 'whereas the articulatory coordination features achieve auc', 'values between 0.94 and 0.97.', 'index terms: concussion, formant dynamics, formant', 'coordination, speech analysis, mild traumatic brain injury', '(mtbi)', '. introduction', 'traumatic brain injury is known to affect various components', 'of voice including the source, prosody, and articulation of', 'production. these observations have been exploited in speech', 'pathology for diagnosis [1] and in automatic detection of', 'traumatic events from vocal features [2]. in this paper, we', 'focus on the articulation component of production, as', 'manifested by vocal tract formant frequencies. previous', 'this work is sponsored by the assistant secretary of defense', 'for research & engineering under air force contract', '#fa8721-05-c-0002. opinions, interpretations, conclusions,', 'and recommendations are those of the authors and are not', 'necessarily endorsed by the united states government.', 'studies have shown that changes in average formant-frequency', 'dynamics [3] or in a novel characterization of articulatory', 'coordination using formant track correlations [4] can be used', 'to identify or predict depression severity as determined  by', 'standard clinical assessment. this paper investigates both of', 'these vocal tract formant representations in a population', 'showing non-physician assessed cognitive impairment. this is', 'a common occurrence among football and soccer athletes, who', 'regularly receive head impacts [5][6]. while each impact may', 'not cause a concussion, also known as a mild traumatic brain', 'injury (mtbi), repeated exposure to head impacts can cause', 'neurocognitive and neurophysiological impairments prior to', 'concussion (preclinical mtbi) [6]. in order to limit the long-', 'term neurological deficits due to repeated preclinical injury,', 'we aim to develop an easily obtainable biomarker for detecting', 'cognitive change. specifically, we hypothesize that a classifier', 'trained using formant track dynamics and coordination will be', 'able to reliably predict cognitive decline. such a classifier', 'could detect preclinical damage that accumulates prior to', 'concussion, and determine readiness to return to activity by', 'identifying the point at which an individual has returned to', 'baseline neurocognitive function.', 'this work is motivated by prior clinical and automatic', 'classification research, which has demonstrated a relation', 'between head trauma and signals associated with vocal', 'dynamics [1][2]. using speech collected from a group of 32', 'high school athletes reciting a standard read passage, we', 'extract', 'formant', 'tracks', 'and', 'measure', 'dynamics-', 'and', 'coordination-based features. these features are applied to a', 'support vector machine (svm) classifier to detect changes in', 'cognitive performance, determined by the immediate post-', 'concussion assessment and cognitive testing (impact)', 'suite [7] in three areas: visual memory, visual motor speed,', 'and reaction time. the ability to detect cognitive performance', 'decline based on these features is evaluated using receiver', 'operator characteristic (roc) curves.', 'the paper is organized as follows. in section 2, we', 'describe the high school football- and soccer-athlete data', 'collection, including the impact cognitive test. section 3', 'provides methods to extract features based on dynamics and', 'coordination of formant tracks, while section 4 gives results of', 'correlating these features with components of the impact', 'test. guided by correlation results, section 5 describes a two-', 'class (presence or absence of cognitive impairment) classifier', 'design, and its performance. finally, section 6 relates our', 'approach to prior work, with section 7 describing future plans.', 'copyright © 2014 isca', '-18 september 2014, singapore', 'interspeech 2014', '.21437/interspeech.2014-121']
jinbo14_interspeech	['graduate school of information science, nara institute of science and technology,', '-5 takayama-cho, ikoma, nara 630-0192, japan']
wang14c_interspeech	['dept. of electrical engineering, university of texas at dallas', 'dept. speech language and hearing sciences, university of colorado at boulder']
fogerty14_interspeech	['department of communication sciences and disorders, university of south carolina, usa', 'division of speech and hearing sciences, the university of hong kong, china']
mittal14_interspeech	['international institute of information technology, hyderabad, india']
wester14_interspeech	['the centre for speech technology research, the university of edinburgh, uk', 'language and speech laboratory, university of the basque country, vitoria, spain', 'basque foundation for science, bilbao, spain']
coupe14_interspeech	['laboratoire dynamique du langage umr5596, universite de lyon and cnrs, france']
coumans14_interspeech	['centre for language studies, radboud university nijmegen, the netherlands', 'imprs for language sciences, nijmegen, the netherlands', 'donders institute for brain, cognition and behaviour, radboud university nijmegen, the', 'netherlands']
wong14_interspeech	['hong kong baptist university']
burgos14_interspeech	['department of linguistics, radboud university nijmegen, the netherlands', 'faculty of information technology and bionics, pazmany peter catholic university, hungary']
lengeris14_interspeech	['department of theoretical and applied linguistics, aristotle university of thessaloniki, greece']
detey14_interspeech	['sils, waseda university, japan', 'elcf, geneva university, switzerland', 'hankuk university of foreign studies, south korea', 'tokyo university of foreign studies, japan']
pinter14_interspeech	['school of languages and communication, kobe university, japan', 'graduate school of inter-cultural studies, kobe university, japan', 'department of english, kobe college, japan']
kalathottukaren14_interspeech	['discipline of speech science, the university of auckland, new zealand']
drozdova14_interspeech	['centre for language studies, radboud university nijmegen, the netherlands', 'imprs for language sciences, nijmegen, the netherlands', 'donders institute for brain, cognition and behaviour, radboud university nijmegen, the', 'netherlands']
chiou14_interspeech	['department of computer science and engineering', 'national sun yat-sen university, kaohsiung, taiwan']
inoue14_interspeech	['school of informatics, kyoto university', 'academic center for computing and media studies, kyoto university', 'sakyo-ku, kyoto 606-8501, japan']
huang14_interspeech	['signal analysis and interpretation lab (sail),', 'university of southern california, los angeles, ca']
delgado14_interspeech	['caiac, autonomous university of barcelona, spain', 'university of avignon, ceri/lia, france']
ghaemmaghami14_interspeech	['speech and audio research laboratory, queensland university of technology, brisbane, australia']
gebre14_interspeech	['max planck institute for psycholinguistics, the netherlands', 'radboud university, the netherlands']
dupuy14_interspeech	['lium, university of le mans, france']
dighe14_interspeech	['idiap research institute, ch-1920 martigny, switzerland']
yella14_interspeech	['idiap research institute, ch-1920 martigny, switzerland', 'ecole polytechnique federale de lausanne, lausanne, switzerland']
ferras14_interspeech	['idiap research institute, ch-1920 martigny, switzerland1', 'fraunhofer heinrich hertz institute', ' berlin, germany2']
bechet14b_interspeech	"['aix marseille universite, cnrs-lif ', 'universite de lille, lifl', ""universite d'avignon, lia"", 'orange labs, france']"
gibson14_interspeech	['signal analysis and interpretation lab, university of southern california, los angeles, ca', 'http://sail.usc.edu']
du14_interspeech	['university of science and technology of china, hefei, anhui, p.r. china', 'georgia institute of technology, atlanta, ga. 30332-0250, usa']
vincent14_interspeech	['inria, villers-les-nancy, f-54600, france', 'institute for language and speech processing, athens, greece', 'austrian research institute for artificial intelligence']
spille14_interspeech	['department of medical physics and acoustics, cluster of excellence hearing4all', 'university of oldenburg, germany']
geiger14_interspeech	['institute for human-machine communication, technische universitat munchen, munich, germany', 'also with department of computing, imperial college london, london, u.k.']
liu14c_interspeech	['school of computing, national university of singapore, singapore']
park14_interspeech	['department of electronic engineering, sogang university, seoul, korea', 'department of electrical and computer engineering, carnegie mellon university, pittsburgh, pa', 'google, mountain view, ca']
zhao14_interspeech	['microsoft search technology center asia, beijing, china', 'microsoft corporation, one microsoft way, redmond, wa 98052']
kao14_interspeech	['department of computer science and information engineering,', 'national taiwan normal university, taipei, taiwan']
ravuri14b_interspeech	['international computer science institute, berkeley, ca, usa', 'eecs department, university of california - berkeley, berkeley, ca, usa']
kim14d_interspeech	
xie14_interspeech	['shenzhen institutes of advanced technology, chinese academy of sciences', 'cambridge university engineering dept, trumpington st., cambridge, cb2 1pz u.k.', 'the chinese university of hong kong, hong kong, china']
bu14_interspeech	
hashimoto14_interspeech	['department of computer science and engineering, toyohashi university of technology, japan']
chung14_interspeech	['keimyung university, daegu, s korea']
alam14_interspeech	['crim, montreal, canada', 'ets, montreal, canada', 'inrs-emt, montreal, canada']
chen14b_interspeech	['university of cambridge engineering dept,', 'trumpington st., cambridge, cb2 1pz, u.k.']
nolden14_interspeech	['a', 'b spoken language processing group, limsi cnrs, paris, france']
adel14_interspeech	['karlsruhe institute of technology, cognitive systems lab, germany', 'university of washington, department of electrical engineering, usa']
nolden14b_interspeech	
sundermeyer14_interspeech	['human language technology and pattern recognition,', 'computer science department, rwth aachen university, aachen, germany', 'spoken language processing group, limsi cnrs, paris, france']
levit14_interspeech	['microsoft corporation, u.s.a.']
sarkar14_interspeech	['school of information technology, indian institute of technology kharagpur', 'e-mail:']
campbell14_interspeech	['mit lincoln laboratory, lexington, ma, usa']
lei14_interspeech	['speech technology and research laboratory, sri international, california, usa', 'departamento de computacion, fcen, universidad de buenos aires and conicet, argentina']
mclaren14_interspeech	['speech technology and research laboratory, sri international, california, usa']
pelecanos14_interspeech	['ibm t.j. watson research center, yorktown heights, ny', ', usa.', 'apple inc.', ' infinite loop, cupertino, ca', ', usa.']
gallardo14_interspeech	['faculty of education, science, technology and mathematics, university of canberra, australia', 'college of engineering and computer science, australian national university, australia', 'quality and usability lab, telekom innovation laboratories, tu berlin, germany']
zang14_interspeech	['tsinghua-cuhk joint research center for media sciences, technologies and systems,', 'shenzhen key laboratory of information science and technology,', 'graduate school at shenzhen, tsinghua university, shenzhen 518055, china', 'tsinghua national laboratory for information science and technology (tnlist),', 'department of computer science and technology, tsinghua university, beijing 100084, china', 'department of systems engineering and engineering management,', 'the chinese university of hong kong, shatin, n.t., hong kong sar, china']
sproat14_interspeech	['google, inc']
gonzalvo14_interspeech	['google']
nagahama14_interspeech	['interdisciplinary graduate school of science and engineering,', 'tokyo institute of technology, japan', 'graduate school of engineering, tohoku university, japan']
ramani14_interspeech	['ssn college of engineering, chennai, india']
hu14b_interspeech	['the centre for speech technology research,university of edinburgh, uk', 'toshiba research europe ltd, cambridge, uk', 'national institute of informatics, tokyo, japan']
patil14_interspeech	['dhirubhai ambani institute of communication and technology, (da-iict),', 'gandhinagar-382007, india']
sorin14_interspeech	['speech technologies, ibm haifa research lab, haifa, israel', 'text-to-speech research, nuance communications, merelbeke, belgium']
zhang14c_interspeech	['institute of automation chinese academy of sciences, beijing, china', 'samsung telecom r&d center, beijing, china']
fabre14_interspeech	['gipsa-lab / dpc, umr 5216, cnrs – grenoble - alpes university, france']
tobing14_interspeech	['graduate school of information science, nara institute of science and technology, japan', 'stei, institut teknologi bandung, indonesia']
ding14_interspeech	"[""school of computer science, northwestern polytechnical university, xi'an, china"", ""school of software and microelectronics, northwestern polytechnical university, xi'an, china""]"
song14_interspeech	['school of information science and engineering, southeast university, nanjing, p.r. china', 'school of computer and control engineering, yantai university, yantai, p.r. china', 'key laboratory of child development and learning science of ministry of education,', 'southeast university, nanjing, p.r. china']
chen14c_interspeech	['university of science and technology of china, hefei, p.r. china', 'iflytek research, ustc iflytek co., ltd., hefei, p.r. china']
sanchez14_interspeech	['department of signal processing, tampere university of technology, finland', 'signalit oy, lempaala, finland']
kadowaki14_interspeech	['graduate school of information science and technology, the university of tokyo, japan', 'ntt communication science laboratories, ntt corporation, japan']
chen14d_interspeech	['department of electrical and computer engineering,', 'university of illinois at urbana-champaign, il']
nguyen14_interspeech	['limsi-cnrs (upr 3251), france', 'mica institute, hust - cnrs/umi2954 - grenoble inp, hanoi, vietnam']
koriyama14_interspeech	['†interdisciplinary graduate school of science and engineering, tokyo institute of technology, japan', '‡graduate school of engineering, tohoku university, japan']
fang14_interspeech	['phonetics lab., institute of linguistics, cass, china', 'school of computer science, tianjin university, china']
chen14e_interspeech	['toshiba research europe ltd., cambridge, uk']
nose14_interspeech	['graduate school of engineering, tohoku university']
valentinibotinhao14_interspeech	['the centre for speech technology research (cstr), university of edinburgh, uk', 'telecommunications research center vienna (ftw), austria', 'national institute of informatics, japan']
lopezpelaez14_interspeech	['center for speech technology research, the university of edinburgh']
baumann14_interspeech	['department of informatics, universitat hamburg, germany']
tsiakoulis14_interspeech	['university of cambridge, engineering department, cambridge, uk']
wang14d_interspeech	['national engineering laboratory for speech and language information processing,', 'university of science and technology of china, hefei, china']
gowda14_interspeech	['department of signal processing and acoustics, aalto university, finland', 'department of telecommunications, technical university of cluj-napoca, romania']
do14b_interspeech	['limsi-cnrs, b.p. 133, f-91403 orsay cedex, france', 'vocally inc.', ' rue des hayeps, f-93100 montreuil, france', 'e-mails:']
latorre14_interspeech	['toshiba research europe ltd., cambridge research lab', ' science park, cambridge, uk.']
miao14_interspeech	['language technologies institute, school of computer science, carnegie mellon university']
fernandez14_interspeech	['ibm tj watson research center, yorktown heights, ny – usa', 'queens college (cuny), flushing, ny – usa']
ragni14_interspeech	['department of engineering, university of cambridge', 'trumpington street, cambridge cb2 1pz, uk']
jouvet14_interspeech	['speech group, loria', 'inria, villers-les-nancy, f-54600, france', 'universite de lorraine, loria, umr 7503, villers-les-nancy, f-54600, france', 'cnrs, loria, umr 7503, villers-les-nancy, f-54600, france']
grezl14_interspeech	
vu14b_interspeech	['karlsruhe institute of technology, germany']
miao14b_interspeech	['language technologies institute, school of computer science, carnegie mellon university', 'pittsburgh, pa, usa']
rath14_interspeech	['cambridge university engineering department', 'trumpington street, cambridge, cb2 1pz, uk']
cui14_interspeech	['ibm t j. watson research center, yorktown heights, ny, usa', 'department of computer science, queens college, city university of new york, ny, usa']
huang14b_interspeech	['microsoft corporation, one microsoft way, redmond, wa 98052']
higuchi14_interspeech	['graduate school of information science and technology, the university of tokyo', 'ntt communication science laboratories, ntt corporation']
vaz14_interspeech	['ming hsieh department of electrical engineering', 'university of southern california, los angeles, ca 90089', 'at&t labs–research', 'bedminster, nj 07932']
mirzaei14_interspeech	['department of electrical engineering-esat, ku leuven, belgium', 'department of electrical engineering, amirkabir university of technology, tehran, iran', 'in this paper, the tasks of speech source localization, source', 'counting and source separation are addressed for an unknown', 'number of sources in a stereo recording scenario. in the first', 'stage, the angles of arrival of individual source signals are', 'estimated through a peak finding scheme applied to the', 'angular spectrum which has been derived using non-linear', 'gcc-phat. then, based on the known channel mixture', 'coefficients, we propose an approach for separating the', 'sources based on maximum likelihood (ml) estimation. the', 'predominant source in each time-frequency bin is identified', 'through ml assuming a diffuse noise model. the separation', 'performance is improved over a binary time-frequency', 'masking method. the performance is measured by obtaining', 'the existing metrics for blind source separation evaluation.', 'the experiments are performed on synthetic speech mixtures', 'in both anechoic and reverberant environments.', 'indexterms— non-linear gcc-phat, angular spectrum,', 'maximum likelihood (ml), binary masking, blind source', 'separation (bss)', '. introduction', 'extracting individual sources from a mixture of several audio', 'signals is required in many applications including hearing', 'aids, automatic meeting transcription systems, polyphonic', 'music source separation and hands-free teleconference', 'systems. when the impulse responses of the channel between', 'sources and microphones are not known, we deal with a blind', 'source separation (bss) task.', 'in [1], a non-negative tensor factorization (ntf)', 'structure is proposed as the generative model of the mixture', 'signal spectrogram. then, the spectral components, time', 'activations and channel mixture coefficients are estimated on', 'the basis of instantaneous mixtures where the channel', 'coefficients are assumed constant positive real values. in [2],', 'the same ntf modeling is considered and the performance of', 'the em algorithm is measured and compared with the', 'multiplicative update (mu) solution. also, convolutive', 'mixtures are accounted for by allowing frequency dependent', 'channel coefficients.', 'there are several drawbacks associated with the above', 'methods. firstly, they disregard the phase information of the', 'signal since they try to factorize the power or absolute value of', 'the short time fourier transform (stft) of the mixture', 'signal. secondly, the number of sources is taken known in', 'advance to enable them to cluster the learned spectral', 'components.', 'in a recent work [3], a bayesian non-parametric approach', 'is considered for estimating the number of sources, channel', 'coefficients and individual source signals. however, the', 'performance is very sensitive to the initial values chosen for', 'the parameters and it is prone to finding a locally optimum', 'solution. moreover, it is computationally intensive because it', 'involves variational inference for a large set of parameters.', 'our proposed approach regards the source separation task', 'as the second stage after source localization. knowing the', 'channel mixture weights, there will be three categories of', 'methods we can apply for extracting individual sources: (1)', 'masking the time-frequency (tf) representation of the', 'mixture', 'signal', '[4,5];', '(2)', 'beamforming-based', 'source', 'separation [6] and (3) statistical  methods where the', 'individual source signals can be derived e.g. as a maximum', 'likelihood solution.', 'in this paper, we consider speech source separation in a', 'convolutive stereo mixture scenario. in contrast to most', 'conventional methods, our approach to direction finding of the', 'sources is not based on the time difference of arrival', '(tdoa) estimation from some variant of generalized cross-', 'correlation with phase transform (gcc-phat) function,', 'hence alleviating the spatial aliasing issue. instead, we apply a', 'peak finding algorithm to an angular spectrum calculated for', 'individual angle of arrival values based on a non-linear', 'version of gcc-phat. the number of sources is then', 'estimated as the number of peaks found subject to some', 'constraints. even if it is overestimated, in the next step the', 'irrelevant sources will be automatically eliminated (taking', 'near zero values). in the source separation stage, we propose a', 'technique to improve the performance over binary masking. it', 'is based on ml estimation of the predominant source in each', 'tf bin. the bss evaluation metrics are finally obtained for', 'performance comparison.', 'the signal model adopted here is based on the far-field', 'assumption, so the received signal in two channels can be', 'represented as', '(', ')cos(', ')', 'exp', ',2', 'k', 'k', 'ift', 'kft', 'ift', 'k', 'j', 'df i', 'x', 's', 'n', 'i', 'c', '\x02', '\x03', '\x04', '\x05', '\x06', '\x07', '\x04', '\x08', '\x04', '(1)', 'where xift denotes the complex value of the mixture signal', 'stft in frequency bin f and time frame t for the ith channel.']
weninger14_interspeech	['mitsubishi electric research laboratories (merl), cambridge, ma 02139, usa']
kawahara14_interspeech	['faculty of systems engineering, wakayama university, wakayama, japan', 'faculty of intelligence and informatics, konan university, kobe, japan', 'national institute of information and communications technology, kyoto, japan']
wang14e_interspeech	['department of electronic engineering, the chinese university of hong kong, hong kong', 'institute for infocomm research, a⋆star, singapore']
ziaei14_interspeech	['center for robust speech systems (crss),', 'department of electrical engineering, university of texas at dallas, richardson, texas, u.s.a']
lu14_interspeech	['national institute of information and communications technology, japan', 'research center for information technology innovation, academic sinica, taiwan']
tuske14_interspeech	['human language technology and pattern recognition, computer science department,', 'rwth aachen university', ' aachen, germany', 'spoken language processing group, limsi cnrs, paris, france']
mitra14_interspeech	['speech technology and research laboratory, sri international, menlo park, ca, usa.']
sainath14_interspeech	['ibm t j. watson research center, yorktown heights, ny 10598, u.s.a', 'center for language and speech processing, johns hopkins university, md 21218, u.s.a', 'log-mel filterbank features, which are commonly used fea-', 'tures for cnns, can remove higher-resolution information from', 'the speech signal. a novel technique, known as deep scatter-', 'ing spectrum (dss), addresses this issue and looks to preserve', 'this information. dss features have shown promise on timit,', 'both for classification and recognition. in this paper, we ex-', 'tend the use of dss features for lvcsr tasks. first, we ex-', 'plore the optimal multi-resolution time and frequency scatter-', 'ing operations for lvcsr tasks. next, we explore techniques', 'to reduce the dimension of the dss features. we also incorpo-', 'rate speaker adaptation techniques into the dss features. re-', 'sults on a 50 and 430 hour english broadcast news task show', 'that the dss features provide between a 4-7% relative improve-', 'ment in wer over log-mel features, within a state-of-the-art', 'cnn framework which incorporates speaker-adaptation and se-', 'quence training. finally, we show that dss features are simi-', 'lar to multi-resolution log-mel + mfccs, and similar improve-', 'ments can be obtained with this representation.', '. introduction', 'a good feature representation for any pattern recognition task', 'is one that preserves detail in the signal, while remaining sta-', 'ble and invariant to non-informative distortions. while con-', 'ventional speech features, such as log-mel [1], plp [2] and', 'rasta [3], are all designed to be deformation stable, they re-', 'move important higher-order information from the speech sig-', 'nal [4]. while better estimation techniques can be designed to', 'preserve higher resolution detail [5], even these high resolution', 'representations are processed using short term smoothing oper-', 'ators for deformation stability [6]. in short, designing an appro-', 'priate feature representation is challenging.', 'deep scattering networks (dsn) [7] have recently been in-', 'troduced to address some of the above challenges. dsns take', 'a raw-signal and generate a contractive representation, which', 'preserves signal energy, while ensuring lipschitz continuity to', 'deformations ([7] and [8]). a scattering representation includes', 'log-mel like features (first-order scatter) together with higher-', 'order features that can preserve greater detail in the speech sig-', 'nal [4]. the representation generated by these networks, called', 'deep scattering spectrum (dss), is locally translation invariant', 'and stable to time varying deformations [4].', 'dss features first showed promise in speech on timit [9]', 'for phonetic classification [4] and then recognition [10]. as', 'there is only so much that can be learned from small-vocabulary', 'tasks like timit [11], in this paper, we extend the use of', 'dss features for large vocabulary continuous speech recogni-', 'tion (lvcsr). in our exploration of dss features for lvcsr,', 'we introduce many novelties in this paper. first, we explore', 'the use of time and frequency scattering representations, which', 'was only explored for classification [4] but not recognition [10].', 'within this, we provide a deep analysis of how to properly do', 'multi-resolution time and frequency scatter. second, as the fea-', 'ture dimension for multi-resolution time and frequency scat-', 'ter can be large (i.e., thousands), we introduce dimensional-', 'ity reduction techniques to significantly reduce the feature di-', 'mension. third, lvcsr systems incorporate speaker adapta-', 'tion techniques [11], including vtln [12], fmllr [13] and', 'i-vectors [14], which we also explore using in the dss frame-', 'work. while neural networks are ideal for high-dimensional', 'time-frequency features, previous work has typically been done', 'using shallow networks [15]. to our knowledge, this is one', 'of the first papers exploring the benefit of time-frequency fea-', 'tures using a state-of-the art deep cnn, encompassing speaker-', 'adaptation and sequence-training [16].', 'the use of representations which filter in both time and fre-', 'quency has certainly been explored before, including techniques', 'such as plp2 [17] and spectro-temporal modulation features', '[15', '', ']. the main difference between these representations', 'and dss features is the incorporation of 2nd-order scatter, and', 'the operation to get frequency scatter. to be complete, we com-', 'pare dss features to other time-and-frequency feature repre-', 'sentations, and analyze how important frequency and 2nd-order', 'scatter are to the dss framework.', 'results with dss features are first explored on a 50-hr', 'english broadcast news (bn) task [16]. we find that multi-', 'resolution time+frequency dss features achieves a 4% relative', 'improvement over log-mel features. next, we extend the use of', 'dss features to a larger 430-hr english bn task, where we ob-', 'serve gains of 7% relative, showing that this technique scales to', 'larger tasks. finally, we show that dss features are similar to', 'multi-resolution log-mel + mfccs, and similar improvements', 'can be obtained with this representation.', '. deep scattering spectra with dnns', '.1. dss features', 'in this section, we describe the dss representation [4], includ-', 'ing time scatter, frequency scatter, and multi-resolution scatter.', '.1.1. time scatter', 'as shown in [4], log-mel features can be approximated by con-', 'volving in time a signal x with a wavelet filterbank (ψλ1), tak-', 'ing the modulus (|.|), and then applying a low-pass filter (φ(t)).', 'this feature representation can be written as |x ∗ψλ1| ∗φ(t).']
chang14_interspeech	['eecs department, university of california-berkeley, berkeley, ca, usa', 'international computer science institute, berkeley, ca, usa']
lu14b_interspeech	['centre for speech technology research, university of edinburgh, edinburgh, uk']
schatz14_interspeech	['lscp, ens/ehess/cnrs, paris, france', 'sierra project-team, inria/ens/cnrs, paris, france', 'hlt center of excellence, john hopkins university, baltimore, maryland']
geiger14b_interspeech	['institute for human-machine communication, technische universitat munchen, munich, germany', 'department esat, ku leuven, leuven, belgium', 'department of computing, imperial college london, london, u.k.']
lilley14_interspeech	['speech research laboratory, nemours biomedical research, wilmington, usa', 'department of speech and hearing science, george washington university, washington, usa']
tachioka14_interspeech	['information technology r&d center, mitsubishi electric corporation, kamakura, japan', 'mitsubishi electric research laboratories, cambridge, us']
ghaffarzadegan14_interspeech	['center for robust speech systems (crss), erik jonsson school of engineering,', 'university of texas at dallas, richardson, texas, u.s.a.']
moghimi14_interspeech	['electrical & computer engineering department, carnegie mellon university', 'language technologies institute, carnegie mellon university']
delacallesilos14_interspeech	['department of signal theory and communications.', 'universidad carlos iii, leganes (madrid), spain', 'departamento de lenguages y sistemas informaticos.', 'univ. nacional de educacion a distancia, madrid, spain']
martinez14_interspeech	['department fur medizinische physik und akustik, exzellenzcluster hearing4all, carl von', 'ossietzky universitat oldenburg, germany', 'fraunhofer idmt - hearing, speech and audio technology, oldenburg, germany']
fox14_interspeech	['speech and hearing group', 'department of computer science', 'university of sheffield, uk']
mukherjee14_interspeech	['centre for educational technology', 'indian institute of technology kharagpur']
moralescordovilla14_interspeech	['signal processing and speech communication laboratory, graz university of technology, austria']
bahaadini14_interspeech	['idiap research institute, martigny, switzerland', 'ecole polytechnique federale de lausanne (epfl), switzerland']
tabain14_interspeech	"['la trobe university, melbourne, australia.', 'flinders university, adelaide, australia.', 'institute for aboriginal development, alice springs, australia.', ""murdoch children's research institute, melbourne, australia."", 'monash university, melbourne, australia.']"
khasanova14_interspeech	['unaffiliated', 'department of linguistics, university of illinois, urbana-champaign, u.s.a.', 'department of computer and electrical engineering, university of illinois, urbana-champaign, u.s.a.']
guo14_interspeech	['dept. of electrical engineering, university of california, los angeles, ca 90095, usa', 'dept. of speech and hearing sciences, indiana university, bloomington']
meenakshi14_interspeech	['electrical engineering, indian institute of science (iisc), bangalore-560012, india', 'department of speech pathology & audiology,', 'national institute of mental health and neuro sciences (nimhans), bangalore-560029, india']
albuquerque14_interspeech	['school of health, university of aveiro/ ieeta, portugal', 'dep. electronics, telecommunications and informatics, university of aveiro/ ieeta, portugal', 'dep. of mathematics, university of aveiro/ cidma, portugal', 'microsoft language development center, lisboa, portugal', 'iscte - university institute of lisbon (iscte-iul), lisboa, portugal']
yu14_interspeech	['center for robust speech systems (crss)', 'the university of texas at dallas, richardson, tx, u.s.a.', 'college of information studies and umiacs', 'university of maryland, college park, md, u.s.a.']
luan14_interspeech	['university of washington']
kawahara14b_interspeech	['faculty of systems engineering, wakayama university, wakayama, wakayama, japan', 'interdisciplinary graduate school of medicine and engineering, university of yamanashi, kofu, japan', 'nara advanced institute of science and technology, ikoma, nara, japan', 'graduate school of science and technology, meijo university, nagoya, japan']
pedersen14_interspeech	['international audio laboratories erlangen, friedrich-alexander university (fau), germany']
nandwana14_interspeech	['center of robust speech systems (crss)', 'erik jonsson school of engineering & computer science', 'university of texas at dallas, richardson, texas, usa']
wang14f_interspeech	['dept. of electrical engineering, university of texas at dallas']
slaney14_interspeech	['microsoft research', ' la avenida, mountain view, ca 94043']
harwath14_interspeech	['massachusetts institute of technology', 'google, inc.']
chen14f_interspeech	['engineering department, university of cambridge, uk', 'toshiba research europe ltd, cambridge, uk']
ng14_interspeech	['raytheon bbn technologies, cambridge, ma 02138', 'the johns hopkins university, baltimore, md, usa', 'brno university of technology, brno, czech republic']
nouza14_interspeech	['speechlab, institute of information technology and electronics', 'technical university of liberec', ' 17 liberec, czech republic']
ylmaz14_interspeech	['dept. esat, ku leuven, belgium']
shaik14_interspeech	['human language technology and pattern recognition – computer science department', 'rwth aachen university', ' aachen, germany', 'spoken language processing group, limsi cnrs, paris, france']
zohrer14_interspeech	['signal processing and speech communication laboratory', 'graz university of technology, austria']
yeung14_interspeech	['department of electronic engineering, the chinese university of hong kong,', 'hong kong sar, china', 'institute for infocomm research, a⋆star, singapore']
jafari14_interspeech	['the university of western australia, australia', 'curtin university of technology, australia']
hsu14_interspeech	['department of electrical and computer engineering, national chiao tung university, taiwan.']
yang14_interspeech	['department of electrical and computer engineering, national chiao tung university, taiwan']
wohlmayr14_interspeech	['commend international, salzburg, austria', 'signal processing and speech communication laboratory', 'graz university of technology, graz, austria']
vacher14_interspeech	['univ. grenoble alpes, lig, f-38000 grenoble, france', 'cnrs, lig, f-38000 grenoble, france', 'rue mathematiques, bp 53', ' grenoble cedex9, france']
walter14_interspeech	['department of communications engineering', 'university of paderborn, germany', 'jort f gemmeke, bart ons,', 'hugo van hamme', 'esat-psi', 'ku leuven, belgium']
gonzalez14_interspeech	['department of computer science, the university of sheffield, sheffield, uk', 'school of engineering, university of hull, kingston upon hull, uk', 'hull and east yorkshire hospitals trust, castle hill hospital, cottingham, uk']
karpov14_interspeech	['st. petersburg institute for informatics and automation of russian academy of sciences, russia', 'bogazici university, i̇stanbul, turkey', 'i̇stanbul technical university, i̇stanbul, turkey', 'university of west bohemia, pilsen, czech republic', 'university itmo, st. petersburg, russia']
ravanelli14_interspeech	['fondazione bruno kessler, trento, italy']
casanueva14_interspeech	['department of computer science, university of sheffield, united kingdom']
yu14b_interspeech	['mit lincoln laboratory, lexington, massachusetts, usa', 'center for telepsychology']
ishi14_interspeech	['atr intelligent robotics and communication labs.']
sainath14b_interspeech	['ibm t j. watson research center, yorktown heights, ny 10598, u.s.a']
bengio14_interspeech	['google inc, mountain view, ca, usa']
seide14_interspeech	['microsoft research asia', ' danling street, haidian district, beijing 100080, p.r.c.', 'institute of microelectronics, tsinghua university', ' beijing, p.r.c', 'microsoft research, one microsoft way, redmond, wa 98052, usa']
takeda14_interspeech	['central research laboratory, hitachi ltd.', '-280, kokubunji-shi, tokyo, japan']
kubo14_interspeech	['ntt communication science laboratories']
chan14_interspeech	['carnegie mellon university', 'electrical and computer engineering', ' language technologies institute']
toth14_interspeech	['mta-szte research group on artificial intelligence', 'hungarian academy of sciences and university of szeged, hungary']
chen14g_interspeech	['department of computer science & engineering', 'hong kong university of science & technology', 'institute for infocomm research, a⋆star, singapore']
hsiao14_interspeech	['raytheon bbn technologies', 'moulton street, cambridge, ma 02138, usa']
liu14d_interspeech	['center for speech and language technologies (cslt)', 'research institute of information technology, tsinghua university;', 'department of computer science, tsinghua university;', 'tsinghua national laboratory for information science and technology']
avila14_interspeech	['inrs-emt, university of quebec, montreal, quebec, canada', 'universidade federal do abc (ufabc), santo andre, sao paulo, brazil']
lee14_interspeech	['department of electrical engineering, national taiwan university, taiwan', 'institute of information science, academia sinica, taiwan', 'research center for information technology innovation, academia sinica, taiwan']
arsikere14_interspeech	['electrical engineering department, university of california, los angeles, ca 90095, usa']
sun14_interspeech	['human language technology department, institute for infocomm research,', 'a*star, singapore 138632']
gallardo14b_interspeech	['faculty of education, science, technology and mathematics, university of canberra, australia', 'college of engineering and computer science, australian national university, australia', 'quality and usability lab, telekom innovation laboratories, tu berlin, germany']
li14e_interspeech	['sysu-cmu joint institute of engineering, sun yat-sen university, guangzhou, china', 'sysu-cmu shunde international joint research institute, shunde, china']
asha14_interspeech	
zhong14_interspeech	['department of systems engineering & engineering management,', 'the chinese university of hong kong, hong kong sar of china,', 'department of electronic and information engineering,', 'the hong kong polytechnic university, hong kong sar of china']
martin14_interspeech	['national institute of standards and technology, gaithersburg, maryland, usa', 'systems plus, inc.', 'center for language and speech processing, johns hopkins university, baltimore, md, usa']
fujimura14_interspeech	['corporate research and development center, toshiba corporation']
abdelaziz14_interspeech	['institute of communication acoustics, digital signal processing group,', 'ruhr-universitat bochum, germany']
noda14_interspeech	['graduate school of fundamental science and engineering, waseda university, tokyo, japan', 'graduate school of informatics, kyoto university, kyoto, japan', 'honda research institute japan co., ltd., saitama, japan']
tao14_interspeech	['multimodal signal processing (msp) laboratory, department of electrical engineering', 'the university of texas at dallas, richardson tx 75080, usa']
masaka14_interspeech	['graduate school of system informatics, kobe university', '-1, rokkodai, nada, kobe', ', japan']
deng14b_interspeech	['bae systems, burlington, ma, usa', 'department of surgery, massachusetts general hospital, boston, ma, usa']
freitas14_interspeech	['microsoft language development center, lisboa, portugal', 'dep. electronics telecommunications & informatics/ieeta, university of aveiro, portugal', 'institute of telecommunications (it), lisboa, portugal', 'dep. elect., tele. & computers, lisbon engineering institute (isel), lisboa, portugal', 'dep. electronics and computers, instituto superior tecnico (ist), lisboa, portugal', 'iscte - university institute of lisbon (iscte-iul), lisboa, portugal']
katz14_interspeech	['balasubramanian4, balakrishnan prabhakaran4, rob rennaker2', 'callier center for communication disorders', 'department of bioengineering', 'arts and technology program', 'department of computer science', 'university of texas at dallas, dallas, texas, usa', 'vulintus, llc. sachse, texas, usa']
wang14g_interspeech	['department of bioengineering', 'callier center for communication disorders', 'university of texas at dallas, dallas, texas, usa', 'department of computer science & engineering', 'university of nebraska-lincoln, lincoln, nebraska, usa', 'department of communication sciences & disorders', 'mgh institute of health professions, boston, massachusetts, usa']
zahner14_interspeech	['cognitive systems lab, karlsruhe institute of technology, germany']
wand14_interspeech	['karlsruhe institute of technology, karlsruhe, germany']
liang14_interspeech	['tokyo institute of technology, japan', 'tokyo city university, japan']
kumar14_interspeech	['microsoft corporation, redmond, wa']
alumae14_interspeech	['institute of cybernetics', 'tallinn university of technology, estonia']
sak14b_interspeech	['google, usa']
huang14c_interspeech	['school of ece, georgia institute of technology, atlanta, ga. usa', 'microsoft corporation, one microsoft way, redmond, wa. usa']
tang14_interspeech	['toyota technological institute at chicago']
mcdermott14_interspeech	['google inc.', 'mountain view & new york, usa']
rao14_interspeech	['school of electrical and computer engineering, georgia institute of technology, atlanta, ga, usa', 'school of interactive computing, georgia institute of technology, atlanta, ga, usa', 'department of psychology, university of miami, coral gables, fl, usa']
pettorino14_interspeech	"[""university of naples “l'orientale”""]"
cummins14_interspeech	['school of elec. eng. and telecomm., the university of new south wales, sydney australia', 'atp research laboratory, national ict australia (nicta), australia', 'experimental industrial psychology, university of wuppertal, wuppertal, germany', 'industrial psychology, rhenish university of applied sciences cologne, germany']
bozkurt14_interspeech	['multimedia, vision and graphics laboratory, koc university, istanbul, turkey', 'ibm research – haifa, haifa university mount carmel, haifa, israel']
honig14_interspeech	['pattern recognition lab, friedrich-alexander-universitat erlangen-nurnberg, germany', 'institute for human-machine communication, technische universitat munchen, germany', 'electrical & computer engineering dept., king abdulaziz university, jeddah, saudi arabia', 'experimental industrial psychology, university of wuppertal, germany']
gangamohan14_interspeech	['speech and vision lab', 'international institute of information technology, hyderabad,']
wu14_interspeech	['◦institute for advanced computer studies, university of maryland', '†google, inc.']
kubo14b_interspeech	['graduate school of information science,', 'nara institute of science and technology (naist), japan']
zhang14d_interspeech	['ocean university of china, qingdao, china', 'the cstr, university of edinburgh, united kingdom, eh8 9ab']
kolluru14_interspeech	['toshiba research europe ltd, cambridge, uk']
mendonca14_interspeech	['instituto de ciencias matematicas e de computacao', 'university of sao paulo, brazil']
aylett14_interspeech	['cereproc ltd., u.k.', 'cstr, university of edinburgh, u.k.']
tsukada14_interspeech	['macquarie university, australia', 'the university of melbourne, australia']
alispahic14_interspeech	['marcs institute, university of western sydney, penrith, australia']
yang14b_interspeech	
lecumberri14_interspeech	['language and speech laboratory, university of the basque country, vitoria, spain', 'grupo de tecnologia del habla, universidad politecnica de madrid, madrid, spain', 'center for speech technology research, university of edinburgh, uk', 'national institute of informatics, japan', 'ikerbasque (basque foundation for science), bilbao, spain']
andreeva14_interspeech	['computational linguistics & phonetics, saarland university, germany', 'department of linguistics, adam mickiewicz university, poland']
avanzi14_interspeech	['laboratoire de linguistique formelle, umr 7110, university paris diderot, france', 'multiling (coe), university of oslo, norway', 'institut langage & communication, centre valibel, uclouvain, belgium']
scheffer14_interspeech	['speech technology and research laboratory, sri international, california, usa']
larcher14_interspeech	['human language technology department, institute for infocomm research, a⋆star, singapore,', 'speech and image research group, swansea university, wales, united kingdom']
fu14_interspeech	['key lab. of shanghai education commission for intelligent interaction and cognitive engineering', 'moe-microsoft key lab. for intelligent computing and intelligent systems', 'department of computer science and engineering, shanghai jiao tong university']
kenny14_interspeech	['centre de recherche informatique de montreal (crim), quebec, canada', 'voicetrust, ontario, canada']
aronowitz14_interspeech	['ibm research – haifa, haifa, israel']
miguel14_interspeech	['aragon institute for engineering research (i3a), university of zaragoza, spain', 'agnitio s.l., madrid, spain']
berg14_interspeech	['ibm t.j. watson research center']
hu14c_interspeech	['department of electrical and computer engineering, binghamton university,', 'binghamton, ny', ', usa', 'for applications such as tone modeling and automatic tone', 'recognition, smoothed f0 (pitch) all-voiced pitch tracks are', 'desirable. three pitch trackers that have been shown to give', 'good accuracy for pitch tracking are yaapt, yin, and', 'praat. on tests with english and japanese databases, for', 'which ground truth pitch tracks are available by other means,', 'we show that yaapt has lower errors than yin and praat.', 'we also experimentally compare the effectiveness of the three', 'trackers for automatic classification of mandarin tones. in', 'addition to f0 tracks, a compact set of low-frequency spectral', 'shape trajectories are used as additional features for automatic', 'tone classification. a combination of pitch trajectories', 'computed with yaapt and spectral shape trajectories', 'extracted from 800ms intervals for each tone results in tone', 'classification accuracy of nearly 77%, a rate higher than', 'human listeners achieve for isolated tonal syllables, and also', 'higher than that obtained with the other two trackers.', 'index terms: pitch tracking, tone classification, mandarin', 'chinese, fundamental frequency', 'accurate fundamental frequency (f0) (commonly referred to', 'as pitch—the terms pitch and f0 are used interchangeably in', 'this paper) tracking in speech remains an elusive goal,', 'especially for noisy and/or band-limited speech, typically the', 'scenarios where reliable pitch tracking would be most useful.', 'good results have been reported by talkin in rapt where a', 'normalized cross correlation function is used [8]. high', 'accuracy pitch tracking results have also been obtained by the', 'yin algorithm, which uses a modified version of the', 'autocorrelation method [2]. probably the most widely used', 'tool for pitch tracking is the speech analysis program praat', '[1] because it provides fairly reliable tracking and is readily', 'available. since about 1980, several pitch trackers have been', 'developed and several studies have been done to evaluate', 'these trackers [5', ']. our own tool for pitch tracking is named', 'yaapt for “yet another algorithm for pitch tracking” [12].', 'for automatic recognition of tones in tonal languages', 'such as mandarin, robust all-voiced pitch tracking is', 'especially important, as pitch is widely considered as the most', 'important acoustic correlate of a tone [1] [9].', 'in this paper, we first summarize and illustrate the', 'yaapt method in the remainder of this section. section 2', 'introduces several modifications motivated by the desire to', 'improve automatic tone classification and describes a method', 'for computing spectral temporal features, which are effective', 'in addition to pitch for use in tone classification. the', 'evaluation results of several experiments, which illustrate the', 'effectiveness of yaapt and the additional features, are', 'reported in sections 3 and 4. for control purposes,', 'experimental results obtained with yin and praat pitch', 'trackers are also given.', 'f0 candidates', 'filtered', 'squared speech', 'filtered', 'speech', 'spectrum', 'fft', 'refined f0', 'candidates', 'refined f0', 'candidates', 'final f0', 'candidate refinement (3)', 'f0 tracking (2)', 'f0 candidate', 'estimation (3)', 'spectral f0 track', 'f0 candidate', 'estimation (3)', 'preprocessing (1)', 'original', 'speech', 'candidate refinement (3)', 'dynamic programming (4)', 'f0 candidates', 'figure 1: yaapt flow chart', 'the main signal processing steps in yaapt are', 'illustrated in figure 1 [12]. for each frame of speech, multiple', 'pitch candidates are computed using the normalized cross', 'correlation. a smoothed pitch track is computed from the', 'spectrogram of the squared signal; to some extent the squaring', 'restores the fundamental, which is likely to be missing from', 'band-limited speech such as telephone speech. all f0', 'candidates, both time domain and frequency domain, as well', 'as an unvoiced candidate, are assigned merit values and the', 'highest overall merit path is determined using dynamic', 'programming. more details, as well as illustrations of the', 'various steps involved, are given in [12].   all three of these', 'trackers have settings to minimize “gross” error (large errors', 'in the voiced sections of speech) or “big” error, which takes', 'into account both large errors in the voiced speech regions,', 'and voiced/unvoiced decision errors.   unfortunately, neither', 'of these minimum error cases is best suited for computing', 'pitch tracks for mandarin tone classification.', '.1. yaapt improvements', 'the most significant change is the introduction of additional', 'post-processing techniques to refine the final pitch tracks,', 'especially for the case when the track is intended to be all', 'voiced. with the previous settings, as given in [12], optimized', 'for minimum gross error, visual inspection of computed pitch']
karlsson14_interspeech	['dept. of linguistics and phonetics, centre for languages and literature, lund university,', 'sweden', 'malmo academy of music, lund university, sweden']
yakoumaki14_interspeech	['department of computer science, university of crete, greece', 'institute of computer science, foundation for research and technology hellas, greece']
wang14h_interspeech	['school of information science, japan advanced institute of science and technology, japan', 'school of electrical engineering and inmc, seoul national university seoul, republic of korea']
barker14_interspeech	
sarma14_interspeech	['dept. of electronics and electrical engineering', 'indian institute of technology guwahati, guwahati-781039, india']
sasou14_interspeech	['national institute of advanced industrial science and technology, aist']
zhang14e_interspeech	['beijing institute of technology']
motlicek14_interspeech	['idiap research institute, martigny, switzerland', 'samsung electronics co. ltd, suwon, south korea']
li14f_interspeech	['interactive digital media technology research center,', 'institute of automation, chinese academy of sciences, beijing, p.r.china']
giwa14_interspeech	['multilingual speech technologies, north-west university, vanderbijlpark, south africa.']
anguera14_interspeech	['telefonica research, edificio telefonica-diagonal 00', ', barcelona, spain', 'universitat pompeu fabra, department of information and communications technologies, spain']
ngo14_interspeech	['national university of singapore, singapore', 'institute for infocomm research, singapore']
adel14b_interspeech	['karlsruhe institute of technology, cognitive systems lab, germany', 'university of washington, department of electrical engineering, usa']
tuske14b_interspeech	['human language technology and pattern recognition, computer science department,', 'rwth aachen university', ' aachen, germany', 'spoken language processing group, limsi cnrs, paris, france']
masumura14_interspeech	['ntt media intelligence laboratories, ntt corporation, japan']
herms14_interspeech	['technische universitat chemnitz, germany']
chien14_interspeech	['department of electrical and computer engineering', 'national chiao tung university, hsinchu, taiwan 30010, roc']
levin14_interspeech	['speech technology center, saint-petersburg', 'saint-petersburg state university, saint-petersburg, russia', 'itmo university, saint-petersburg, russia']
wang14i_interspeech	['institute for infocomm research, singapore 138632']
rutherford14_interspeech	['†brandeis university, waltham, ma, usa', '‡google inc., mountain view, ca, usa']
schuppler14_interspeech	['signal processing and speech communication laboratory, graz university of technology, austria', 'lpp-cnrs, univ. paris sorbonne nouvelle, paris']
lehr14_interspeech	['center for spoken language understanding, ohsu, portland, or, usa', 'google inc']
pellegrini14_interspeech	['universite de toulouse; ups; irit; toulouse, france', 'universite paris descartes, paris, france', 'universite paris ouest, paris, france']
metallinou14_interspeech	['knowledge technologies, pearson', 'campbell ave., menlo park, california 94025, usa']
lu14c_interspeech	['electrical engineering, national taiwan university', 'graduate institute of electrical engineering, national taiwan university', 'graduate institute of communication engineering, national taiwan university']
duan14_interspeech	['school of information science, beijing language and culture university, beijing 100083, china', 'center for studies of chinese as a second language, beijing language and culture university', 'beijing 100083, china']
xu14b_interspeech	['¹universite pierre et marie curie, paris, france', '²signal processing and machine learning laboratory, espci-paristech, paris, france', 'electrical and computer engineering department, university of new mexico, usa', 'phonetics and phonology laboratory, universite sorbonne nouvelle, paris, france,', 'vocal tract visualization lab, university of maryland dental school, baltimore, usa']
derrick14_interspeech	['university of canterbury, new zealand institute of language, brain & behaviour (new zealand)', 'university of western sydney, marcs institute (australia)']
czap14_interspeech	['department of automation and infocommunication', 'university of miskolc']
banchs14_interspeech	['institute for infocomm research, singapore']
akira14_interspeech	['school of computer science and statistics, trinity college dublin, ireland', 'school of linguistics, speech and communication sciences, trinity college dublin, ireland']
centelles14_interspeech	['universitat politecnica de catalunya, barcelona', 'institute for infocomm research, singapore']
benin14_interspeech	['istc-cnr, uos padova']
naderi14_interspeech	['quality and usability lab, telekom innovation laboratories, tu berlin, germany']
moore14_interspeech	['speech and hearing research group, university of sheffield, uk']
dubinsky14_interspeech	['syncwords llc., usa']
clark14_interspeech	['the', 'simple4all project', 'consortium', 'copyright © 2014 isca', '-18 september 2014, singapore', 'interspeech 2014: show & tell contribution']
chawah14_interspeech	['phonetics and phonology laboratory, lpp -cnrs, umr7018, university paris3 sorbonne nouvelle', 'universite pierre marie curie, paris, france,', 'signal processing and machine learning lab, espci paris -tech, paris, france,', 'vocal tract visualization lab, university of maryland dental school, baltimore, usa']
jeon14_interspeech	['gwangju institute of science and technology (gist), korea', 'samsung electronics, korea']
maurer14_interspeech	['zurich university of the arts, institute for the performing arts and film, switzerland', 'the chinese university of hong kong, dept. of linguistics and modern languages, hong kong', 'university of zurich, phonetics laboratory, switzerland']
mowlaee14_interspeech	['† signal processing and speech communication laboratory, graz university of technology, austria', '‡ speech and image processing unit, school of computing, university of eastern finland, finland']
roekhaut14_interspeech	['cental - universite catholique de louvain, belgium 2f.r.s-fnrs research fellow', 'tcts - universite de mons, belgium ', 'nuance communications, inc., belgium∗']
niculescu14_interspeech	['institute for infocomm research (i2r)']
plummer14_interspeech	['dept. of computer science and engineering, the ohio state university, columbus, oh; u.s.a.', 'language technologies institute, carnegie mellon university, pittsburgh, pa; u.s.a.', 'dept. of integrated engineering, minnesota state university, mankato, mn; u.s.a.']
marekspartz14_interspeech	['university of minnesota, minneapolis, usa']
masudakatsuse14_interspeech	['faculty of humanity-oriented science and engineering, kindai university, fukuoka, japan']
driesen14_interspeech	['centre for speech technology research, university of edinburgh, uk', 'red bee media, uk']
dong14_interspeech	['human language technology department, institute for infocomm research, a*star, singapore']
henter14_interspeech	['centre for speech technology research, university of edinburgh, u.k.', 'department of engineering, university of cambridge, u.k.']
merritt14_interspeech	['the centre for speech technology research, university of edinburgh, u.k.', 'department of signal processing and acoustics, aalto university, finland']
latorre14b_interspeech	['toshiba research europe ltd., cambridge research lab', ' science park, cambridge, uk.']
yanagisawa14_interspeech	['toshiba research europe ltd., cambridge research lab', ' science park, cambridge, uk']
brognaux14_interspeech	['cental, icteam - universite catholique de louvain, belgium', 'tcts lab - university of mons, belgium']
cai14_interspeech	['national engineering laboratory for speech and language processing,', 'university of science and technology of china, p.r.china']
zhang14f_interspeech	['tnlist, department of electronic engineering, tsinghua university, beijing, china', 'department of computer science & engineering and center for cognitive & brain sciences,', 'the ohio state university, columbus, oh, usa']
prasad14_interspeech	['electronics and communication engineering, manipal institute of technology, manipal, india', 'electrical engineering, indian institute of science (iisc), bangalore-560012, india', 'electrical engineering, university of southern california (usc), los angeles-90089, u.s.a.']
ziaei14b_interspeech	['center for robust speech systems (crss),', 'department of electrical engineering, university of texas at dallas, richardson, texas, u.s.a', 'college of information studies and umiacs', 'university of maryland, college park, md, u.s.a.']
tu14_interspeech	['school of information and electronics, beijing institute of technology']
mcloughlin14_interspeech	['national engineering laboratory of speech and language information processing', 'the university of science and technology of china, hefei, china']
ma14_interspeech	['raytheon bbn technologies, cambridge, ma 02138, usa']
le14_interspeech	['university of michigan', 'computer science and engineering, ann arbor, mi 48109']
strombergsson14_interspeech	['department of speech, music and hearing, kth, stockholm, sweden', 'swedish agency for accessible media, johanneshov, sweden']
orozcoarroyave14_interspeech	['faculty of engineering, universidad de antioquia, medelln, colombia', 'pattern recognition lab, universitat erlangen-nurnberg, germany', 'department of neurology, knappschaftskrankenhaus, ruhr-university bochum, germany', 'faculty of electrical engineering, czech technical university, prague, czech republic', 'first faculty of medicine, charles university, prague, czech republic', 'king abdulaziz university, jeddah, saudi arabia', 'corresponding author:']
lilley14b_interspeech	['speech research laboratory, nemours biomedical research, wilmington, usa', 'department of otolaryngology – head & neck surgery, the ohio state university, columbus,', 'usa']
shahin14_interspeech	['dept.of electrical and computer engineering, texas a&m university, doha, qatar', 'faculty of health sciences, the university of sydney, sydney, australia', 'dept. of computer science and engineering, texas a&m university, college station, texas']
berry14_interspeech	['marquette university speech pathology & audiology, milwaukee, wi, usa', 'marquette university electrical and computer engineering, milwaukee, wi, usa']
wand14b_interspeech	['karlsruhe institute of technology, karlsruhe, germany']
lee14b_interspeech	['victoria junior college, singapore', 'anderson junior college, singapore', 'institute for infocomm research, singapore']
gretter14_interspeech	['fbk - via sommarive', ' - i-38123 povo (tn), italy']
tsiami14_interspeech	['school of electr. and computer eng., national technical univ. of athens', ' athens, greece', 'department of electr. and computer eng., univ. of thessaly', ' volos, greece', 'athena research and innovation center', ' maroussi, greece']
matassoni14_interspeech	['fondazione bruno kessler (italy)', 'l2f - spoken language systems laboratory, inesc-id lisboa, portugal', 'national technical university of athens (greece)']
henriques14_interspeech	['inesc-id, lisbon, portugal', 'ist, universidade de lisboa, portugal']
mowlaee14b_interspeech	['†signal processing and speech communication laboratory, graz university of technology, austria', '‡speech and image processing unit, school of computing, university of eastern finland, finland', '∗computer science dept. university of crete, crete, greece']
cano14_interspeech	['fraunhofer institute for digital media technology idmt.', 'centre for digital music, queen mary university of london']
degottex14_interspeech	['university of crete and foundation for research and technology-hellas, heraklion, greece', 'ircam, umr stms ircam-cnrs-upmc, paris, france']
degottex14b_interspeech	['university of crete and foundation for research and technology-hellas, heraklion, greece', 'aholab, university of basque country, ikerbasque, basque science foundation, bilbao, spain']
jokinen14_interspeech	['aalto university, department of signal processing and acoustics, espoo, finland', 'international audio laboratories erlangen, friedrich-alexander universitat (fau), germany', 'lumia audio technology, microsoft, tampere, finland']
shanmugam14_interspeech	['department of computer science and engineering', 'indian institute of technology madras']
koutsogiannaki14_interspeech	['multimedia informatics lab, csd, university of crete, greece', 'institute of computer science, forth, crete, greece']
vijayan14_interspeech	['department of electrical engineering', 'indian institute of technology hyderabad, india']
sanchez14b_interspeech	['aholab signal processing laboratory, university of the basque country upv/ehu, spain', 'ikerbasque, basque foundation for science, bilbao, spain.']
yang14c_interspeech	"['shaanxi provincial key laboratory of speech and image information processing,', ""school of computer science, northwestern polytechnical university, xi'an, china"", 'institute for infocomm research, a⋆star, singapore']"
hout14_interspeech	['speech technology and research laboratory, sri international, menlo park, california, usa']
makino14_interspeech	['faculty of engineering, shizuoka university, japan', 'graduate school of engineering, shizuoka university, japan']
pappagari14_interspeech	['department of electrical engineering', 'indian institute of technology hyderabad, hyderabad, india-502205']
george14_interspeech	['speech and vision lab, international institute of information technology, hyderabad,']
li14g_interspeech	['interactive digital media technology research center,', 'institute of automation, chinese academy of sciences, beijing, p.r.china']
schulam14_interspeech	['johns hopkins university', 'microsoft']
kawasaki14_interspeech	['department of computer science and engineering', 'toyohashi university of technology']
liou14_interspeech	['graduate institute of communication engineering, national taiwan university', 'graduate institute of computer science and information engineering, national taiwan university']
gravier14_interspeech	['cnrs, irisa - umr 6074 & inria rennes', 'universite rennes 1, irisa - umr 6074 & inria rennes', 'inria, irisa - umr 6074 & inria rennes']
garcia14_interspeech	['departament de sistemes informatics i computacio', 'universitat politecnica de valencia', 'camino de vera s/n', ' valencia, spain']
mittal14b_interspeech	['international institute of information technology, hyderabad, india']
ntalampiras14_interspeech	['joint research center, european commission, enrico fermi 2749', ', ispra, varese, italy', 'technological educational, institute of crete, e daskalaki - perivolia', ', rethymno, crete, greece']
piot14_interspeech	['supelec ims-malis research group and umi 2958 (georgiatech - cnrs)', 'university lille 1, lifl (umr 8022 cnrs/lille 1) - sequel team']
weiss14_interspeech	['technische universitat berlin, quality & usability lab, germany', 'technische universitat berlin, assessment of ip-based applications, germany']
avanzi14b_interspeech	['umr 7110-llf (laboratoire de linguistique formelle), universite paris-diderot', 'centre valibel, institute for language & communication, university of louvain, belgium', 'irisa, university of rennes 1, lannion, france']
matsumiya14_interspeech	['graduate school of information science, nara institute of science and technology, japan']
tseng14_interspeech	['phonetics lab, institute of linguistics, academia sinica, taipei, taiwan', 'taiwan international graduate program, academia sinica, taipei, taiwan']
truong14b_interspeech	['human media interaction, university of twente, enschede, the netherlands', 'phonetics, saarland university, saarbrucken, germany']
prylipko14_interspeech	['cognitive systems group, otto von guericke university magdeburg, germany']
kakouros14_interspeech	['department of signal processing and acoustics, aalto university, finland']
madzlan14_interspeech	['clcs, school of linguistics, speech and communication sciences, trinity college dublin', 'scss, school of computer science and statistics, trinity college dublin, ireland', 'elld, faculty of languages and communication, upsi, malaysia']
katerenchuk14b_interspeech	['cuny graduate center, new york, usa', 'cuny queens college, new york, usa']
das14_interspeech	['department of electronics and electrical engineering ,', 'indian institute of technology guwahati, guwahati-781039, india', 'department of electrical engineering ,', 'indian institute of science, bangalore-560012, india']
diez14_interspeech	['gtts, department of electricity and electronics,', 'university of the basque country, upv/ehu', ', leioa, spain']
ganapathy14_interspeech	['ibm t.j. watson research center, yorktown heights, ny, usa.', 'signal analysis and interpretation laboratory, university of southern california, los angeles, usa.']
yu14c_interspeech	['center for robust speech systems (crss)', 'the university of texas at dallas, richardson, tx, u.s.a.']
mak14_interspeech	['department of electronic and information engineering,', 'the hong kong polytechnic university, hong kong sar']
sadjadi14_interspeech	['ibm research, watson group']
liu14e_interspeech	['institute of information science, academia sinica, taiwan', 'national taiwan university, taiwan', 'national taiwan normal university, taiwan']
morchid14b_interspeech	['georges linar', '`', 'es†, driss matrouf† and renato de mori†‡', '†lia, university of avignon, france', '‡mcgill university, school of computer science, montreal, quebec, canada']
lai14b_interspeech	['centre for speech technology research', 'university of edinburgh, edinburgh, uk']
bouallegue14_interspeech	['`', 'es† and renato de mori†‡', '†lia, university of avignon, france', '‡mcgill university, school of computer science, montreal, quebec, canada']
bouallegue14b_interspeech	['†lia, university of avignon, france', '‡mcgill university, school of computer science, montreal, quebec, canada']
bouchekif14_interspeech	['orange labs', ' avenue pierre marzin 22307 lannion, france', 'lium, universit du maine, le mans, france']
huang14d_interspeech	['microsoft corporation, one microsoft way, redmond, wa 98052']
bacchiani14_interspeech	['google inc.']
jaitly14_interspeech	['university of toronto', 'google inc.']
li14h_interspeech	['microsoft corporation, one microsoft way, redmond, wa 98052', 'microsoft search technology center asia, beijing, china']
deng14c_interspeech	['microsoft research, one microsoft way, redmond, wa, usa']
zhou14_interspeech	['school of computer science and technology, tianjin university, china', 'college of information technical science, nankai university, china', 'institute of linguistics chinese academic of social sciences, china']
hsu14b_interspeech	['university college london, uk']
schmidt14_interspeech	['centre for language studies, radboud university nijmegen, the netherlands', 'imprs for language sciences, nijmegen, the netherlands', 'donders institute for brain, cognition and behavior, radboud university nijmegen, the', 'netherlands', 'max planck institute for psycholinguistics, nijmegen, the netherlands']
yang14d_interspeech	['signal analysis and interpretation lab (sail), university of southern california, los angeles, ca']
chappuis14_interspeech	['swiss center for affective sciences, university of geneva', 'neuroscience of emotion and affective dynamics, university of geneva']
zellers14_interspeech	['department of speech, music & hearing, kungliga tekniska hogskolan, stockholm, sweden']
fuchs14_interspeech	['englisches seminar, westfalische wilhelms-universitat munster']
chen14h_interspeech	['university of science and technology of china, p.r. china', 'iflytek research, ustc iflytek co., ltd., anhui, p.r. china', 'department of signal processing and acoustics, aalto university, finland', 'the centre for speech technology research, university of edinburgh, uk', 'national institute of informatics, japan']
kang14_interspeech	['human-computer communications laboratory,', 'department of systems engineering and engineering management,', 'the chinese university of hong kong, hong kong sar, china']
fan14_interspeech	['shanghai jiao tong university, shanghai, china', 'microsoft research asia, beijing, china']
raitio14_interspeech	['department of signal processing and acoustics, aalto university, finland', 'institute of behavioural sciences, university of helsinki, finland']
fernandez14b_interspeech	['ibm tj watson research center, yorktown heights, ny – usa', 'ibm haifa research lab, haifa – israel']
yin14_interspeech	['national engineering laboratory of speech and language information processing,', 'university of science and technology of china, hefei, p.r. china', 'microsoft, beijing, china']
nakashika14_interspeech	['graduate school of system informatics, kobe university, japan', 'organization of advanced science and technology, kobe university, japan']
xie14b_interspeech	['harbin institute of technology, harbin, china', 'microsoft research asia, beijing, china']
bocquelet14_interspeech	['inserm, clinatec, u1167, grenoble france', 'univ. grenoble, clinatec, u1167, grenoble, france', 'cea, leti, clinatec, grenoble, france', 'gipsa-lab, umr5216/cnrs/inp/ujf/u.stendhal, grenoble, france']
xu14c_interspeech	['faculty of arts and social science, university of brunei darussalam, brunei darussalam']
wang14j_interspeech	['school of foreign languages, tongji university, shanghai, china', 'department of linguistics, university of pennsylvania, philadelphia, usa', 'school of foreign languages, shanghai jiao tong university, shanghai, china']
mahajan14_interspeech	['center for language and speech processing, the johns hopkins university, baltimore, md', 'columbia university, new york, ny']
thlithi14_interspeech	['universite de toulouse-ups-irit – 118, route de narbonne – 31062 toulouse cedex 9 – france']
watson14_interspeech	['university of auckland, new zealand']
arndt14_interspeech	['quality and usability lab, technische universitat berlin, berlin, germany', 'machine learning group, technische universitat berlin, berlin, germany', 'neurotechnology group, technische universitat berlin, berlin, germany', 'neurophysics group, charite-universitatsmedizin, berlin, germany']
chen14i_interspeech	['division of speech and hearing sciences, the university of hong kong, hong kong, china']
berry14b_interspeech	['marquette university speech pathology & audiology, milwaukee, wi, usa', 'marquette university electrical and computer engineering, milwaukee, wi, usa']
bailly14_interspeech	['gipsa-lab, speech & cognition dpt, grenoble - france']
mandel14_interspeech	['computer science & engineering, the ohio state university, usa', 'speech & hearing science, the ohio state university, usa']
mahajan14b_interspeech	['the marcs institute, university of western sydney']
laskowski14_interspeech	['carnegie mellon university, pittsburgh pa, usa', 'voci technologies inc., pittsburgh pa, usa']
sakano14_interspeech	['graduate school of science and engineering, yamagata university, yamagata, japan']
jokinen14b_interspeech	['aalto university, department of signal processing and acoustics, espoo, finland', 'international audio laboratories erlangen, friedrich-alexander universitat (fau), germany']
koster14_interspeech	['quality and usability lab, telekom innovation labs', 'technische universitat berlin, germany']
aubanel14_interspeech	['the marcs institute, university of western sydney, australia']
zorila14_interspeech	['computer science department, university of crete, heraklion, crete, greece', 'toshiba cambridge research lab, uk']
chen14j_interspeech	['division of speech and hearing sciences, the university of hong kong', 'dept. of electrical & electronic engineering, south univ. of science and technology of china', 'department of electrical engineering & computer science, university of wisconsin-milwaukee']
wang14k_interspeech	['dept. electrical engineering, university of texas at dallas', 'west campbell rd, richardson, tx 75080, usa']
valentinibotinhao14b_interspeech	['the centre for speech technology research, university of edinburgh, uk']
dabel14_interspeech	['department of computer science, university of sheffield, uk']
harvilla14_interspeech	['department of electrical and computer engineering', 'carnegie mellon university, pittsburgh, pa 15213 usa']
xu14d_interspeech	['nanyang technological university, singapore', 'international computer science institute, berkeley, california, us', 'institute for infocomm research, singapore']
kapralova14_interspeech	['google inc.', 'ninth avenue, new york, ny 10011']
cardinal14_interspeech	['mit computer science and artificial intelligence laboratory,', 'cambridge, massachusetts 02139, usa', 'qatar computing research institute, doha, qatar']
sundermeyer14b_interspeech	['human language technology and pattern recognition,', 'computer science department, rwth aachen university, aachen, germany', 'spoken language processing group, limsi cnrs, paris, france']
cheng14_interspeech	
cui14b_interspeech	['ibm t j. watson research center, yorktown heights, ny 10598, usa', 'department of computer science, queens college, city university of new york, ny 11367, usa', 'department of computer science, columbia university, ny 10027, usa', 'center for computational learning systems, columbia university, ny 10115, usa']
chowdhury14_interspeech	['dept. of information engineering & computer science, univ. of trento, trento, italy', 'dept. of electronics & computer engineering, tech. univ. of crete, chania, greece']
hakkanitur14_interspeech	['microsoft']
garner14_interspeech	['idiap research institute, martigny, switzerland']
harrat14_interspeech	['ens bouzareah, algiers, algeria', 'badji mokhtar university-annaba, algeria', 'crstdla, algiers, algeria', 'campus scientifique loria , nancy, france']
ferrer14_interspeech	['speech technology and research laboratory, sri international, california, usa', 'departamento de computacion, fcen, universidad de buenos aires and conicet, argentina']
gonzalezdominguez14_interspeech	['google inc., new york, usa', 'atvs-biometric recognition group, universidad autonoma de madrid, madrid, spain']
desplanques14_interspeech	['elis multimedia lab', 'ghent university - iminds, belgium']
behravan14_interspeech	['school of computing, university of eastern finland, finland', 'faculty of architecture and engineering, university of enna ”kore”, italy', 'idiap research institute, switzerland', 'school of languages and translation studies, university of turku, finland', 'school of ece, georgia institute of technology, usa']
chen14k_interspeech	['national laboratory of pattern recognition, institute of automation, chinese academy of sciences,', 'beijing 100190, china']
kolly14_interspeech	['phonetics laboratory, department of comparative linguistics, university of zurich, switzerland']
karanasou14_interspeech	['department of engineering, university of cambridge', 'trumpington street, cambridge cb2 1pz, uk']
fukuda14_interspeech	['ibm research – tokyo', '-52, toyosu 5-chome, koto-ku', '-8511, japan', 'ibm t j. watson research center, yorktown heights, ny10598']
miao14c_interspeech	['language technologies institute, school of computer science, carnegie mellon university', 'pittsburgh, pa, usa']
gorin14_interspeech	['speech group, loria', 'inria', ' rue du jardin botanique, f-54600, villers-ls-nancy, france', 'universit de lorraine, loria, umr 7503, villers-ls-nancy, f-54600, france', 'cnrs, loria, umr 7503, villers-ls-nancy, f-54600, france']
doddipatla14_interspeech	['the university of sheffield, sheffield, united kingdom.']
you14_interspeech	['interactive digital media technology research center,', 'institute of automation, chinese academy of sciences,', 'beijing, p.r.china']
pellegrini14b_interspeech	['universite de toulouse; ups; irit; toulouse, france', 'inesc-id, lisbon, portugal', 'instituto superior tecnico, lisbon, portugal', 'microsoft language development center, lisbon, portugal /', 'iscte - university institute of lisbon (iscte-iul), lisbon, portugal']
najafian14_interspeech	['school of eece, university of birmingham, birmingham, uk', 'school of computing sciences, university of east anglia, norwich, uk']
zhang14g_interspeech	['zhengzhou information science and technology institute, zhengzhou, china', 'department of electronic engineering, tsinghua university, beijing, china']
huang14e_interspeech	['microsoft corporation, one microsoft way, redmond, wa 98052']
shahnawazuddin14_interspeech	['department of electronics and electrical engineering', 'indian institute of technology guwahati, guwahati -781039, india']
kubota14_interspeech	['dept. of compute science, waseda university, tokyo, japan', 'toyohashi university of technology, toyohashi, japan']
huang14f_interspeech	['school of ece, georgia institute of technology, atlanta, ga. usa', 'microsoft corporation, one microsoft way, redmond, wa. usa', 'department of telematics, kore university of enna, enna, italy']
tomashenko14_interspeech	['speech technology center, saint-petersburg, russia', 'itmo university, saint-petersburg, russia']
karafiat14_interspeech	
rouvier14_interspeech	['aix marseille universite, cnrs, lif umr 7279']
singhal14_interspeech	['department of electrical engineering', 'indian institute of technology kanpur']
cui14c_interspeech	['multimedia team, dmc r&d center, samsung electronics co., ltd.']
netsch14_interspeech	['texas instruments, inc.']
ying14_interspeech	['key laboratory of speech acoustics and content understanding, chinese academy of sciences']
xue14_interspeech	['national laboratory of pattern recognition, institute of automation, chinese academy of sciences,', 'beijing 100190, china']
bouafif14_interspeech	['lr-signal image and information technology laboratory, national engineering school of tunis,', 'el-manar university, bp53, campus universitaire', ', le belvedere, tunis, tunisia.', 'depart. of physic and instrumentation, national institute of applied sciences and technology,', 'carthage university bp 676, centre urbain', ', cedex, tunis, tunisia.']
zhang14h_interspeech	['∗center for brains, minds and machines | mcgovern institute for brain research at mit', '† lcsl, istituto italiano di tecnologia and massachusetts institute of technology']
sinclair14_interspeech	['centre for speech technology research', 'statistical machine translation group', 'school of informatics, university of edinburgh, edinburgh eh8 9ab, uk']
aneeja14_interspeech	['international institute of information technology, hyderabad-500032, india']
he14b_interspeech	['school of computer science and technology, harbin institute of technology, harbin, china', 'school of computer science and technology, harbin university of science and technology']
vaz14b_interspeech	['ming hsieh department of electrical engineering', 'university of southern california, los angeles, ca 90089']
gallardoantolin14_interspeech	['dept. of signal theory and communications, universidad carlos iii de madrid, spain', 'speech technology group, etsit, universidad politecnica de madrid, spain', 'the centre for speech technology research, university of edinburgh, uk']
asami14_interspeech	['ntt media intelligence laboratories, ntt corporation, japan']
shokouhi14_interspeech	['center for robust speech systems (crss)', 'the university of texas at dallas, richardson, tx 75080-3021, usa']
voinea14_interspeech	['center for brains, minds and machines | mcgovern institute for brain research at mit', 'lcsl, istituto italiano di tecnologia and massachusetts institute of technology']
dalsgaard14_interspeech	['aalborg university, denmark']
ouali14_interspeech	['ets (ecole de technologie superieure), montreal, canada', 'crim (computer research institute of montreal), montreal, canada']
jiang14_interspeech	['department of electronic engineering, tsinghua university, beijing 100084, p.r. china', 'department of computer science & engineering and center for cognitive & brain sciences,', 'the ohio state university, columbus, ohio 43210, usa']
anguera14b_interspeech	['telefonica research (barcelona, spain)', 'university of the basque country upv/ehu (leioa, spain)', 'brno university of technology (brno, czech republic)', 'university politehnica of bucharest (bucharest, romania)', 'carnegie mellon university (pittsburgh, pa, usa)']
soto14_interspeech	['department of computer science, columbia university, new york, ny, usa', 'ibm t j. watson research center, yorktown heights, ny, usa', 'department of computer science, cuny graduate center, new york, ny, usa']
karakos14_interspeech	['raytheon bbn technologies, cambridge, ma']
wang14l_interspeech	['language technologies institute, carnegie mellon university', 'pittsburgh, pa, u.s.a.']
lee14c_interspeech	['mit computer science and artificial intelligence laboratory', 'cambridge, massachusetts 02139, usa']
le14b_interspeech	['vocapia research', ' rue jean rostand', ' orsay, france', 'cnrs/limsi, spoken language processing group', ' orsay cedex, france']
hartmann14_interspeech	['cnrs/limsi, spoken language processing group', ' orsay cedex, france', 'vocapia research', ' rue jean rostand', ' orsay, france']
ma14b_interspeech	['department of computer science, the cuny graduate center, new york, usa', 'department of linguistics, the cuny graduate center, new york, usa', 'department of computer science, columbia university, new york, usa']
xu14e_interspeech	['language technologies institute, school of computer science, carnegie mellon university', 'pittsburgh, pa, usa']
chen14l_interspeech	['school of electrical and computer engineering, georgia institute of technology', 'institute for infocomm research, singapore']
chiu14_interspeech	['language technologies institute, carnegie mellon university, pittsburgh, pa, usa', 'center for language and speech processing & human language technology center of', 'excellence, johns hopkins university, baltimore, md, usa']
liu14f_interspeech	['center for language and speech processing & department of electrical and computer engineering,', 'human language technology center of excellence', 'the johns hopkins university, baltimore, md usa']
ohtani14_interspeech	['knowledge media laboratory, corporate research & development center, toshiba corporation, japan']
nakamura14_interspeech	['department of scientific and engineering simulation, nagoya institute of technology, nagoya, japan']
lee14d_interspeech	['human language technology department, institute for infocomm research, a*star, singapore', 'school of computer engineering, nanyang technological university, singapore']
saito14_interspeech	['graduate school of information science and technology, the university of tokyo, japan', 'graduate school of engineering, the university of tokyo, japan']
wu14b_interspeech	['nanyang technological university, singapore', 'institute for infocomm research, singapore']
kobayashi14_interspeech	['graduate school of information science, nara institute of science and technology (naist), japan']
ellis14_interspeech	['labrosa, columbia university, new york, ny, usa', '& international computer science institute, berkeley, ca, usa', 'morikawa lab, university of tokyo, tokyo, japan']
phan14_interspeech	['institute for signal processing, university of lubeck, germany', 'graduate school for computing in medicine and life sciences, university of lubeck, germany']
ferras14b_interspeech	['idiap research institute, ch-1920 martigny, switzerland']
dennis14_interspeech	['institute for infocomm research, a*star', ' fusionopolis way, singapore 138632', 'school of computer engineering, nanyang technological university, singapore']
satt14_interspeech	['ibm research – haifa, israel', 'university of nice sophia antipolis, france', 'centre memoire de ressources et de recherche, chu de nice, nice, france', 'maastricht university medical center, maastricht, netherlands']
raboshchuk14_interspeech	['talp research center, department of signal theory and communications,', 'universitat politecnica de catalunya, barcelona, spain', 'hospital sant joan de deu barcelona, esplugues de llobregat, barcelona, spain']
fox14b_interspeech	['department of speech and hearing science, the ohio state university, columbus, oh, usa.']
turco14_interspeech	['university of konstanz (germany)', 'laboratoire de linguistique formelle - umr 7110 (france)']
tu14b_interspeech	['center of learning technology for chinese, national taiwan normal university', 'department of educational psychology and counseling, national taiwan normal university']
leong14_interspeech	['centre for neuroscience in education, department of psychology, university of cambridge', 'marcs institute, university of western sydney']
wewalaarachchi14_interspeech	['national university of singapore']
goh14_interspeech	['national university of singapore', 'a*star']
francisco14_interspeech	['radboud university nijmegen, behavioural science institute, nijmegen, the netherlands', 'department of psychology, university of massachusetts, amherst, ma, usa', 'donders institute for brain, cognition and behaviour, nijmegen, the netherlands', 'max planck institute for psycholinguistics, nijmegen, the netherlands']
derrick14b_interspeech	['university of canterbury, new zealand institute of language, brain & behaviour (new zealand)', 'university of western sydney, marcs institute (australia)']
mai14_interspeech	['department of psychology, the university of sheffield']
stringer14_interspeech	['department of speech, hearing and language sciences,', 'university college london, london, uk']
fong14_interspeech	['department of electronic engineering, the chinese university of hong kong, hong kong, china', 'joint research centre for language and human complexity,', 'the chinese university of hong kong, hong kong, china']
scharenborg14_interspeech	['centre for language studies, radboud university nijmegen, the netherlands', 'donders institute for brain, cognition and behaviour, radboud university nijmegen, the', 'netherlands', 'centre for language and speech technology, radboud university nijmegen, the netherlands']
hanai14_interspeech	['mit computer science and artificial intelligence laboratory, cambridge, ma 02139, usa']
orosanu14_interspeech	['speech group, loria', 'inria, villers-les-nancy, f-54600, france', 'universite de lorraine, loria, umr 7503, villers-les-nancy, f-54600, france', 'cnrs, loria, umr 7503, villers-les-nancy, f-54600, france']
gandhe14_interspeech	['lti, carnegie mellon university']
gangireddy14_interspeech	['centre for speech technology research, university of edinburgh, uk']
roy14_interspeech	['the media lab, massachusetts institute of technology', 'cambridge, ma 02139']
jalalvand14_interspeech	['human language technology unit, fondazione bruno kessler, via sommarive 18, trento, italy']
chelba14_interspeech	['google', 'amphitheatre parkway,', 'mountain view, ca 94043, usa', 'university of edinburgh', 'crichton street, room 4.19,', 'edinburgh, eh8 9ab, united kingdom', 'cantab research ltd', 'canterbury street, cambridge, cb4 3qg, united kingdom']
schnall14_interspeech	['tu darmstadt - control methods and robotics', 'holzhofallee 38', ' darmstadt, germany', 'honda research institute europe gmbh', 'carl-legien-str. 30', ' offenbach/main, germany']
biadsy14_interspeech	['google, inc.']
telaar14_interspeech	['cognitive systems lab, karlsruhe institute of technology (kit), karlsruhe, germany']
harwath14b_interspeech	['mit computer science and artificial intelligence laboratory,', 'cambridge, massachusetts 02139, usa']
zhao14b_interspeech	['advanced digital sciences center, illinois at singapore, singapore', 'department of electrical and computer engineering, university of illinois at urbana-champaign,', 'illinois, usa']
jathar14_interspeech	['department of electrical engineering, indian institute of technology bombay, india']
xu14f_interspeech	['national engineering laboratory for speech and language information processing,', 'university of science and technology of china', 'school of electrical and computer engineering, georgia institute of technology']
pertila14_interspeech	['department of signal processing, tampere university of technology, finland']
mani14_interspeech	['department of electrical engineering, indian institute of technology hyderabad, india']
liu14g_interspeech	['university of illinois at urbana-champaign, usa', 'adobe research, usa']
mohammadiha14_interspeech	['dept. of medical physics and acoustics and cluster of excellence hearing4all', 'university of oldenburg, germany']
kato14_interspeech	['university of east anglia']
pfeifenberger14_interspeech	['signal processing and speech communication laboratory', 'graz university of technology, graz, austria']
chacon14_interspeech	['†signal processing and speech communication lab., graz university of technology, graz, austria', '‡austrian research institute for artificial intelligence, vienna, austria']
ming14_interspeech	"[""institute of ecit, queen's university belfast, belfast bt7 1nn, uk""]"
zhou14b_interspeech	['department of electronic engineering / graduate school at shenzhen, tsinghua university, china', 'department of computer science / graduate school at shenzhen, tsinghua university, china', 'nagaoka university of technology, japan']
mirsamadi14_interspeech	['center for robust speech systems (crss)', 'the university of texas at dallas, richardson, tx 75080-3021, u.s.a.']
chen14m_interspeech	['labrosa, columbia university, new york, ny, usa', 'international computer science institute, berkeley, ca, usa']
jaureguiberry14_interspeech	['institut mines-telecom, telecom paristech, cnrs ltci', '-39, rue dareau 75014 paris, france', 'inria', ' villers-les-nancy, france']
kang14b_interspeech	['department of electrical and computer engineering and inmc,', 'seoul national university, korea', 'school of information and communications,', 'gwangju institute of science and technology, korea']
sonowal14_interspeech	['department of electrical and computer engineering and inmc seoul national university,', 'seoul 151-742, korea', 'school of information and communications gwangju institute of science and technology,', 'gwangju 500-712, korea']
backstrom14_interspeech	['international audio laboratories erlangen', 'friedrich-alexander university erlangen-nurnberg (fau)']
cernak14_interspeech	['idiap research institute, martigny, switzerland']
pulakka14_interspeech	['lumia audio technology, microsoft, tampere, finland', 'nokia research center, tampere, finland', 'department of signal processing and acoustics, aalto university, espoo, finland']
fu14b_interspeech	"[""school of computer science, northwestern polytechnical university, xi'an, china""]"
lee14e_interspeech	['department of electronics and computer engineering, hanyang university, seoul, korea']
wu14c_interspeech	['institute of acoustics, chinese academy of sciences, beijing, china']
byambakhishig14_interspeech	['graduate school of system informatics, kobe university, japan']
dikici14_interspeech	['department of electrical and electronics engineering, bogazici university, istanbul, turkey']
qin14_interspeech	['m*modal', ' murray ave, pittsburgh, pa, usa', 'carnegie mellon university', ' forbes ave, pittsburgh, pa, usa']
schlippe14_interspeech	['cognitive systems lab, karlsruhe institute of technology (kit), germany']
akbacak14_interspeech	['microsoft, sunnyvale, ca usa']
lee14f_interspeech	['mit computer science and artificial intelligence laboratory, cambridge, ma 02139, usa']
sapru14_interspeech	['idiap research institute', ', martigny, switzerland', 'ecole polytechnique federale de lausanne, lausanne, switzerland']
xu14g_interspeech	['shaanxi provincial key laboratory of speech and image information processing,', 'school of computer science, northwestern polytechnical university, china', 'school of computer engineering, nanyang technological university, singapore', 'institute for infocomm research, a⋆star, singapore']
gupta14b_interspeech	['signal analysis and interpretation laboratory, university of southern california', 'los angeles, ca 90081, u.s.a.', 'speech, language, and multimedia business unit, raytheon bbn technologies', 'cambridge, ma 02138, u.s.a.']
dutrey14_interspeech	['edf r&d', ' 141 clamart, france', 'limsi-cnrs', ' 403 orsay, france', 'lpp, universite paris iii – sorbonne nouvelle', ' paris, france', 'universite paris sud', ' orsay, france', 'institut mines-telecom, telecom paristech, cnrs ltci', ' paris, france']
hasan14_interspeech	['the university of sheffield, sheffield, united kingdom.']
zayats14_interspeech	['university of washington']
jiang14b_interspeech	['national engineering laboratory of speech and language information processing,', 'university of science and technology of china, hefei, anhui, china', 'iflytek research, anhui ustc iflytek co., ltd., hefei, anhui, china']
tong14_interspeech	['institute for infocomm research, singapore']
liu14h_interspeech	['tsinghua national laboratory for information science and technology', 'department of electronic engineering, tsinghua university, beijing 100084, china', 'general communication station, general logistics department, china']
segbroeck14b_interspeech	['signal analysis and interpretation lab,', 'university of southern california, los angeles, usa']
diez14b_interspeech	['gtts, department of electricity and electronics,', 'university of the basque country, upv/ehu', ', leioa, spain']
travadi14_interspeech	['signal analysis and interpretation lab', 'university of southern california, los angeles, ca – 90089']
dharo14_interspeech	['speech technology group. dpto. de ing. electronica. universidad politecnica de madrid.', 'ciudad universitaria s/n 28040, madrid, spain', 'universidad politecnica salesiana del ecuador', 'calle vieja 12-30 y elia liut, casilla 26, cuenca, ecuador']
plchot14_interspeech	['gtts, university of the basque country, upv/ehu, leioa, spain']
yeong14_interspeech	['school of computer sciences, universiti sains malaysia', ' usm, penang, malaysia']
