paper_id	affiliations	author_area_id	author_area_label
sainath15_interspeech	['google, inc. new york, ny, u.s.a']	8	Speech Recognition – Signal Processing, Acoustic Modeling, Robustness, and Adaptation
bhargava15_interspeech	['department of electrical and computer engineering, mcgill university', 'google inc., new york, ny, u.s.a']		
palaz15_interspeech	['idiap research institute, martigny, switzerland', 'ecole polytechnique federale de lausanne (epfl), lausanne, switzerland', 'facebook ai research, menlo park, ca, usa']	8	Speech Recognition – Signal Processing, Acoustic Modeling, Robustness, and Adaptation
ogawa15_interspeech	['dept. of computer science, waseda university', 'toyohashi university of technology']	8	Speech Recognition – Signal Processing, Acoustic Modeling, Robustness, and Adaptation
lin15_interspeech	['research center for information technology innovation, academia sinica, taipei, taiwan', 'asus headquarters, advanced technology division, kauhsiung, taiwan']	8	Speech Recognition – Signal Processing, Acoustic Modeling, Robustness, and Adaptation
golik15_interspeech	['human language technology and pattern recognition, computer science department,', 'rwth aachen university', ' aachen, germany', 'spoken language processing group, limsi cnrs, paris, france']	8	Speech Recognition – Signal Processing, Acoustic Modeling, Robustness, and Adaptation
glavitsch15_interspeech	['empa, swiss federal laboratories for materials science and technology, switzerland', 'department of comparative linguistics, university of zurich, switzerland']	2	Phonetics, Phonology, and Prosody
windmann15_interspeech	['faculty for linguistics and literary studies, bielefeld university, germany', 'institute of behavioral sciences, university of helsinki, finland']	2	Phonetics, Phonology, and Prosody
eriksson15_interspeech	['department of linguistics, stockholm university, sweden']	2	Phonetics, Phonology, and Prosody
zahner15_interspeech	['department of linguistics, university of konstanz, germany']	2	Phonetics, Phonology, and Prosody
mixdorff15_interspeech	['department of computer science and media, beuth university berlin, germany', 'lis, university of buenos aires, argentina', 'university of bielefeld, citec, germany']	2	Phonetics, Phonology, and Prosody
simonetti15_interspeech	['the marcs institute, university of western sydney']	2	Phonetics, Phonology, and Prosody
michalsky15_interspeech	['department of german studies, university of oldenburg']	2	Phonetics, Phonology, and Prosody
reichel15_interspeech	['institute of phonetics and speech processing, university of munich', 'hungarian academy of sciences, budapest, hungary', 'constantine the philosopher university, nitra & ii sas bratislava, slovakia']	2	Phonetics, Phonology, and Prosody
sarma15_interspeech	['department of electronics and electrical engineering', 'department of humanities and social sciences', 'indian institute of technology guwahati', 'guwahati 781039, india']	2	Phonetics, Phonology, and Prosody
repp15_interspeech	['humboldt-universitat zu berlin, germany']	2	Phonetics, Phonology, and Prosody
jabeen15_interspeech	['university of konstanz, germany']	2	Phonetics, Phonology, and Prosody
mady15_interspeech	['research institute for linguistics, hungarian academy of sciences, budapest, hungary']	2	Phonetics, Phonology, and Prosody
benus15_interspeech	['constantine the philosopher university in nitra & ii sas bratislava, slovakia', 'institute of phonetics and speech processing, university of munich, germany', 'institute of behavioral sciences, university of helsinki, finland']	2	Phonetics, Phonology, and Prosody
gendrot15_interspeech	['universite sorbonne-nouvelle paris 3 - laboratoire de phonetique et phonologie umr 7018', 'laboratoire de phonetique et phonologie umr 7018']	2	Phonetics, Phonology, and Prosody
schauffler15_interspeech	['institute of english linguistics, university of stuttgart, germany', 'institute for natural language processing, university of stuttgart, germany']	2	Phonetics, Phonology, and Prosody
andreeva15_interspeech	['computational linguistics & phonetics, saarland university, germany', 'department of linguistics, adam mickiewicz university, poland']	2	Phonetics, Phonology, and Prosody
qiu15_interspeech	['school of foreign languages, tongji university', 'school of foreign languages, jiangsu university of science and technology']	2	Phonetics, Phonology, and Prosody
oreilly15_interspeech	['phonetics and speech laboratory, school of linguistic, speech and communication sciences', 'trinity college dublin, ireland']	2	Phonetics, Phonology, and Prosody
sarmah15_interspeech	['department of humanities and social sciences', 'indian institute of technology guwahati', 'guwahati 781039, india']	2	Phonetics, Phonology, and Prosody
wochner15_interspeech	['department of linguistics, university of konstanz, germany']	2	Phonetics, Phonology, and Prosody
zorila15_interspeech	['toshiba cambridge research laboratory, united kingdom']	6	Speech Coding and Enhancement
koutsogiannaki15_interspeech	['multimedia informatics laboratory, csd, university of crete, greece', 'cambridge research laboratory, toshiba research europe ltd.']	6	Speech Coding and Enhancement
jemaa15_interspeech	"[""unite de recherche signaux et systemes (u2s), ecole nationale d'ingenieurs de tunis (enit),"", 'universite de tunis el manar, bp37', ' tunis- belvedere, tunisia', 'cea linklab, telnet innovation labs', ' ariana, tunisia', 'signal processing laboratory (lts2), swiss federal institute of technoloy (epfl),', 'lausanne, switzerland', 'department of otolaryngology-head & neck surgery, stanford school of medicine,', 'stanford, california, usa', '∗both authors contributed equally to this work']"	6	Speech Coding and Enhancement
schepker15_interspeech	['university of oldenburg, signal processing group, dept. of medical physics and acoustics', 'and the cluster of excellence hearing4all, oldenburg, germany', 'fraunhofer idmt, project group hearing, speech, and audio technology,', 'oldenburg, germany']	6	Speech Coding and Enhancement
rottschafer15_interspeech	['social cognitive systems group – faculty of technology and citec', 'bielefeld university, po-box 10 01 31', ' bielefeld, germany']	6	Speech Coding and Enhancement
jokinen15_interspeech	['aalto university, department of signal processing and acoustics, espoo, finland']	6	Speech Coding and Enhancement
kumar15_interspeech	['signal analysis and interpretation lab,', 'department of electrical engineering,', 'university of southern california, los angeles.']	3	Analysis of Paralinguistics in Speech and Language
orozcoarroyave15_interspeech	['faculty of engineering, universidad de antioquia, medellin, colombia', 'pattern recognition lab, friedrich-alexander-universitat, erlangen-nurnberg, germany', 'department of neurology, knappschaftskrankenhaus, ruhr-university bochum, germany', 'faculty of electrical engineering, czech technical university, prague, czech republic', 'first faculty of medicine, charles university, prague, czech republic', 'corresponding author:']	3	Analysis of Paralinguistics in Speech and Language
villacanas15_interspeech	['faculty of engineering, universidad de antioquia udea, calle 70 no. 52-21, medellin, colombia.', 'friedrich alexander universitat, erlangen-nurnberg, germany']	3	Analysis of Paralinguistics in Speech and Language
vasquezcorrea15_interspeech	['faculty of engineering. universidad de antioquia udea, medellin, colombia.', 'pattern recognition lab, friedrich-alexander-universitat, erlangen-nurnberg, germany', 'corresponding author:']	3	Analysis of Paralinguistics in Speech and Language
cummins15_interspeech	['school of elec. eng. and telecomm., the university of new south wales, sydney australia', 'atp research laboratory, national ict australia (nicta), australia', 'experimental industrial psychology, university of wuppertal, wuppertal, germany', 'industrial psychology, rhenish university of applied sciences cologne, germany']	3	Analysis of Paralinguistics in Speech and Language
marchi15_interspeech	['machine intelligence & signal processing group, mmk, technische universitat munchen, germany', 'department of computing, imperial college london, uk', 'chair of complex & intelligent systems, university of passau, germany', 'autism research centre, university of cambridge, uk', 'department of psicology, bar-ilan university, israel', 'center of neurodelopmental disorders, karolinska intitute, sweden', 'department of communication engineering, university of paderborn, germany']	3	Analysis of Paralinguistics in Speech and Language
liu15_interspeech	['the johns hopkins university, baltimore, md usa', 'microsoft corporation, redmond, wa usa']	11	Spoken Language Processing – Dialogue, Summarization, Understanding
tam15_interspeech	['microsoft corporation']	11	Spoken Language Processing – Dialogue, Summarization, Understanding
vukotic15_interspeech	['insa de rennes, rennes, france', 'inria/irisa, rennes, france', 'cnrs, france']	11	Spoken Language Processing – Dialogue, Summarization, Understanding
ravuri15_interspeech	['international computer science institute', ' university of california, berkeley, ca, usa', 'microsoft research, mountain view, ca, usa']	11	Spoken Language Processing – Dialogue, Summarization, Understanding
lu15_interspeech	['graduate institute of computer science and information engineering, national taiwan university', 'graduate institute of communication engineering, national taiwan university']	11	Spoken Language Processing – Dialogue, Summarization, Understanding
morchid15_interspeech	['lia - university of avignon (france)']	11	Spoken Language Processing – Dialogue, Summarization, Understanding
sheikh15_interspeech	['universite de lorraine, loria, umr 7503, vandoeuvre-les-nancy, f-54506, france', 'inria, villers-les-nancy, f-54600, france', 'cnrs, loria, umr 7503, vandoeuvre-les-nancy, f-54506, france']	11	Spoken Language Processing – Dialogue, Summarization, Understanding
boutin15_interspeech	['ecole de technologie superieure, montreal, canada', 'nuance communications, montreal, canada']	11	Spoken Language Processing – Dialogue, Summarization, Understanding
yang15_interspeech	['tsinghua national laboratory for information science and technology', 'department of electronic engineering, tsinghua university, beijing 100084, china']	11	Spoken Language Processing – Dialogue, Summarization, Understanding
chiu15_interspeech	['language technologies institute, carnegie mellon university, pittsburgh, pa, usa']	11	Spoken Language Processing – Dialogue, Summarization, Understanding
shen15_interspeech	['graduate institute of communication engineering, national taiwan university,', 'mit computer science and artificial intelligence laboratory']	11	Spoken Language Processing – Dialogue, Summarization, Understanding
charlet15_interspeech	['orange labs, lannion, france']	11	Spoken Language Processing – Dialogue, Summarization, Understanding
ramanarayanan15_interspeech	['educational testing service r&d', '†90 new montgomery st, #1500, san francisco, ca', '‡660 rosedale road, princeton, nj']	11	Spoken Language Processing – Dialogue, Summarization, Understanding
racca15_interspeech	['adapt centre', 'school of computing', 'dublin city university', 'dublin 9, ireland']	11	Spoken Language Processing – Dialogue, Summarization, Understanding
chen15_interspeech	['*institute of information science, academia sinica, taiwan', '#national taiwan normal university, taiwan', '†national taiwan university, taiwan']	11	Spoken Language Processing – Dialogue, Summarization, Understanding
renkens15_interspeech	['department electrical engineering-esat, katholieke universiteit leuven', 'kasteelpark arenberg 10, bus 2441, b-3001 leuven belgium']	11	Spoken Language Processing – Dialogue, Summarization, Understanding
bastianelli15_interspeech	['dicii', ' dii - university of rome tor vergata - rome, italy', 'diag - sapienza university of rome - rome, italy']	11	Spoken Language Processing – Dialogue, Summarization, Understanding
luan15_interspeech	['mitsubishi electric research laboratories']	11	Spoken Language Processing – Dialogue, Summarization, Understanding
ferreira15_interspeech	['ceri-lia, university of avignon, avignon - france']	11	Spoken Language Processing – Dialogue, Summarization, Understanding
tafforeau15_interspeech		11	Spoken Language Processing – Dialogue, Summarization, Understanding
yang15b_interspeech	['tsinghua national laboratory for information science and technology', 'department of electronic engineering, tsinghua university, beijing 100084']	11	Spoken Language Processing – Dialogue, Summarization, Understanding
lopes15_interspeech	['kth speech, music and hearing, stockholm, sweden', 'ist/inesc-id lisboa, lisboa, portugal', 'iscte/inesc-id lisboa, lisboa, portugal']	11	Spoken Language Processing – Dialogue, Summarization, Understanding
crook15_interspeech	['microsoft corporation, redmond wa 98052, usa']	11	Spoken Language Processing – Dialogue, Summarization, Understanding
solanki15_interspeech	['glasgow university laboratory of phonetics, university of glasgow, glasgow (uk)', 'school of computing science, university of glasgow, glasgow (uk)']	11	Spoken Language Processing – Dialogue, Summarization, Understanding
laskowski15_interspeech	['carnegie mellon university, pittsburgh pa, usa', 'voci technologies inc., pittsburgh pa, usa']	11	Spoken Language Processing – Dialogue, Summarization, Understanding
llimona15_interspeech	['telefonica research', 'edificio telefonica-diagonal 00, barcelona, spain']	11	Spoken Language Processing – Dialogue, Summarization, Understanding
callejas15_interspeech	['dept. of languages and computer systems, university of granada / citic-ugr, granada, spain', 'dept. of computer science, university carlos iii of madrid, leganes, spain']	11	Spoken Language Processing – Dialogue, Summarization, Understanding
nakamura15_interspeech		11	Spoken Language Processing – Dialogue, Summarization, Understanding
gravano15_interspeech	['departamento de computacion, fceyn, universidad de buenos aires, argentina', 'national scientific and technical research council (conicet), buenos aires, argentina', 'constantine the philosopher university in nitra & ii-slovak academy of sciences, slovakia', 'dept. of computer and information science, brooklyn college cuny, new york, ny, usa', 'dept. of computer science, columbia university, new york, ny, usa']	11	Spoken Language Processing – Dialogue, Summarization, Understanding
chowdhury15_interspeech	['department of information engineering & computer science, university of trento, italy']	11	Spoken Language Processing – Dialogue, Summarization, Understanding
christodoulides15_interspeech	['centre valibel, institute for language & communication, universite de louvain, belgium', 'dtal, faculty of modern & medieval languages, university of cambridge, uk']	11	Spoken Language Processing – Dialogue, Summarization, Understanding
hakkanitur15_interspeech	['microsoft, usa']	11	Spoken Language Processing – Dialogue, Summarization, Understanding
despotovic15_interspeech	['university of belgrade, technical faculty of bor, serbia', 'university of paderborn, department of communications engineering, germany']	11	Spoken Language Processing – Dialogue, Summarization, Understanding
svec15_interspeech	['ntis - new technologies for information society', 'university of west bohemia, pilsen, czech republic']	11	Spoken Language Processing – Dialogue, Summarization, Understanding
chen15b_interspeech	['school of computer science, carnegie mellon university', 'forbes avenue, pittsburgh, pa 15213-3891, usa']	11	Spoken Language Processing – Dialogue, Summarization, Understanding
szekely15_interspeech	['school of computer science and informatics', 'university college dublin', 'belfield, dublin 4, ireland']	1	Speech Perception, Production, and Acquisition
cowan15_interspeech		1	Speech Perception, Production, and Acquisition
ma15_interspeech	['department of computer science, university of sheffield, sheffield s1 4dp, uk']	1	Speech Perception, Production, and Acquisition
schymura15_interspeech	['institute of communication acoustics, ruhr-universitat bochum, germany', 'institute of communications engineering, university of rostock, germany']	1	Speech Perception, Production, and Acquisition
may15_interspeech	['hearing systems group,', 'technical university of denmark,', 'dk-2800 kgs. lyngby, denmark']	1	Speech Perception, Production, and Acquisition
kayser15_interspeech	['medizinische physik, universitat oldenburg, germany', 'signal processing, universitat oldenburg, germany', 'cluster of excellence “hearing4all”, universitat oldenburg, germany']	1	Speech Perception, Production, and Acquisition
gomez15_interspeech	['honda research institute japan co., ltd.']		
chen15c_interspeech	['key lab. of shanghai education commission for intelligent interaction and cognitive engineering', 'speechlab, department of computer science and engineering', 'shanghai jiao tong university, shanghai, china']	4	Speaker and Language Identification
stafylakis15_interspeech	['centre de recherche informatique de montreal (crim), quebec, canada', 'voicetrust, ontario, canada']	4	Speaker and Language Identification
knyazeva15_interspeech	['limsi – cnrs – rue john von neumann, orsay, france.', 'universite paris sud – orsay, france.']	4	Speaker and Language Identification
cumani15_interspeech	['dipartimento di automatica e informatica, politecnico di torino, torino, italy']	4	Speaker and Language Identification
panda15_interspeech	['tcs innovation labs-mumbai,', 'yantra park, thane, maharshtra, india', '.']	4	Speaker and Language Identification
doroshin15_interspeech	['stel - computer systems ltd., moscow, russia']	4	Speaker and Language Identification
novoselov15_interspeech	['speech technology center ltd., st. petersburg, russia', 'itmo university, st. petersburg, russia']	4	Speaker and Language Identification
vaquero15_interspeech	['agnitio s.l., madrid, spain']	4	Speaker and Language Identification
kelly15_interspeech	['center for robust speech systems (crss),', 'university of texas at dallas, richardson, texas, usa']	4	Speaker and Language Identification
chen15d_interspeech	['national engineering laboratory for speech and language information processing, ustc, china', 'institute for infocomm research, a*star, singapore', 'this paper investigates the use of frame alignment given by a', 'deep neural network (dnn) for text-constrained speaker verifi-', 'cation task, where the lexical contents of the test utterances are', 'limited to a finite set of vocabulary. the dnn makes use of', 'information carried by the target and its contextual frames to', 'assign it probabilistically to one of the phonetic states. the', 'frame alignment is therefore more precise and less ambiguous', 'than that generated by a gaussian mixture model (gmm). using', 'the dnn alignment, we show that an i-vector can be decom-', 'posed into segments of local variability vectors, each corre-', 'sponding to a monophone, where each local vector models ses-', 'sion variability given the phonetic context. based on the local', 'vectors, the content matching between the utterances for com-', 'parison can be accomplished in the plda scoring. experiments', 'conducted on the rsr2015 database shows that the proposed', 'phone-centric local variability vector achieves a better perform-', 'ance compared to the i-vector.', 'index terms— text-constrained speaker verification, deep neu-', 'ral network, phone-centric local variability', '. introduction', 'over recent years, many approaches based on gaussian mixture', 'model–universal background model (gmm-ubm) [1] have been', 'proposed for speaker verification [2]. based upon similar', 'framework as the eigenvoice model [3], the i-vector was pro-', 'posed in [4] and soon became the mainstream method in speaker', 'verification. similar to a supervector [5], an i-vector is a fixed-', 'length representation of a speech utterance, which typically con-', 'sists of varying number of frames. besides, an i-vector offers a', 'low-dimensional representation of the total variability, contain-', 'ing both speaker and channel information, rendered in an utter-', 'ance. channel compensation could then be performed using the', 'probabilistic linear discriminant analysis (plda) [6], which', 'also serves as the backend classifier.', 'i-vectors have proven to be very effective for text-', 'independent verification when both the training and test utter-', 'ances are of long duration. in text-constrained speaker verifica-', 'tion task, the lexical content of the spoken utterances are con-', 'fined to a finite known set and always of short duration [7]. for', 'short utterances, the content mismatch between the enrollment', 'and test utterances makes it difficult for i-vectors to be applied', 'directly [8', ']. in [11], we proposed the local variability model', '(lvm) with the aim to capture the local variability associated', 'with individual gaussians of the ubm. it unties a shared i-', 'vector among all the gaussians by assigning a local variability', 'vector to each gaussian component. lvm offers a flexible way', 'to compare two utterances in a content-wise manner which may', 'provide a viable solution to the content mismatch problem be-', 'tween utterances of short duration.', 'individual gaussian components of the ubm can be thought', 'of the representation of some low-level acoustic events [10].', 'however, it is generally difficult to associate such events to any', 'well-defined phonetic classes since the ubm is trained in an', 'unsupervised manner. the lexical content modeled by individual', 'gaussians is therefore ambiguous without clear phonetic defini-', 'tion. this problem was addressed in [12] and [13], using deep', 'neural network (dnn) for i-vector extraction. with the dnn for', 'triphone models trained for automatic speech recognition (asr),', 'speech frames are aligned to a predefined set of tied-states,', 'which are treated as gaussian-like units in the i-vector frame-', 'work. thus, every unit is endowed with clear phonetic meaning.', 'in [14], a method to perform the content-matching at the sta-', 'tistics level was proposed, which was shown to be effective for', 'the tasks where the lexical contents of the test utterance is con-', 'fined to those for enrolment. however, in such a method, the i-', 'vectors need to be estimated for the enrolment and test utteranc-', 'es in every trial, resulting in complex computation in the testing', 'phase. in this paper, treating the output nodes of a dnn trained', 'as a monophonic acoustic model for asr as gaussian-like units,', 'we propose to estimate the phone-centric local variability vectors.', 'the benefit of such phone-centric local vectors is that, they are', 'estimated independently before speaker comparison, and can be', 'selected to be compared according to their corresponding pho-', 'netic contents during the subsequent plda scoring, performing', 'content-matching. we show that such local vectors outperform', 'the (dnn) i-vector in the content-matching.', 'the rest of this paper is organized as follows. section 2 re-', 'views the i-vector extraction briefly. section 3 describes the', 'local variability modeling. section 4 proposes the phone-centric', 'local variability vectors. section 5 shows the results of our ex-', 'periments. section 6 is the conclusion.', '. i-vector extraction with gmm vs. dnn', '.1 gmm i-vector', 'the purpose of i-vector extraction is to find a compressed repre-', 'sentation of the speaker and channel information rendered in a', 'variable-length utterance [4]. the fundamental assumption is', 'that the feature vector sequence of the utterance is generated', 'from a session-specific gmm. furthermore, the mean super-', 'vector of the gmm', 'r', 'm  is confined to a low-dimensional sub-', 'space t with origin \x02 , as follows', 'r', 'r', '\x02', '\x03', 'm', '\x02', 'tw ,', '(1)']	4	Speaker and Language Identification
george15_interspeech	['machine intelligence research lab., amrita vishwa vidyapeetham, coimbatore, india', 'tcs innovation labs., mumbai, india']	4	Speaker and Language Identification
shiota15_interspeech	['tokyo metropolitan university, hino, tokyo', '-0065, japan.', 'national institute of informatics, chiyoda, tokyo', '-8430, japan.', 'the institue of statistical and mathematics, tachikawa', '-8562, japan.']	4	Speaker and Language Identification
hurmalainen15_interspeech	['department of signal processing, tampere university of technology, tampere, finland', 'department of signal processing and acoustics, aalto university, espoo, finland']	4	Speaker and Language Identification
alam15_interspeech	['crim, montreal (qc) canada']	4	Speaker and Language Identification
lee15_interspeech	['institute for infocomm research, a*star, singapore', 'universite du mans - lium, france', 'centre de recherche informatique de montreal (crim), quebec, canada', 'agnitio research, somerset west, south africa', 'novolanguage, the netherlands', 'ibm research – haifa, israel', 'voicetrust, ontario, canada', 'agnitio s l., madrid, spain']	4	Speaker and Language Identification
he15_interspeech	['school of computer science and technology, harbin university of science and technology', 'school of computer science and technology, harbin institute of technology, harbin, china']	4	Speaker and Language Identification
nautsch15_interspeech	['⋆da/sec – biometrics and internet security research group, hochschule darmstadt, germany', '†department of signal processing and acoustics, aalto university, finland']	4	Speaker and Language Identification
fredes15_interspeech		4	Speaker and Language Identification
shokouhi15_interspeech	['center for robust speech systems (crss)', 'the university of texas at dallas,tx 75080-3021, usa']	4	Speaker and Language Identification
wang15_interspeech	['tianjin key laboratory of cognitive computation & its applications, tianjin university, tianjin,', 'p. r china', 'center for speaker and language technologies (cslt), tsinghua university, beijing, p r.', 'china', 'school of information science, japan advanced institute of science and technology, ishikawa,', 'japan']	4	Speaker and Language Identification
yella15_interspeech	['idiap research institute, ch-1920 martigny, switzerland.', 'microsoft research, mountain view, ca, u.s.a.']	4	Speaker and Language Identification
shapiro15_interspeech	['afeka tel-aviv academic college of engineering, afeka center for language processing (aclp),', 'israel']	4	Speaker and Language Identification
fedorova15_interspeech	['university of eastern finland, finland', 'brno university of technology, czech republic']	4	Speaker and Language Identification
banse15_interspeech	['the national institute of standards and technology, gaithersburg, maryland usa', 'human language technology center of excellence, johns hopkins university, baltimore,', 'maryland usa', 'mit lincoln laboratory, lexington, massachusetts usa', 'u.s. department of defense, fort meade, maryland usa']	4	Speaker and Language Identification
martin15_interspeech	['the national institute of standards and technology, gaithersburg, maryland, usa', 'u.s. department of defense, fort meade, maryland, usa', '*contractor    #guest researcher']	4	Speaker and Language Identification
desplanques15_interspeech	['elis multimedia lab', 'ghent university - iminds, belgium']	4	Speaker and Language Identification
inoue15_interspeech	['graduate school of informatics, kyoto university, japan', 'graduate school of information science and engineering, ritsumeikan university, japan', 'academic center for computing and media studies, kyoto university, japan']	4	Speaker and Language Identification
delgado15_interspeech	['caiac, autonomous university of barcelona, cerdanyola del valles, spain', 'sinkronigo s.l., barcelona, spain', 'ceri/lia, university of avignon, france']	4	Speaker and Language Identification
sell15_interspeech	['human language technology center of excellence', 'johns hopkins university, baltimore, md, usa']	4	Speaker and Language Identification
woubie15_interspeech	['talp research center, department of signal theory and communications,', 'universitat politecnica de catalunya, barcelona, spain', 'telefonica research, edificio telefonica-diagonal, barcelona, spain']	4	Speaker and Language Identification
madikeri15_interspeech	['idiap research institute , ch-1920 martigny, switzerland']	4	Speaker and Language Identification
raitio15_interspeech	['department of signal processing and acoustics, aalto university, finland', 'institute of behavioural sciences, university of helsinki, finland']	7	Speech Synthesis and Spoken Language Generation
sitaram15_interspeech	['carnegie mellon university, usa']	7	Speech Synthesis and Spoken Language Generation
inai15_interspeech	['graduate school of natural science and technology , okayama university, japan', 'ntt media intelligence laboratories, ntt corporation, japan']		
lu15b_interspeech	['nuance communications inc.']	7	Speech Synthesis and Spoken Language Generation
ohtani15_interspeech	['knowledge media laboratory, coorporate r & d center, toshiba corporation']	7	Speech Synthesis and Spoken Language Generation
xie15_interspeech	['key laboratory of human-machine intelligence-synergy systems,', 'shenzhen institutes of advanced technology, chinese academy of sciences, china', 'cambridge university engineering dept, trumpington st., cambridge, cb2 1pz u.k.', 'the chinese university of hong kong, hong kong, china']	7	Speech Synthesis and Spoken Language Generation
mohammadi15_interspeech	['center for spoken language understanding, oregon health & science university', 'portland, or, usa']		
huber15_interspeech	['sound analysis/synthesis team, ircam-cnrs-upmc stms', ' paris, france', 'stefan (dot) huber, axel (dot) roebel (at) ircam (dot) fr']	7	Speech Synthesis and Spoken Language Generation
huang15_interspeech	['dept. of computer science and information engineering', 'national cheng-kung university, tainan, taiwan']	7	Speech Synthesis and Spoken Language Generation
oshima15_interspeech	['graduate school of information science, nara institute of science and technology, japan']	7	Speech Synthesis and Spoken Language Generation
toman15_interspeech	['ftw telecommunications research center vienna, austria']	7	Speech Synthesis and Spoken Language Generation
wu15_interspeech	['the centre for speech technology research, university of edinburgh, united kingdom']	7	Speech Synthesis and Spoken Language Generation
wang15b_interspeech	['national laboratory of pattern recognition, institute of automation,', 'chinese academy of sciences, beijing, china', 'beijing key laboratory of mobile computing and pervasive device,', 'institute of computing technology, chinese academy of sciences, beijing, china']	7	Speech Synthesis and Spoken Language Generation
ninh15_interspeech	['graduate school of science and engineering, ritsumeikan university, japan']	7	Speech Synthesis and Spoken Language Generation
merritt15_interspeech	['the centre for speech technology research, university of edinburgh, united kingdom', 'national institute of informatics, japan']	7	Speech Synthesis and Spoken Language Generation
chen15e_interspeech	['key laboratory of shanghai education commission for', 'intelligent interaction and cognitive engineering', 'speechlab, department of computer science and engineering', 'shanghai jiao tong university, shanghai, china']	7	Speech Synthesis and Spoken Language Generation
watts15_interspeech	['centre for speech technology research, university of edinburgh, uk']	7	Speech Synthesis and Spoken Language Generation
betz15_interspeech	['bielefeld university, phonetics and phonology workgroup', 'bielefeld university, dialogue systems group']	7	Speech Synthesis and Spoken Language Generation
szaszak15_interspeech	['department of telecommunications and media informatics,', 'budapest university of technology and economics', 'research institute for linguistics, hungarian academy of sciences']	7	Speech Synthesis and Spoken Language Generation
lanchantin15_interspeech	['†cambridge university engineering department, cambridge cb2 1pz, uk', '∗centre for speech technology research, university of edinburgh, edinburgh eh8 9ab, uk']	7	Speech Synthesis and Spoken Language Generation
thu15_interspeech	['multilingual translation lab., nict, kyoto, japan', 'natural language processing lab., ucsy, yangon, myanmar', 'spoken language communication lab., nict, kyoto, japan']	7	Speech Synthesis and Spoken Language Generation
takaki15_interspeech	['national institute of informatics (nii), tokyo', '-8430, japan', 'naver labs, naver corporation, seongnam', '-867, korea', 'the centre for speech technology research (cstr),', 'university of edinburgh, edinburgh, eh8 9lw, united kingdom']	7	Speech Synthesis and Spoken Language Generation
yao15_interspeech	['microsoft research']	7	Speech Synthesis and Spoken Language Generation
kay15_interspeech	['centre for speech technology research, university of edinburgh, uk', 'speech technology group, universidad politecnica de madrid, spain']	7	Speech Synthesis and Spoken Language Generation
eger15_interspeech	['text technology lab, goethe university frankfurt am main']	7	Speech Synthesis and Spoken Language Generation
ding15_interspeech	"[""school of computer science, northwestern polytechnical university, xi'an, china"", ""school of software and microelectronics, northwestern polytechnical university, xi'an, china""]"	7	Speech Synthesis and Spoken Language Generation
tobing15_interspeech	['graduate school of information science, nara institute of technology ( naist), japan']	7	Speech Synthesis and Spoken Language Generation
cornu15_interspeech	['university of east anglia']	7	Speech Synthesis and Spoken Language Generation
sitaram15b_interspeech	['carnegie mellon university, usa', 'university of california, san francisco, usa']	7	Speech Synthesis and Spoken Language Generation
wester15_interspeech	['the centre for speech technology research, the university of edinburgh, uk', 'cereproc ltd., uk', 'cambridge university engineering department, university of cambridge, uk']	7	Speech Synthesis and Spoken Language Generation
evrard15_interspeech	"['limsi-cnrs, audio & acoustic group', ""rue john von neumann, campus universitaire d'orsay"", 'bˆat. 508, f-91405 orsay cedex, france']"	7	Speech Synthesis and Spoken Language Generation
ardaillon15_interspeech	['ircam - umr stms (ircam - cnrs - sorbonne universites upmc paris 06)', 'paris, france']	7	Speech Synthesis and Spoken Language Generation
jauk15_interspeech	['speech processing group (veu), signal theory and communication department', 'universitat politecnica de catalunya, upc campus nord, c/jordi girona 1-3', ' barcelona', 'multimedia technologies group (gtm), atlanttic research centre, universidade de vigo', 'e.e. de telecomunicacion, campus universitario de vigo', ' vigo']	7	Speech Synthesis and Spoken Language Generation
aryal15_interspeech	['department of computer science and engineering, texas a&m university']	7	Speech Synthesis and Spoken Language Generation
matousek15_interspeech	['department of cybernetics', 'new technologies for the information society (ntis)', 'faculty of applied sciences, university of west bohemia, czech rep.']	12	Spoken Language Processing – Translation, Information Retrieval, and Resources
schweitzer15_interspeech	['institute for natural language processing, university of stuttgart, germany']	12	Spoken Language Processing – Translation, Information Retrieval, and Resources
chen15f_interspeech	['institute for infocomm research, singapore']	12	Spoken Language Processing – Translation, Information Retrieval, and Resources
wong15_interspeech	['human-computer communications laboratory,', 'department of systems engineering and engineering management', 'stanley ho big data decision analytics research centre,', 'school of life sciences,', 'cuhk-utrecht university centre for language, mind and brain,', 'department of linguistics and modern languages,', ',2,3,4the chinese university of hong kong, hong kong sar, china', 'department of linguistics, university of washington, seattle, wa usa']	12	Spoken Language Processing – Translation, Information Retrieval, and Resources
arsikere15_interspeech	['data analytics lab, xerox research center–india (xrci), bangalore, karnataka, india']	12	Spoken Language Processing – Translation, Information Retrieval, and Resources
can15_interspeech	['department of computer science and 2department of electrical engineering,', 'university of southern california, los angeles, ca, usa', 'department of psychiatry and behavioral sciences, university of washington, seattle, wa, usa']	12	Spoken Language Processing – Translation, Information Retrieval, and Resources
vapnarsky15_interspeech	['centre erea du lesc, cnrs & universite paris ouest, france', 'limsi-cnrs, univ. paris-sud', ', orsay, france']	12	Spoken Language Processing – Translation, Information Retrieval, and Resources
hasan15_interspeech	['the university of sheffield, sheffield, united kingdom']		
kuang15_interspeech	['department of linguistics, university of pennsylvania, u.s.a.']	2	Phonetics, Phonology, and Prosody
bao15_interspeech	['school of computer software, tianjin university', 'school of computer science and technology, tianjin university', 'chinese academy of social science', 'school of information science, jaist, japan']	1	Speech Perception, Production, and Acquisition
barbier15_interspeech	['speech and cognition department, gipsa-lab, cnrs & grenoble university, grenoble, france', 'anatomy laboratory, montpellier university, montpellier, france', 'lpnc, cnrs & grenoble university, grenoble, france', 'crnl, inserm, cnrs & lyon 1 university, lyon, france']	1	Speech Perception, Production, and Acquisition
sivaraman15_interspeech		1	Speech Perception, Production, and Acquisition
barbier15b_interspeech	['speech and cognition department, gipsa-lab & grenoble university, grenoble, france', 'department of linguistics, universite du quebec a montreal, montreal, quebec, canada', 'univ. grenoble alpes, timc-imag, f-38000 grenoble, france', 'cnrs, timc-imag, f-38000 grenoble, france', 'haskins laboratories, new haven, connecticut, usa', 'mit, cambridge, massachusetts, usa;', 'boston university, boston, massachusetts, usa']	1	Speech Perception, Production, and Acquisition
kaburagi15_interspeech	['kyushu university', '-9-1 shiobaru, minami-ku, fukuoka, japan']	1	Speech Perception, Production, and Acquisition
skordilis15_interspeech	['signal analysis & interpretation lab, university of southern california, los angeles, ca, usa', 'educational testing service r&d', ' new montgomery st, #1500, san francisco, ca, usa', 'department of linguistics, university of southern california, los angeles, ca, usa']	1	Speech Perception, Production, and Acquisition
fer15_interspeech		4	Speaker and Language Identification
mccree15_interspeech	['human language technology center of excellence', 'johns hopkins university, baltimore, md, usa']	4	Speaker and Language Identification
song15_interspeech	['national engineering laboratory of speech and language information processing,', 'university of science and technology of china, hefei, china']	4	Speaker and Language Identification
lozanodiez15_interspeech	['atvs-biometric recognition group, universidad autonoma de madrid, madrid, spain']	4	Speaker and Language Identification
hautamaki15_interspeech	['school of computing, university of eastern finland, finland', 'faculty of architecture and engineering, university of enna ”kore”, italy', 'school of ece, georgia institute of technology, usa']	4	Speaker and Language Identification
geng15_interspeech	['interactive digital media technology research center', 'institute of automation chinese academy of sciences, beijing 100190, china']	4	Speaker and Language Identification
asaei15_interspeech	['idiap research institute, martigny, switzerland', 'ecole polytechnique federale de lausanne (epfl), switzerland']	6	Speech Coding and Enhancement
lenarczyk15_interspeech	['institute of computer science, polish academy of sciences', '(ipi pan)']	6	Speech Coding and Enhancement
issing15_interspeech	['computer networks and communication systems, dept. of computer science,', 'university of erlangen, germany', 'fraunhofer institut integrierte schaltungen, erlangen']	6	Speech Coding and Enhancement
issing15b_interspeech	['computer networks and communication systems, dept. of computer science,', 'university of erlangen, germany', 'fraunhofer institut integrierte schaltungen, erlangen']	6	Speech Coding and Enhancement
hines15_interspeech	['school of computing, dublin institute of technology, ireland', 'sigmedia, school of engineering, trinity college dublin, ireland']	6	Speech Coding and Enhancement
gallardo15_interspeech	['faculty of estem, university of canberra, australia', 'quality and usability lab, telekom innovation laboratories, tu berlin, germany']	6	Speech Coding and Enhancement
levit15_interspeech	['microsoft corporation, u.s.a.']	9	Speech Recognition – Architecture, Search, and Linguistic Components
kobayashi15_interspeech	['nhk (japan broadcasting corporation)', 'science and technology research laboratories, tokyo, japan']	9	Speech Recognition – Architecture, Search, and Linguistic Components
ma15b_interspeech	['center for speech and language technology (cslt),', 'research institute of information technology, tsinghua university', 'tsinghua national lab for information science and technology']	9	Speech Recognition – Architecture, Search, and Linguistic Components
masumura15_interspeech	['† ntt media intelligence laboratories, ntt corporation, japan', '‡ graduate school of engineering, tohoku university, japan']	9	Speech Recognition – Architecture, Search, and Linguistic Components
aleksic15_interspeech	['google inc.']	9	Speech Recognition – Architecture, Search, and Linguistic Components
vasserman15_interspeech	['google, inc.']	9	Speech Recognition – Architecture, Search, and Linguistic Components
schuller15_interspeech	['department of computing, imperial college london, uk', 'chair of complex & intelligent systems, university of passau, germany', 'pattern recognition lab, fau erlangen-nuremberg, germany', 'machine intelligence & signal processing group, tum, munich, germany', 'faculty of engineering, universidad de antioquia, medellin, colombia']	3	Analysis of Paralinguistics in Speech and Language
montacie15_interspeech	['stih laboratory, paris sorbonne university', ' rue serpente', ', paris, france', 'paris descartes university', ' rue des saints-peres', ', paris, france']	3	Analysis of Paralinguistics in Speech and Language
ribeiro15_interspeech	['l2f – spoken language systems laboratory – inesc-id lisboa', 'instituto superior tecnico, universidade de lisboa, portugal', 'vivolab, i3a, universidad de zaragoza, spain', 'flul/clul, universidade de lisboa, portugal', 'iscte-iul – instituto universitario de lisboa, portugal']	3	Analysis of Paralinguistics in Speech and Language
black15_interspeech	['signal analysis & interpretation laboratory, univ. of southern california, los angeles, ca, usa', 'information sciences institute, univ. of southern california, marina del rey, ca, usa', 'behavioral informatix, llc, los angeles, ca, usa', 'http://sail.usc.edu,', 'www.isi.edu,', 'www.behavioralinformatix.com']	3	Analysis of Paralinguistics in Speech and Language
sztaho15_interspeech	['budapest university of technology and economics', 'department of telecommunications and media informatics']	3	Analysis of Paralinguistics in Speech and Language
zlotnik15_interspeech	['speech technology group, etsit, universidad politecnica de madrid, spain', 'dept. of signal theory and communications, universidad carlos iii de madrid, spain']	3	Analysis of Paralinguistics in Speech and Language
an15_interspeech	['department of computer science, cuny graduate center, usa', 'department of linguistics, cuny graduate center, usa', 'department of computer science, queens college (cuny), usa']	3	Analysis of Paralinguistics in Speech and Language
hahm15_interspeech	['speech disorders & technology lab, department of bioengineering', 'callier center for communication disorders', 'university of texas at dallas, richardson, texas, united states', 'university of texas southwestern medical center, dallas, texas, united states']	3	Analysis of Paralinguistics in Speech and Language
williamson15_interspeech	['mit lincoln laboratory, lexington, massachusetts, usa', 'massachusetts institute of technology, cambridge, massachusetts, usa']	3	Analysis of Paralinguistics in Speech and Language
prasad15_interspeech	['electrical engineering, indian institute of science (iisc), bangalore-560012, india']	3	Analysis of Paralinguistics in Speech and Language
wagner15_interspeech	['university of augsburg, lab for human centered multimedia, germany']	3	Analysis of Paralinguistics in Speech and Language
pir15_interspeech	['department of computer science', 'the graduate center', 'queens college', 'city university of new york, new york, usa']	3	Analysis of Paralinguistics in Speech and Language
pellegrini15_interspeech	['universite de toulouse; ups; irit; toulouse, france']	3	Analysis of Paralinguistics in Speech and Language
milde15_interspeech	['language technology group, tu darmstadt, germany']	3	Analysis of Paralinguistics in Speech and Language
kaya15_interspeech	['department of computer engineering, bogazici university, bebek, ˙istanbul, turkey', 'st. petersburg institute for informatics and automation of russian academy of sciences, russia', 'itmo university, st. petersburg, russia']	3	Analysis of Paralinguistics in Speech and Language
kim15_interspeech	['signal analysis & interpretation laboratory, univ. of southern california, los angeles, ca, usa', 'information sciences institute, univ. of southern california, marina del rey, ca, usa', 'http://sail.usc.edu,', 'www.isi.edu']	3	Analysis of Paralinguistics in Speech and Language
grosz15_interspeech	['institute of informatics, university of szeged, hungary', 'department of computer science, university of paderborn, germany', 'mta-szte research group on artificial intelligence, szeged, hungary']	3	Analysis of Paralinguistics in Speech and Language
houghton15_interspeech	['school of electronic, electrical and systems engineering,', 'gisbert kapp building, university of birmingham b15 2tt, uk.']	8	Speech Recognition – Signal Processing, Acoustic Modeling, Robustness, and Adaptation
zeng15_interspeech	['center for speech and language technology (cslt),', 'research institute of information technology, tsinghua university', 'tsinghua national lab for information science and technology', 'beijing university of posts and telecommunications', 'chongqing university of posts and telecommunicatoins']	8	Speech Recognition – Signal Processing, Acoustic Modeling, Robustness, and Adaptation
chen15g_interspeech	['center for language and speech processing', 'human language technology center of excellence', 'the johns hopkins university, baltimore, md 21218, usa']	8	Speech Recognition – Signal Processing, Acoustic Modeling, Robustness, and Adaptation
davel15_interspeech	['multilingual speech technologies, north-west university, vanderbijlpark, south africa.', 'raytheon bbn technologies, cambridge, ma 02138, usa.']	8	Speech Recognition – Signal Processing, Acoustic Modeling, Robustness, and Adaptation
zheng15_interspeech	['national laboratory of pattern recognition, institute of automation,', 'chinese academy of sciences, beijing, p.r.china', 'electric power research institute of shanxi electric power company, china state grid corp']	8	Speech Recognition – Signal Processing, Acoustic Modeling, Robustness, and Adaptation
marcheret15_interspeech	['ibm thomas j watson research center, yorktown heights, ny 10598, usa', 'dept. of electrical and computer engineering, university of thessaly, volos 38221, greece', 'ibm czech republic, prague-chodov 14800, czech republic']	8	Speech Recognition – Signal Processing, Acoustic Modeling, Robustness, and Adaptation
kalantari15_interspeech	['speech, audio, image, and video technologies, science and engineering faculty', 'queensland university of technology', ' george st, brisbane, australia 4000']	8	Speech Recognition – Signal Processing, Acoustic Modeling, Robustness, and Adaptation
kalantari15b_interspeech	['speech, audio, image, and video technologies, science and engineering faculty', 'queensland university of technology', ' george st, brisbane, australia 4000']	8	Speech Recognition – Signal Processing, Acoustic Modeling, Robustness, and Adaptation
ninomiya15_interspeech	['department of electrical engineering and computer science, nagoya university, japan', 'faculty of engineering, university of tokushima, japan', 'department of engineering, gifu university, japan', 'school of information science and technology, aichi prefectural university, japan']	8	Speech Recognition – Signal Processing, Acoustic Modeling, Robustness, and Adaptation
kakouros15_interspeech	['department of signal processing and acoustics, aalto university, finland']	8	Speech Recognition – Signal Processing, Acoustic Modeling, Robustness, and Adaptation
cernak15_interspeech	['idiap research institute, martigny, switzerland']	8	Speech Recognition – Signal Processing, Acoustic Modeling, Robustness, and Adaptation
ning15_interspeech	['tsinghua-cuhk joint research center for media sciences, technologies and systems,', 'graduate school at shenzhen, tsinghua university, shenzhen 518055, china', 'tsinghua national laboratory for information science and technology (tnlist),', 'department of computer science and technology, tsinghua university, beijing 100084, china', 'department of systems engineering and engineering management,', 'the chinese university of hong kong, shatin, n.t., hong kong sar, china', 'beijing samsung telecom r&d center, beijing 100081, china']	8	Speech Recognition – Signal Processing, Acoustic Modeling, Robustness, and Adaptation
bai15_interspeech	['school of electronic electrical and systems engineering,', 'the university of birmingham, birmingham b15 2tt, uk']	5	Analysis of Speech and Audio Signals
uchida15_interspeech	['the university of tokyo', '-3-1, hongo, bunkyo-ku, tokyo', '-8656 japan']	5	Analysis of Speech and Audio Signals
pappagari15_interspeech	['department of electrical engineering', 'indian institute of technology hyderabad, india']	5	Analysis of Speech and Audio Signals
loweimi15_interspeech	['speech and hearing research group (spandh), university of sheffield, sheffield, uk']	5	Analysis of Speech and Audio Signals
maia15_interspeech	['†toshiba research europe limited, cambridge research laboratory, cambridge, uk', '‡toshiba corporation, corporate research and development center, kawasaki, japan']	5	Analysis of Speech and Audio Signals
liberatore15_interspeech	['department of computer science and engineering, texas a&m university, united states']	5	Analysis of Speech and Audio Signals
csapo15_interspeech	['department of telecommunications and media informatics,', 'budapest university of technology and economics, budapest, hungary']	5	Analysis of Speech and Audio Signals
preu15_interspeech	['institute of acoustics and speech communication, technische universitat dresden']	5	Analysis of Speech and Audio Signals
abari15_interspeech	['university of debrecen, hungary', 'budapest university of technology and economics, department of telecommunications and', 'media informatics, hungary']	5	Analysis of Speech and Audio Signals
hsu15_interspeech	['department of electrical and computer engineering, national chiao tung university, taiwan']	5	Analysis of Speech and Audio Signals
laporte15_interspeech	['department of electrical engineering, ecole de technologie superieure, montreal canada', 'department of linguistics, universite du quebec a montreal, montreal canada']	5	Analysis of Speech and Audio Signals
websdale15_interspeech	['university of east anglia']	5	Analysis of Speech and Audio Signals
mertens15_interspeech	"['laboratory of images, signals and acoustics. universite libre de bruxelles, brussels, belgium', 'national fund for scientific research, belgium', ""neurology department of pays d'aix hospital, france"", 'lpl, laboratoire parole et langage, cnrs umr 6057, aix-marseille university, france', 'department of neurology, knappschaftskrankenhaus, ruhr university of bochum, germany']"	5	Analysis of Speech and Audio Signals
godoy15_interspeech	['mit lincoln laboratory', ' wood street, lexington, ma 02420']	5	Analysis of Speech and Audio Signals
houghton15b_interspeech	['school of electronic, electrical and systems engineering,', 'gisbert kapp building, university of birmingham b15 2tt, uk.']		
meenakshi15_interspeech	['electrical engineering, indian institute of science (iisc), bangalore-560012, india']	5	Analysis of Speech and Audio Signals
tsai15_interspeech	['eecs department, university of california berkeley, berkeley, ca usa', 'international computer science institute, berkeley, ca usa', 'microsoft research, mountain view, ca usa']	5	Analysis of Speech and Audio Signals
zohrer15_interspeech	['signal processing and speech communication lab, graz university of technology', ',', 'bee-pri biotechmed-graz, idn – inst. of physiology, medical university of graz', ',']	5	Analysis of Speech and Audio Signals
gowda15_interspeech	['dept. of signal processing and acoustics, aalto university, finland']	5	Analysis of Speech and Audio Signals
drugman15_interspeech	['toshiba cambridge research laboratory, uk']	5	Analysis of Speech and Audio Signals
lu15c_interspeech	['. national institute of information and communications technology, japan', '. research center for information technology innovation, academic sinica, taiwan']	5	Analysis of Speech and Audio Signals
anushiyarachel15_interspeech	['speech lab, ssn college of engineering, chennai, india']	5	Analysis of Speech and Audio Signals
montano15_interspeech	['gtm - grup de recerca en tecnologies media, la salle - universitat ramon llull', 'quatre camins', ', barcelona, spain']	5	Analysis of Speech and Audio Signals
hyafil15_interspeech	['department of information and communication technologies', 'center for brain and cognition, universitat pompeu fabra, barcelona, spain', 'auditory language group, centre medical universitaire (cmu), geneva, switzerland', 'idiap research institutes, martigny, switzerland']	5	Analysis of Speech and Audio Signals
lee15b_interspeech	['mit computer science and artificial intelligence laboratory,', 'cambridge, massachusetts 02139, usa']	10	Speech Recognition – Technologies and Systems for New Applications
rasipuram15_interspeech	['idiap research institute, martigny, switzerland']	10	Speech Recognition – Technologies and Systems for New Applications
ma15c_interspeech	['graduate center, the city university of new york', 'educational testing service, princeton, nj']	10	Speech Recognition – Technologies and Systems for New Applications
lunsford15_interspeech	['center for spoken language understanding', 'oregon health & science university', 'portland, or, usa']	10	Speech Recognition – Technologies and Systems for New Applications
fontan15_interspeech	['universite de toulouse; ups; irit; toulouse, france', 'universite de toulouse; ut2j; letra; toulouse, france', 'archean technologies; montauban, france']	10	Speech Recognition – Technologies and Systems for New Applications
chakravarthula15_interspeech	['dept. electrical engineering, university of southern california, u.s.a.', 'dept. educational psychology, university of utah, u.s.a.', 'dept. psychiatry & behavioral sciences, university of washington, u.s.a.']	10	Speech Recognition – Technologies and Systems for New Applications
liu15b_interspeech	['university of washington, seattle']	10	Speech Recognition – Technologies and Systems for New Applications
kamper15_interspeech	['cstr and 2ilcc, school of informatics, university of edinburgh, uk', 'hltcoe and clsp, johns hopkins university, usa']	10	Speech Recognition – Technologies and Systems for New Applications
tilk15_interspeech	['institute of cybernetics', 'tallinn university of technology, estonia']	10	Speech Recognition – Technologies and Systems for New Applications
ylmaz15_interspeech	['dept. esat-psi, ku leuven, belgium']	10	Speech Recognition – Technologies and Systems for New Applications
gao15_interspeech		10	Speech Recognition – Technologies and Systems for New Applications
joshi15_interspeech	['department of electrical engineering, indian institute of technology bombay, india']	10	Speech Recognition – Technologies and Systems for New Applications
kumar15b_interspeech	['microsoft corporation, redmond, wa']	10	Speech Recognition – Technologies and Systems for New Applications
liu15c_interspeech	['department of systems engineering and engineering management,', 'the chinese university of hong kong, hong kong sar, china', 'human language technology department,', 'institute for infocomm research, singapore']	10	Speech Recognition – Technologies and Systems for New Applications
sharma15_interspeech	['iit mandi, india']	10	Speech Recognition – Technologies and Systems for New Applications
niculescu15_interspeech			
yeo15_interspeech	['institute for infocomm research, singapore']		
dharo15_interspeech	['institute for infocomm research - a*star', 'fusionopolis way, connexis south', 'singapore']		
salimbajevs15_interspeech	['tilde', 'a vienibas gatve, lv-1004, riga, latvia', 'university of latvia', ' raina blvd., lv-1586, riga, latvia']		
gaka15_interspeech	['agh university of science and technology', 'faculty of computer science, electronics and telecommunications, krakow pl–30059']		
abdelali15_interspeech	['qatar computing research institute, hbku, doha, qatar']		
stadtschnitzer15_interspeech	['fraunhofer iais, schloss birlinghoven, sankt augustin, germany']		
bell15_interspeech	['centre for speech technology research, university of edinburgh, edinburgh eh8 9ab, uk']		
znotins15_interspeech	['institute of mathematics and computer science, university of latvia', 'leta, latvia']		
assayag15_interspeech	['intel corporation israel, po box 1659, matam industrial park, haifa 31015, israel', 'intel labs, santa clara , ca ', ' usa', 'intel corporation germany, dornacher strasse 1, d-85622 feldkirchen/muenchen, germany']		
zioko15_interspeech	['agh university of science and technology,', 'department of computer science, electronics and telecommunications,', 'al. mickiewicza 30, krakow, poland, www.dsp.agh.edu.pl', 'techmo, krakow, poland, techmo.pl']		
faria15_interspeech	['remeeting, inc.']		
masudakatsuse15_interspeech	['faculty of humanity-oriented science and engineering, kindai university, fukuoka, japan']		
kaufhold15_interspeech	['pattern recognition lab, fau erlangen-nuremberg, germany', 'e.sigma technology gmbh, ilmenau, germany']		
azarov15_interspeech	['computer engineering department, belarusian state university of informatics and radioelectronics,', ', p.brovky str.', ', minsk, belarus']		
duplessis15_interspeech	['limsi-cnrs', 'universite paris sud', 'universite paris sorbonne - paris 4', 'lium']		
lange15_interspeech	['institute for natural language processing, university of stuttgart, germany']		
berkling15_interspeech	['cooperative state university, karlsruhe, germany', 'logopraxen, karlsruhe, germany', 'inline internet online gmbh, germany']		
wong15b_interspeech	['stanley ho big data decision analytics research centre,', 'the chinese university of hong kong,', 'hong kong sar, china']		
rothlisberger15_interspeech	['ulla', 'richardson 4, silvia brem 1,2', 'university clinic for child and adolescent psychiatry, university of zurich, switzerland', 'neuroscience center zurich, university of zurich and eth zurich, switzerland', 'department of comparative linguistics, university of zurich, switzerland', 'the agora center, university of jyvaskyla, finland']		
pfab15_interspeech	['institut fur phonetik und sprachverarbeitung, lmu munchen, munich, germany', 'entwicklungsgruppe klinische neuropsychologie (ekn), munchen']		
patil15_interspeech	['data analytics lab, xerox research center india (xrci), bangalore, karnataka, india']		
anguera15_interspeech	['sinkronigo, s.l., barcelona, spain']		
besacier15_interspeech			
lee15c_interspeech	['institute for infocomm research, a*star, singapore']		
arai15_interspeech	['department of information and communication sciences', 'sophia university, tokyo, japan']		
budnik15_interspeech	"[""laboratoire d'informatique de grenoble (lig), univ. grenoble alpes, grenoble, france"", 'limsi, cnrs - orsay, france', 'list, luxembourg']"		
kisler15_interspeech	['bavarian archive of speech signals,', 'ludwig-maximilians-universitat munchen, germany']		
winkelmann15_interspeech	['institute of phonetics and speech processing,', 'ludwig maximilian university of munich']		
wankerl15_interspeech	['pattern recognition lab, fau erlangen-nuremberg, germany', 'machine intelligence & signal processing group, tum, munich, germany', 'faculty of engineering, universidad de antioquia, medellin, colombia']		
kumar15c_interspeech	"['raytheon bbn technologies', 'moulton street, cambridge, ma 02138, usa', 'abstract1', 'component models of speech-to-speech translation (s2s)', 'systems need to be customized to emerging needs. in this', 'demonstration, we will showcase the technical functionality of', ""bbn's domain customization tools for s2s systems that allow"", 'subject matter experts to augment an existing s2s system with', 'new vocabulary items and translation rules using a web-based', 'user interface. to reduce the user effort and time, our tools', 'leverage wikipedia as a linguistic resource for enrichment of', 'domain profiles by finding lexical items and translations', 'related to the domain. in a recent evaluation of bbn s2s', 'system customized for using these tools, we found 15%', '(relative) reduction in word error rate as well as 30% (relative)', 'reduction in untranslatable words when used within', 'customized conversational domains.', 'index', 'terms:', 'speech-to-speech', 'translation,', 'domain', 'customization, web as a resource', '. introduction', 'over the past decade, considerable progress has been made in', 'developing', 'usable,', 'two-way', 'speech-to-speech', '(s2s)', 'translation systems that enable real time cross-lingual spoken', 'communication [1].  state-of-the-art s2s systems comprise a', 'number of advanced technology components that perform', 'automatic speech recognition (asr), statistical machine', 'translation (smt) and text-to-speech synthesis (tts).', 'these components are trained on large volumes of data that is', 'collected to represent anticipated domains of use.', 'on the other hand, unforeseen scenarios for the use of', 'such systems emerge on a regular basis. examples of emergent', 'domains of use include natural disasters (e.g. landslides due to', 'torrential rains), humanitarian relief (e.g. refugee processing)', 'and medical emergencies (e.g. the recent outbreaks of middle-', 'eastern respiratory syndrome, or mers). unfortunately, the', 'performance of system components suffers dramatically when', 'they are used in domains that have limited or no coverage', 'within the training data. in particular, the asr component will', 'fail to recognize previously unseen (out-of-vocabulary or', '“oov”) words. furthermore, novel meanings of known words', 'in new domains may not be translated accurately. these', 'this work was funded by the darpa bolt program under', 'contract number hr0011-12-c-0014. the views, opinions,', 'and/or findings contained in this article are those of the', 'authors and should not be interpreted as representing the', 'official views or policies of the department of defense or the', 'u.s. government. approved for public release, distribution', 'unlimited.', 'failures cause non-communication and miscommunication of', 'critical concepts in s2s mediated cross-lingual interaction.', 'collecting large volumes of speech and text corpora in', 'response to emergent domains may not be feasible, given that', 'a s2s system would need to be deployed in a matter of hours', 'or days, rather than weeks or months. the objective of our', 'current work is to enable rapid extension of the conversational', 'repertoire of s2s systems to new domains.', 'we achieve this objective by developing workflows,', 'discussed in section 3, as well as technologies that allow', 'bilingual subject matter experts (smes) who are not s2s', 'system developers to customize s2s systems. we have created', 'web-based tools, presented next, that operationalize an', 'efficient customization workflow within which smes can', 'specify phrase pairs new to the emergent domain.', '. domain customization tools', 'figure 1. customization tool: editing a domain profile', 'the domain customization tool, referred to as customizer, is a', 'web based application that allows a customization team to', 'create and maintain domain profiles. figure 1 shows an', 'example of domain profile for medical triage. one of the use-', 'cases for this profile is performing triage following an', 'earthquake. users can specify a number of phrase pairs in both', 'translation directions. oov words in the customization are', 'automatically highlighted (e.g. landslide) which helps users', 'identify which words are critical to improving asr', 'performance in the new domain.', 'besides functionality for organizing and editing phrase', 'pairs, the customizer includes a number of advanced features', 'to facilitate the customization process. automatic translations', 'of phrases are made available to reduce the manual effort of', 'the bilingual speaker. automatic translations can be edited', 'when necessary. users can enrich manually entered phrases', 'using automatic phrase enrichment which uses wikipedia to', 'find keywords and phrases in articles about the manually', 'copyright © 2015 isca', 'september 6-10', ', dresden, germany', 'interspeech 2015: show & tell contribution']"		
metze15_interspeech	['language technologies institute, carnegie mellon university, pittsburgh, pa; u.s.a.', 'dept. of computer science and engineering, the ohio state university, columbus, oh; u.s.a.', 'computer science department, minnesota state university, mankato, mn; u.s.a.']		
rennies15_interspeech	['fraunhofer idmt, hearing, speech and audio technology, and cluster of', 'excellence hearing4all, oldenburg, germany', 'university of oldenburg, signal processing group and cluster of excellence', 'hearing4all, oldenburg, germany']		
moller15_interspeech	['quality and usability lab, telekom innovation laboratories, tu berlin']		
sityaev15_interspeech	['genesys, united states of america']		
itakura15_interspeech	['graduate school of informatics, kyoto university, japan']	8	Speech Recognition – Signal Processing, Acoustic Modeling, Robustness, and Adaptation
himawan15_interspeech	['idiap research institute, martigny, switzerland', 'science and engineering faculty, queensland university of technology']	8	Speech Recognition – Signal Processing, Acoustic Modeling, Robustness, and Adaptation
dekkers15_interspeech	['esat-etc/advise, ku leuven tc geel, kleinhoefstraat 4', ', geel, belgium', 'esat-stadius, ku leuven, kasteelpark arenberg', ', leuven, belgium', 'esat-psi, ku leuven, kasteelpark arenberg', ', leuven, belgium', 'iminds, medical it, kasteelpark arenberg', ', leuven, belgium']	8	Speech Recognition – Signal Processing, Acoustic Modeling, Robustness, and Adaptation
kim15b_interspeech	['google, mountain view ca 94043 usa']		
ravanelli15_interspeech	['fondazione bruno kessler, trento, italy']	8	Speech Recognition – Signal Processing, Acoustic Modeling, Robustness, and Adaptation
miao15_interspeech	['language technologies institute, school of computer science, carnegie mellon university']	8	Speech Recognition – Signal Processing, Acoustic Modeling, Robustness, and Adaptation
levy15_interspeech	['grk „frequency effects in language“, university of freiburg']	1	Speech Perception, Production, and Acquisition
tong15_interspeech	['institute for infocomm research, singapore']	1	Speech Perception, Production, and Acquisition
jugler15_interspeech	['saarland university, saarbrucken, germany', 'ludwig maximilian university, munich, germany']	1	Speech Perception, Production, and Acquisition
bao15b_interspeech	['research center for linguistic sciences, tianjin university, china', 'school of liberal arts and law, tianjin university, china', 'tianjin key laboratory of cognitive computing and application, china', 'school of information science, japan advanced institute of science and technology, japan']	1	Speech Perception, Production, and Acquisition
saha15_interspeech	['centre for educational technology, indian institute of technology, kharagpur, india']	1	Speech Perception, Production, and Acquisition
naganomadsen15_interspeech	['department of languages and literatures, university of gothenburg, sweden']	1	Speech Perception, Production, and Acquisition
sar15_interspeech	['bogazici university, bebek, istanbul', ', turkey']	12	Spoken Language Processing – Translation, Information Retrieval, and Resources
mendels15_interspeech	['columbia university, new york, usa', 'university of cambridge, cambridge, uk']	12	Spoken Language Processing – Translation, Information Retrieval, and Resources
domoto15_interspeech	['graduate school of systems and information engineering, university of tsukuba, japan', 'interdisplinary graduate school of medicine and engineering, university of yamanashi, japan']	12	Spoken Language Processing – Translation, Information Retrieval, and Resources
zhang15_interspeech	['raytheon bbn technologies, cambridge, ma, usa.']	12	Spoken Language Processing – Translation, Information Retrieval, and Resources
bertero15_interspeech	['human language technology center', 'department of electronic and computer engineering', 'the hong kong university of science and technology, clear water bay, hong kong']	12	Spoken Language Processing – Translation, Information Retrieval, and Resources
hough15_interspeech	['dialogue systems group', 'faculty of linguistics and literature', 'bielefeld university']	12	Spoken Language Processing – Translation, Information Retrieval, and Resources
hu15_interspeech	['the centre for speech technology research,university of edinburgh, uk', 'toshiba research europe ltd, cambridge, uk']	7	Speech Synthesis and Spoken Language Generation
achanta15_interspeech	['international institute of information technology, hyderabad, india']	7	Speech Synthesis and Spoken Language Generation
fan15_interspeech	['microsoft research asia, beijing, china']	7	Speech Synthesis and Spoken Language Generation
valentinibotinhao15_interspeech	['the centre for speech technology research, university of edinburgh, united kingdom']	7	Speech Synthesis and Spoken Language Generation
song15b_interspeech	['department of electrical and electronic engineering, yonsei university, seoul, korea']	7	Speech Synthesis and Spoken Language Generation
wu15b_interspeech		7	Speech Synthesis and Spoken Language Generation
wang15c_interspeech	['national engineering laboratory for speech and language information processing,', 'university of science and technology of china, hefei, anhui, p r. china', 'school of electrical and computer engineering, georgia institute of technology, usa']	4	Speaker and Language Identification
irtza15_interspeech	['school of electrical engineering and telecommunications, unsw australia', 'atp research laboratory, national ict australia (nicta), australia', 'institute for infocomm research, a*star, singapore']	4	Speaker and Language Identification
cumani15b_interspeech	['politecnico di torino, italy']	4	Speaker and Language Identification
lykartsis15_interspeech	['audio communication group, technische universitat berlin, germany']	4	Speaker and Language Identification
saeidi15_interspeech	['∗department of signal processing and acoustics, aalto university, finland', '† forensic laboratory, national bureau of investigation, finland', '‡ faculty of behavioural science, university of helsinki, finland', '⋆speech and image processing unit, school of computing, university of eastern finland']	4	Speaker and Language Identification
rahman15_interspeech	['speech and audio research laboratory', 'queensland university of technology, brisbane, australia']	4	Speaker and Language Identification
xu15_interspeech	['broadband wireless communication and sensor network technology key lab.', 'nanjing university of posts and telecommunications, china', 'institute for infocomm research, a*star, singapore']	4	Speaker and Language Identification
cai15_interspeech	['sysu-cmu joint institute of engineering, sun yat-sen university, china', 'sysu-cmu shunde international joint research institute, china', 'school of information science and technology, sun yat-sen university, china', 'school of information science and technology, xiamen university, china']	4	Speaker and Language Identification
aronowitz15_interspeech	['ibm research - haifa, israel']	4	Speaker and Language Identification
hong15_interspeech	['school of information science and technology, xiamen university, china', 'sysu-cmu joint institute of engineering, sun yat-sen university, china']	4	Speaker and Language Identification
jelil15_interspeech	['department of information technology', 'north-eastern hill university, shillong-793022,', 'department of electronics and electrical engineering', 'indian institute of technology guwahati, guwahati-781039']	4	Speaker and Language Identification
gallardo15b_interspeech	['faculty of estem, university of canberra, australia', 'quality and usability lab, telekom innovation laboratories, tu berlin, germany', 'college of engineering and computer science, australian national university, australia']	4	Speaker and Language Identification
yamamoto15_interspeech	['information and media processing laboratory, nec corporation, japan']	4	Speaker and Language Identification
ribas15_interspeech	['advanced technologies application center (cenatav), habana, cuba', 'inria, villers-les-nancy, f-54600, france']	4	Speaker and Language Identification
huang15b_interspeech	['school of ece, georgia institute of technology, atlanta, ga. usa', 'department of computer engineering, kore university of enna, enna, italy', 'microsoft corporation, one microsoft way, redmond, wa. usa']	8	Speech Recognition – Signal Processing, Acoustic Modeling, Robustness, and Adaptation
huang15c_interspeech	['microsoft corporation, one microsoft way, redmond, wa 98052']	8	Speech Recognition – Signal Processing, Acoustic Modeling, Robustness, and Adaptation
li15_interspeech	['speech and hearing research center,', 'key laboratory of machine perception (ministry of education),', 'peking university, beijing']	8	Speech Recognition – Signal Processing, Acoustic Modeling, Robustness, and Adaptation
kumar15d_interspeech	['microsoft corporation, redmond, wa']	8	Speech Recognition – Signal Processing, Acoustic Modeling, Robustness, and Adaptation
karthickb15_interspeech		8	Speech Recognition – Signal Processing, Acoustic Modeling, Robustness, and Adaptation
miao15b_interspeech	['language technologies institute, school of computer science, carnegie mellon university']	8	Speech Recognition – Signal Processing, Acoustic Modeling, Robustness, and Adaptation
parisotto15_interspeech	['department of computer science, university of toronto', ' toronto rehabilitation institute-uhn;', 'sickkids research institute', ' university of calgary;', 'neurology, hospital for sick children; toronto on canada']	1	Speech Perception, Production, and Acquisition
werff15_interspeech	['reykjavik university', 'menntavegur 1', ' reykjavik, iceland']	1	Speech Perception, Production, and Acquisition
francoisnienaber15_interspeech	['department of computer science, university of toronto, toronto, canada', 'rotman research institute, toronto, canada', 'toronto rehabilitation institute-uhn, toronto, canada']	1	Speech Perception, Production, and Acquisition
yang15c_interspeech	['department of electrical engineering, columbia university, new york, ny, usa.', 'department of neurosurgery, columbia university medical center, new york, ny, usa.', 'department of neurology, columbia university medical center, new york, ny, usa.']	1	Speech Perception, Production, and Acquisition
brumberg15_interspeech	['department of speech-language-hearing, university of kansas, usa', 'department of psychology, university of kansas, usa', 'department of electrical engineering and computer science, university of kansas, usa']	1	Speech Perception, Production, and Acquisition
heger15_interspeech	['cognitive systems lab, institute for anthropomatics and robotics,', 'karlsruhe institute of technology, karlsruhe, germany', 'national center for adaptive neurotechnologies, wadsworth center,', 'new york state department of health, albany, ny, usa', 'department of neurology, albany medical college, albany, usa', 'department of biomedical sciences,', 'state university of new york at albany, albany, ny, usa', '∗these authors contributed equally to this work']	1	Speech Perception, Production, and Acquisition
chen15h_interspeech	['google inc., usa']	4	Speaker and Language Identification
garciaromero15_interspeech	['human language technology center of excellence', 'the johns hopkins university, baltimore, md 21218, usa']	4	Speaker and Language Identification
richardson15_interspeech	['mit lincoln laboratory, lexington, ma usa', 'mit csail, cambridge, ma usa']	4	Speaker and Language Identification
tian15_interspeech	['national laboratory for information science and technology, department of electronic engineering,', 'tsinghua university, beijing 100084, china']	4	Speaker and Language Identification
xing15_interspeech	['center for robust speech systems (crss)', 'university of texas at dallas, richardson, usa']		
zheng15b_interspeech	['national laboratory of pattern recognition, institute of automation,', 'chinese academy of sciences, beijing, p.r.china']	4	Speaker and Language Identification
yoshimura15_interspeech	['department of scientific and engineering simulation,', 'nagoya institute of technology, nagoya, japan']	7	Speech Synthesis and Spoken Language Generation
pouget15_interspeech	['cnrs/gipsa-lab, grenoble, france', 'univ. grenoble alpes/gipsa-lab, grenoble, france', 'universitat hamburg, informatics department, natural language systems, hamburg, germany']	7	Speech Synthesis and Spoken Language Generation
takamichi15_interspeech	['graduate school of information science, nara institute of science and technology (naist), japan', 'language technologies institute, carnegie mellon university (cmu)']	7	Speech Synthesis and Spoken Language Generation
black15b_interspeech	['language technologies institute, carnegie mellon unversity, pittsburgh, pa, usa.']	7	Speech Synthesis and Spoken Language Generation
hong15b_interspeech	['department of electrical and computer engineering and inmc,', 'seoul national university, korea']	7	Speech Synthesis and Spoken Language Generation
tsiaras15_interspeech	['technical university of crete, school of electronic and computer engineering, chania, greece', 'toshiba research europe limited, cambridge research laboratory, cambridge, uk']	7	Speech Synthesis and Spoken Language Generation
looze15_interspeech	['phonetics and speech laboratory, trinity college dublin, ireland', 'dublin institute of technology, ireland', 'center for robust speech systems, university of texas at dallas, usa', 'centre for innovative human systems, school of psychology, trinity college dublin']	10	Speech Recognition – Technologies and Systems for New Applications
lee15d_interspeech	['dmc r&d center, samsung electronics, suwon, south korea']	10	Speech Recognition – Technologies and Systems for New Applications
zainko15_interspeech	['department of telecommunications and media informatics', 'budapest university of technology and economics, hungary']	10	Speech Recognition – Technologies and Systems for New Applications
mandal15_interspeech	['indian institute of information technology and management, gwalior, india']		
feher15_interspeech	['voice inter connect gmbh']	10	Speech Recognition – Technologies and Systems for New Applications
erro15_interspeech	['university of the basque country, bilbao/vitoria, spain', 'ikerbasque, bilbao, spain', 'vicomtech-ik4, san sebastian, spain', 'technical university of catalonia, barcelona, spain', 'nanyang technological university, singapore, singapore', 'university of vigo, vigo, spain', 'technical university of kosice, kosice, slovakia', 'university of science and technology of china, hefei, china']	10	Speech Recognition – Technologies and Systems for New Applications
sahraeian15_interspeech	['esat, ku leuven, belgium', 'hlt, meraka institute, csir, south africa']	8	Speech Recognition – Signal Processing, Acoustic Modeling, Robustness, and Adaptation
golik15b_interspeech	['human language technology and pattern recognition, computer science department,', 'rwth aachen university', ' aachen, germany', 'spoken language processing group, limsi cnrs, paris, france']	8	Speech Recognition – Signal Processing, Acoustic Modeling, Robustness, and Adaptation
wang15d_interspeech	['graduate school of science and engineering, doshisha university, kyoto, japan']	8	Speech Recognition – Signal Processing, Acoustic Modeling, Robustness, and Adaptation
juan15_interspeech	['faculty of computer science and information technology, unimas, malaysia', 'grenoble informatics laboratory (lig), univ. grenoble alpes , grenoble, france']	8	Speech Recognition – Signal Processing, Acoustic Modeling, Robustness, and Adaptation
korenevsky15_interspeech	['itmo university, saint-petersburg, russia', 'speech technology center ltd., saint-petersburg, russia', 'stc-innovations ltd., saint-petersburg, russia']	8	Speech Recognition – Signal Processing, Acoustic Modeling, Robustness, and Adaptation
beck15_interspeech	['human language technology and pattern recognition, computer science department', 'rwth aachen university, ahornstr. 55', ' aachen, germany', 'spoken language processing group, limsi cnrs, paris, france']	8	Speech Recognition – Signal Processing, Acoustic Modeling, Robustness, and Adaptation
itoh15_interspeech	"['ibm research, toyosu', '-8511, japan,', 'graduate school of informatics, shizuoka university', 'abstract1', 'word error rate or character error rate are usually used as the', 'metrics for evaluating the accuracy of speech recognition.', 'these are naturally-defined objective metrics and are helpful', 'for comparing recognition methods fairly. however the overall', 'performance of the recognition systems and the usefulness of', 'the results are not necessarily considered. to address this', 'problem, we study and propose a metric which  replicates', 'human-annotated scores using their perception to the', 'recognition results. the features that we use are the numbers', 'of insertion errors, deletion errors, and substitution errors in', 'the characters and the syllables. in addition we studied the', 'numbers of consecutive errors, the misrecognized keywords,', 'and the locations of errors. we created models using linear', 'regression and random forest, predicted human-perceived', 'scores, and compared them with the actual scores using', ""spearman's"", 'rank-based', 'correlation.', 'according', 'to our', 'experiments the correlation of human perceived scores with', 'character error rates is 0.456, while those with the predicted', 'scores by using a random forest of 10 features is 0.715. the', 'latter is close to the averaged correlation between the scores of', 'the human subjects', '.765, which suggests that we can predict', 'the human-perceived scores using those features and that we', 'can leverage human perception model for evaluating speech', 'recognition performance. the important factors (features) for', 'the prediction are the numbers of substitution errors and', 'consecutive errors.', 'index terms: speech recognition, evaluation, word error  rate,', 'character error rate, human perception', '. introduction', 'evaluation metrics are important for comparing various', 'algorithms for speech recognition and assessing which', 'approach outperforms the others.  the wer (word error', 'rate) has been most often used in  research work on speech', 'recognition [1]. the cer (character error rate) is also', 'popular in research for some languages (such as japanese),', 'where the word units can be ambiguous [2]. in some', 'applications, task-oriented metrics have also been tried. for', 'example levit proposed a metric for end-to-end accuracy', 'evaluation in voice-enabled search tasks [3].', '͊this work was conducted when the author was a member of', 'ibm research - tokyo', 'in addition, speech-enabled dialog systems have been usually', 'evaluated by the concept error rate, task completion ratio, or', 'required time and average number of turns to the completion', '[4][5], because the quality of dialog systems is affected not', 'only by the recognition accuracy but also by interpretation', 'algorithms and strategies of the dialog management. however,', 'in many speech applications such as dictation, voicemail', 'transcription, or message creation, the quality of the output', 'text, (its readability and understandability), is the largest factor', 'for evaluating the speech recognition systems. in this paper we', 'study the human-assessed quality of automatic speech', 'recognition (asr) output to rank the transcriptions in', 'japanese where the orthographic and word units are hard to', 'define.', 'this paper is organized as follows: in section 2 we survey', 'related works. in section 3 the strategy for collecting human', 'perceived scores from human annotators is described. in', 'section 4, we discuss the features to be used for defining our', 'metrics. section 5 presents our experimental results using two', 'frequently used approaches: linear regression and random', 'forest, a well-known non-linear prediction method. in section', ', we discuss the results, followed by some concluding', 'remarks.', '. related works', 'jones [6] studied the readability of asr transcripts, and', 'reported that certain metadata (capitalization, punctuation, and', 'disfluencies (removed or not)) significantly influenced the', 'human-perceived', 'readability.', 'nanjo', '[7]', 'proposed', 'the', 'weighted key word error rate (wker) as a more suitable', 'metric for evaluating asr used in applications. the asr', 'quality problem is similar in difficulty to assessing (or', 'automatically predicting) human reactions to machine', 'translation output . bleu was proposed as a more objective', 'metric for evaluating machine translation [8]. however, the', 'relation between the metrics for speech recognition output and', 'human-perceived quality has not been sufficiently investigated.', 'we are investigating what and how the recognition errors', 'affect human perception of the asr output. our goal is to the', 'predict human perceived quality scores using surface features', 'in the asr output, then to leverage the prediction model for', 'evaluating asr.', 'copyright © 2015 isca', 'september 6-10', ', dresden, germany', 'interspeech 2015', '.21437/interspeech.2015-321']"	8	Speech Recognition – Signal Processing, Acoustic Modeling, Robustness, and Adaptation
jannet15_interspeech	['universite paris-sud', 'lne', 'lpp–cnrs umr 7018, universite sorbonne nouvelle', 'limsi–cnrs upr 3251']	8	Speech Recognition – Signal Processing, Acoustic Modeling, Robustness, and Adaptation
mixdorff15b_interspeech	['beuth university berlin, germany', 'university of bielefeld, citec, germany', 'limsi-cnrs, orsay, france']	3	Analysis of Paralinguistics in Speech and Language
khaki15_interspeech	['department of electrical and electronics engineering, koc university, istanbul, turkey']	3	Analysis of Paralinguistics in Speech and Language
lee15e_interspeech	['department of electrical engineering, national tsing hua university, taiwan', 'signal analysis and interpretation laboratory (sail), los angeles, ca, usa']	3	Analysis of Paralinguistics in Speech and Language
mori15_interspeech	['graduate school of engineering, utsunomiya university, japan']	3	Analysis of Paralinguistics in Speech and Language
mehrabani15_interspeech	['sony computer entertainment america']	3	Analysis of Paralinguistics in Speech and Language
albin15_interspeech	['georgia institute of technology']	3	Analysis of Paralinguistics in Speech and Language
kadiri15_interspeech	['speech and vision laboratory', 'international institute of information technology, hyderabad, india.']	3	Analysis of Paralinguistics in Speech and Language
huang15d_interspeech	['school of electrical engineering and telecommunications, unsw australia', 'atp research laboratory, national ict australia (nicta), australia']	3	Analysis of Paralinguistics in Speech and Language
gu15_interspeech	['nanjing normal university, china', 'the university of tokyo, japan', 'centre national de la recherche scientifique, france']	3	Analysis of Paralinguistics in Speech and Language
gosztolya15_interspeech	['mta-szte research group on artificial intelligence, szeged, hungary']	3	Analysis of Paralinguistics in Speech and Language
chong15_interspeech	['marcs institute, university of western sydney, australia']	3	Analysis of Paralinguistics in Speech and Language
palogiannidi15_interspeech	['school of ece, technical university of crete, chania 73100, crete, greece', '“athena” research and innovation center, maroussi 15125, athens, greece', 'school of ece, national technical university of athens, zografou 15780, athens, greece']		
xu15b_interspeech	['misp group, mmk, technische universitat munchen, germany', 'school of information science and engineering, southeast university, p.r. china', 'department of computing, imperial college london, u.k.', 'chair of complex and intelligent systems, university of passau, germany']	3	Analysis of Paralinguistics in Speech and Language
lee15f_interspeech	['department of electrical and electronic engineering, yonsei university, seoul, korea', 'microsoft research, one microsoft way, redmond, wa 98052, usa']	3	Analysis of Paralinguistics in Speech and Language
kim15c_interspeech	['school of electrical engineering, korea advanced institute of science and technology (kaist)']	3	Analysis of Paralinguistics in Speech and Language
vlasenko15_interspeech	['idiap research institute, martigny, switzerland', 'cognitive systems, iikt, otto von guericke university magdeburg and', 'center for behavioral brain sciences magdeburg']	3	Analysis of Paralinguistics in Speech and Language
arisoy15_interspeech	['mef university, istanbul, turkey', 'bogazici university, istanbul, turkey']	9	Speech Recognition – Architecture, Search, and Linguistic Components
hall15_interspeech	['google, inc.']	9	Speech Recognition – Architecture, Search, and Linguistic Components
marin15_interspeech	['microsoft corporation, bellevue, wa u.s.a.', 'university of washington, seattle, wa u.s.a.']	9	Speech Recognition – Architecture, Search, and Linguistic Components
shazeer15_interspeech	['google, inc.', ' amphitheatre parkway', 'mountain view, ca 94043, usa', 'dept. esat, ku leuven, kasteelpark arenberg 10', 'b-3001 leuven, belgium']	9	Speech Recognition – Architecture, Search, and Linguistic Components
pelemans15_interspeech	['google, inc.', ' amphitheatre parkway', 'mountain view, ca 94043, usa', 'dept. esat, ku leuven, kasteelpark arenberg 10', 'b-3001 leuven, belgium']	9	Speech Recognition – Architecture, Search, and Linguistic Components
chelba15_interspeech	['google', 'amphitheatre parkway,', 'mountain view, ca 94043, usa']	9	Speech Recognition – Architecture, Search, and Linguistic Components
botros15_interspeech	['human language technology and pattern recognition,', 'computer science department, rwth aachen university, aachen, germany', 'spoken language processing group, limsi cnrs, paris, france']	9	Speech Recognition – Architecture, Search, and Linguistic Components
bayer15_interspeech	['signals and interactive systems lab - university of trento, italy']	9	Speech Recognition – Architecture, Search, and Linguistic Components
sun15_interspeech	['school of computer science, carnegie mellon university', 'forbes avenue, pittsburgh, pa 15213-3891, usa']	9	Speech Recognition – Architecture, Search, and Linguistic Components
chong15b_interspeech	['temasek laboratories, nanyang technological university, singapore 639798', 'school of computer engineering, nanyang technological university, singapore 639798', 'institute for infocomm research, singapore 138632']	9	Speech Recognition – Architecture, Search, and Linguistic Components
paulik15_interspeech	['apple inc.', ' infinite loop, cupertino, ca 95014']	8	Speech Recognition – Signal Processing, Acoustic Modeling, Robustness, and Adaptation
sak15_interspeech	['google']	8	Speech Recognition – Signal Processing, Acoustic Modeling, Robustness, and Adaptation
nakkiran15_interspeech	['department of eecs, university of california, berkeley, usa', 'speech group, google inc., mountain view, usa']	8	Speech Recognition – Signal Processing, Acoustic Modeling, Robustness, and Adaptation
sainath15b_interspeech	['google, inc. new york, ny, u.s.a']	8	Speech Recognition – Signal Processing, Acoustic Modeling, Robustness, and Adaptation
berg15_interspeech	['ibm watson', 'ibm t.j. watson research center']	8	Speech Recognition – Signal Processing, Acoustic Modeling, Robustness, and Adaptation
strom15_interspeech	['amazon.com']	8	Speech Recognition – Signal Processing, Acoustic Modeling, Robustness, and Adaptation
kalkur15_interspeech	['indian institute of technology kanpur']	5	Analysis of Speech and Audio Signals
zhang15b_interspeech	"[""school of computer science, northwestern polytechnical university, xi'an, china"", 'institute for infocomm research, a⋆star, singapore', 'school of computer engineering, nanyang technological university, singapore']"	5	Analysis of Speech and Audio Signals
nie15_interspeech	['national laboratory of patten recognition, institute of automation, chinese academy of sciences', 'college of computer science, inner mongolia university', 'electric power research institute of shanxi electric power company, china state grid corp']	5	Analysis of Speech and Audio Signals
xu15c_interspeech	['national engineering laboratory for speech and language information processing,', 'university of science and technology of china, china', 'school of electrical and computer engineering, georgia institute of technology, usa']	5	Analysis of Speech and Audio Signals
kwon15_interspeech	['dept. of electrical and computer engineering and the inmc,', 'seoul national university, seoul, korea', 'school of information and communications,', 'gwangju institute of science and technology, gwangju, korea.']	5	Analysis of Speech and Audio Signals
khan15_interspeech	['school of computing sciences, university of east anglia, norwich, uk', 'department of software engineering, university of science and technology, bannu, pakistan']	5	Analysis of Speech and Audio Signals
hoge15_interspeech	['universitat der bundeswehr munchen, munich, germany']	1	Speech Perception, Production, and Acquisition
yamamoto15b_interspeech	['graduate school of systems engineering, wakayama university,', 'cnbh, department of physiology, development, and neuroscience, university of cambridge']	1	Speech Perception, Production, and Acquisition
rasilo15_interspeech	['aalto university, dept. signal processing and acoustics, otakaari 5 a', ' espoo, finland', 'vrije universiteit brussel, artificial intelligence laboratory, pleinlaan 2', ' elsene, belgium']	1	Speech Perception, Production, and Acquisition
lin15b_interspeech	['college of communication engineering, jilin university, changchun 130025, p r. china', 'department of computer science, university of sheffield, sheffield s1 4dp, uk']	1	Speech Perception, Production, and Acquisition
cao15_interspeech	['laboratory of phonetics and speech science, institute of linguistics,', 'chinese academy of social sciences, beijing, china', 'neurophonetics group, department of phoniatrics, pedaudiology, and communication disorders,', 'medical school, rwth aachen university, aachen, germany']	1	Speech Perception, Production, and Acquisition
bosch15_interspeech	['radboud university nijmegen', 'univ. of alberta, edmonton, canada', 'max planck institute for psycholinguistics']	1	Speech Perception, Production, and Acquisition
chen15i_interspeech	['national engineering laboratory for speech and language information processing,', 'university of science and technology of china, hefei, china', 'human language technology department, institute for infocomm research, a⋆star, singapore']	7	Speech Synthesis and Spoken Language Generation
ribeiro15b_interspeech	['centre for speech technology research, university of edinburgh, uk', 'national institute of informatics, tokyo, japan']	7	Speech Synthesis and Spoken Language Generation
moungsri15_interspeech	['interdisciplinary graduate school of science and engineering, tokyo institute of technology, japan']	7	Speech Synthesis and Spoken Language Generation
langarani15_interspeech	['center for spoken language understanding, oregon health & science university,', 'portland, or, usa']	7	Speech Synthesis and Spoken Language Generation
gerazov15_interspeech	['faculty of electrical engineering and information technologies,', 'university of ss. cyril and methodius in skopje, macedonia', 'idiap research institute, martigny, switzerland']	7	Speech Synthesis and Spoken Language Generation
fernandez15_interspeech	['tj watson research center, yorktown heights, ny – usa', 'ibm haifa reseach lab, haifa – israel']	7	Speech Synthesis and Spoken Language Generation
liao15_interspeech	['google inc.']	11	Spoken Language Processing – Dialogue, Summarization, Understanding
bone15_interspeech	['signal analysis and interpretation laboratory (sail), usc, los angeles, ca, usa', 'information sciences institute, usc, marina del rey, ca, usa', 'department of communication sciences and disorders, emerson college, boston, ma, usa', 'university of massachusetts medical school shriver center, worcester, ma, usa']	11	Spoken Language Processing – Dialogue, Summarization, Understanding
fringi15_interspeech	['school of electronic electrical and systems engineering,', 'university of birmingham, birmingham b15 2tt, uk', 'disney research pittsburgh', ' forbes avenue lower level, pittsburgh, pa 15213, usa']	11	Spoken Language Processing – Dialogue, Summarization, Understanding
pucher15_interspeech	['telecommunications research center vienna (ftw), austria', 'the centre for speech technology research (cstr), university of edinburgh, uk', 'national institute of informatics, japan', 'university of applied sciences, wiener neustadt, austria', 'federal institute for the blind, vienna, austria']	11	Spoken Language Processing – Dialogue, Summarization, Understanding
shahnawazuddin15_interspeech	['department of electronics and electrical engineering', 'indian institute of technology guwahati, guwahati, india.']	11	Spoken Language Processing – Dialogue, Summarization, Understanding
giuliani15_interspeech	['hlt research unit, fondazione bruno kessler (fbk), trento, italy', 'school of mathematics, statistics, and computer science, university of tehran, iran']	11	Spoken Language Processing – Dialogue, Summarization, Understanding
govender15_interspeech	['human language technology research group, csir, meraka institute, pretoria, south africa', 'university of kwa-zulu natal, durban, south africa']	11	Spoken Language Processing – Dialogue, Summarization, Understanding
kim15d_interspeech	['human media interaction, university of twente, enschede, the netherlands']	11	Spoken Language Processing – Dialogue, Summarization, Understanding
sadeghian15_interspeech	['department of electrical and computer engineering, watson school,', 'binghamton university, new york, usa']	11	Spoken Language Processing – Dialogue, Summarization, Understanding
proenca15_interspeech	['instituto de telecomunicacões, portugal', 'department of electrical and computer engineering, university of coimbra, portugal', 'microsoft language development centre, lisbon, portugal', 'polytechnic institute of leiria, leiria, portugal']	11	Spoken Language Processing – Dialogue, Summarization, Understanding
sundar15_interspeech		11	Spoken Language Processing – Dialogue, Summarization, Understanding
guo15_interspeech	['dept. of electrical engineering, university of california, los angeles, ca 90095, usa', 'dept. of speech and hearing sciences, indiana university, bloomington', 'data analytics lab, xerox research center-india (xrci), bangalore, karnataka, india']	11	Spoken Language Processing – Dialogue, Summarization, Understanding
leemann15_interspeech	['department of theoretical and applied linguistics, university of cambridge, united kingdom', 'phonogrammarchiv, universitat zurich, switzerland']	2	Phonetics, Phonology, and Prosody
fuchs15_interspeech	['englisches seminar, westfalische wilhelms-universitat munster, germany']	2	Phonetics, Phonology, and Prosody
li15b_interspeech	['research center for language information technologies, nanjing normal university, china']	2	Phonetics, Phonology, and Prosody
leykum15_interspeech	['acoustics research institute, austrian academy of sciences, austria', 'institute for corpus linguistics and text technology, austrian academy of sciences, austria']	2	Phonetics, Phonology, and Prosody
gibson15_interspeech		2	Phonetics, Phonology, and Prosody
arai15b_interspeech	['department of information and communication sciences', 'sophia university, tokyo, japan']	2	Phonetics, Phonology, and Prosody
dutta15_interspeech	['department of computational linguistics, the efl university, hyderabad, india']	2	Phonetics, Phonology, and Prosody
kraus15_interspeech	['department of english linguistics, department of phonetics and speech processing', 'ludwig-maximilian-university, munich']	2	Phonetics, Phonology, and Prosody
kolly15_interspeech	['limsi-cnrs orsay / department of comparative linguistics, university of zurich', 'department of theoretical and applied linguistics, university of cambridge', 'department of general linguistics, university of bern']	2	Phonetics, Phonology, and Prosody
jani15_interspeech	['faculty of information technology and bionics, pazmany peter catholic university, hungary', 'center for language and speech technology, radboud university nijmegen, the netherlands', 'department of linguistics, radboud university nijmegen, the netherlands']	2	Phonetics, Phonology, and Prosody
zimmerer15_interspeech	['phonetics, saarland university, saarbrucken (germany)']	2	Phonetics, Phonology, and Prosody
bruni15_interspeech	['institute for natural language processing, university of stuttgart']	2	Phonetics, Phonology, and Prosody
prathosh15_interspeech	['xerox research center india, banglore, india.', 'department of electrical engineering, indian institute of science, banglore, india.', 'voice and speech systems, banglore, india.']		
barlaz15_interspeech	['department of linguistics,2department of electrical and computer engineering,', 'department of bioengineering', 'beckman institute, university of illinois at urbana-champaign']		
michon15_interspeech	"['bogazici university, turkey', 'ecole polytechnique, france', 'laboratoire de sciences cognitives et psycholinguistique, (ens, ehess, cnrs)', ""departement d'etudes cognitives, ecole normale superieure, psl research university, france""]"	2	Phonetics, Phonology, and Prosody
howson15_interspeech	['the university of toronto, canada']	2	Phonetics, Phonology, and Prosody
yuan15_interspeech	['linguistic data consortium, university of pennsylvania']	2	Phonetics, Phonology, and Prosody
pouplier15_interspeech	[', alexei kochetov', 'institute of phonetics and speech processing, lmu munich, germany', 'department of linguistics, university of toronto, canada']	2	Phonetics, Phonology, and Prosody
wong15c_interspeech	['department of electronic engineering', 'the chinese university of hong kong', 'hong kong sar, china']	6	Speech Coding and Enhancement
vaz15_interspeech	['signal analysis and interpretation lab', 'university of southern california, los angeles, ca 90089']	6	Speech Coding and Enhancement
elshamy15_interspeech	['institute for communications technology, technische universitat braunschweig', 'schleinitzstr. 22, d–38106 braunschweig, germany', 'nxp software', 'interleuvenlaan 80, b–3001 leuven, belgium']	6	Speech Coding and Enhancement
zhang15c_interspeech	['department of computer science & engineering and center for cognitive & brain sciences,', 'the ohio state university, columbus, oh, usa']	6	Speech Coding and Enhancement
nrholm15_interspeech	['audio analysis lab, ad:mt, aalborg university, denmark', 'speech signal processing group and 3acoustics group,', 'cluster of excellence ”hearing4all”,', 'dept. medical physics and acoustics, university of oldenburg, germany']	6	Speech Coding and Enhancement
nrholm15b_interspeech	['audio analysis lab, ad:mt, aalborg university']	6	Speech Coding and Enhancement
kinoshita15_interspeech	['ntt communication science labs, ntt corporation']	6	Speech Coding and Enhancement
masaya15_interspeech	['japan advanced institute of science and technology', 'inpex']	6	Speech Coding and Enhancement
kang15_interspeech	['dept. of electrical and electronic engineering, yonsei university, seoul, korea', 'samsung electronics, suwon, korea']	6	Speech Coding and Enhancement
lee15g_interspeech	['department of electrical and computer engineering and inmc', 'seoul national university, seoul, korea', 'school of information and communications,', 'gwangju institute of science and technology, gwangju, korea']	6	Speech Coding and Enhancement
he15b_interspeech	['speech and audio signal processing laboratory, school of electronic information and control', 'engineering, beijing university of technology, beijing, china']	6	Speech Coding and Enhancement
chinaev15_interspeech	['department of communications engineering, university of paderborn', ' paderborn, germany']	6	Speech Coding and Enhancement
hao15_interspeech	['speech and audio signal processing laboratory, school of electronic information and control', 'engineering, beijing university of technology, beijing, china']	6	Speech Coding and Enhancement
mayer15_interspeech	['signal processing and speech communication lab', 'graz university of technology, austria']	6	Speech Coding and Enhancement
zhao15_interspeech	['department of computer science, university of missouri, columbia, missouri 65211, usa', 'pearson knowledge technologies, menlo park, ca 94025, usa']	8	Speech Recognition – Signal Processing, Acoustic Modeling, Robustness, and Adaptation
weber15_interspeech	['school of eese, university of birmingham, edgbaston, birmingham b15 2tt, uk']	8	Speech Recognition – Signal Processing, Acoustic Modeling, Robustness, and Adaptation
ganapathy15_interspeech	['ibm t.j. watson research center, yorktown heights, ny, usa.']	8	Speech Recognition – Signal Processing, Acoustic Modeling, Robustness, and Adaptation
travadi15_interspeech	['signal analysis and interpretation lab,', 'university of southern california, los angeles - 90089']	8	Speech Recognition – Signal Processing, Acoustic Modeling, Robustness, and Adaptation
pesan15_interspeech	['johns hopkins university, baltimore, md, usa']	8	Speech Recognition – Signal Processing, Acoustic Modeling, Robustness, and Adaptation
nagamine15_interspeech	['department of electrical engeering, columbia university, new york, usa', 'microsoft research, redmond, usa']	8	Speech Recognition – Signal Processing, Acoustic Modeling, Robustness, and Adaptation
loukina15_interspeech	['educational testing service, usa']	2	Phonetics, Phonology, and Prosody
zimmerer15b_interspeech	['phonetics, saarland university, saarbrucken, germany']	2	Phonetics, Phonology, and Prosody
bonneau15_interspeech	['loria/cnrs vandoeuvre-les-nancy, france', 'loria/udl vandoeuvre-les-nancy, france']	2	Phonetics, Phonology, and Prosody
best15_interspeech	['university of western sydney, australia', 'griffith university, australia', 'university college london, uk', 'university of york, uk', 'university of canterbury, nz']	2	Phonetics, Phonology, and Prosody
bundgaardnielsen15_interspeech	['marcs institute/university of western sydney', 'la trobe university', 'university of melbourne']	2	Phonetics, Phonology, and Prosody
hirst15_interspeech	['aix-marseille university, lpl umr 7309', ', aix-en-provence, france', 'school of foreign languages, shanghai jiao tong university, china', 'institute of acoustics and speech communication, tu dresden, germany']	2	Phonetics, Phonology, and Prosody
gibson15b_interspeech	['signal analysis and interpretation lab, university of southern california, los angeles, ca, usa', 'department of psychiatry and behavioral sciences, university of washington, seattle, wa, usa', 'sail.usc.edu,']	3	Analysis of Paralinguistics in Speech and Language
malandrakis15_interspeech	['signal analysis and interpretation laboratory (sail), usc, los angeles, ca 90089, usa']	3	Analysis of Paralinguistics in Speech and Language
xia15_interspeech	['university of southern california, los angeles, ca, usa', 'the university of utah, department of psychology, ut, usa']	3	Analysis of Paralinguistics in Speech and Language
gupta15_interspeech	['signal analysis and interpretation lab, university of southern california, los angeles, usa', 'department of psychiatry and behavioral sciences, university of washington, seattle, usa']	3	Analysis of Paralinguistics in Speech and Language
bonin15_interspeech	['school of computer science and statistics', 'trinity college dublin, ireland']	3	Analysis of Paralinguistics in Speech and Language
schrank15_interspeech	['signal processing and speech communication laboratory', 'graz university of technology, graz, austria']	3	Analysis of Paralinguistics in Speech and Language
ringeval15_interspeech	['machine intelligence & signal processing group, mmk, technische universitat munchen, germany', 'department of psychology, webster vienna private university, austria', 'swiss center for affective sciences, university of geneva, switzerland', 'chair of complex and intelligent systems, universitat passau, germany', 'department of computing, imperial college london, u.k.']	5	Analysis of Speech and Audio Signals
nandwana15_interspeech	['center for robust speech systems (crss)', 'erik jonsson school of engineering and computer science', 'university of texas at dallas, richardson, texas, usa']	5	Analysis of Speech and Audio Signals
dumpala15_interspeech	['international institute of information technology, hyderabad, india']	5	Analysis of Speech and Audio Signals
gergen15_interspeech	['institute of communication acoustics', 'ruhr-universitat bochum, germany']	5	Analysis of Speech and Audio Signals
dennis15_interspeech	['institute for infocomm research, a*star', ' fusionopolis way, singapore 138632']	5	Analysis of Speech and Audio Signals
choi15_interspeech	['school of electrical engineering, korea university, seoul, korea', 'office of naval research, arlington, va, usa']	5	Analysis of Speech and Audio Signals
hwang15_interspeech	['department of electronic and computer engineering', 'hanyang university, seoul, korea.']	5	Analysis of Speech and Audio Signals
wang15e_interspeech	['university of science and technology of china, p r. china', 'georgia institute of technology, usa']	5	Analysis of Speech and Audio Signals
zhan15_interspeech	['key laboratory of speech acoustics and content understanding, chinese academy of sciences']	5	Analysis of Speech and Audio Signals
ghaemmaghami15_interspeech	['speech and audio research laboratory, science and engineering faculty,', 'queensland university of technology, brisbane, australia']	5	Analysis of Speech and Audio Signals
sriskandaraja15_interspeech	['school of electrical engineering and telecommunications, unsw, australia', 'atp research laboratory, national ict australia (nicta), australia']	5	Analysis of Speech and Audio Signals
tao15_interspeech	['multimodal signal processing (msp) laboratory - center for robust speech systems (crss)', 'department of electrical engineering, the university of texas at dallas, richardson tx 75080, usa']	5	Analysis of Speech and Audio Signals
raboshchuk15_interspeech	['talp research center, department of signal theory and communications,', 'universitat politecnica de catalunya, barcelona, spain', 'school of electronic, electrical & systems engineering,', 'university of birmingham, birmingham, uk', 'hospital sant joan de deu barcelona, esplugues de llobregat, barcelona, spain']	5	Analysis of Speech and Audio Signals
dai15_interspeech		5	Analysis of Speech and Audio Signals
liu15d_interspeech	['amazon, usa']	5	Analysis of Speech and Audio Signals
liu15e_interspeech	['sysu-cmu joint institute of engineering, sun yat-sen university', 'sysu-cmu joint research institute, sun yat-sen university', 'department of electrical and computer engineering, carnegie mellon university', 'language technologies institute, carnegie mellon university']	5	Analysis of Speech and Audio Signals
espi15_interspeech	['ntt communication science laboratories, ntt corporation, japan']	5	Analysis of Speech and Audio Signals
transfeld15_interspeech	['institute for communications technology, technische universitat braunschweig, germany']	5	Analysis of Speech and Audio Signals
bouchekif15_interspeech	"['orange labs', ' avenue pierre marzin 22300, lannion, france.', ""laboratoire d'informatique de l'universite du maine, lium - france.""]"	5	Analysis of Speech and Audio Signals
kraljevski15_interspeech	['voice inter connect gmbh, dresden, germany', 'department of electronic systems, aalborg university, aalborg, denmark', 'casl research centre, queen margaret university, edinburgh, united kingdom']	5	Analysis of Speech and Audio Signals
lehner15_interspeech	['department of computational perception', 'johannes kepler university of linz, austria']	5	Analysis of Speech and Audio Signals
su15_interspeech	['department of engineering, university of cambridge, cambridge, uk']	11	Spoken Language Processing – Dialogue, Summarization, Understanding
griol15_interspeech	['dept. of computer science, carlos iii university of madrid, spain', 'dept. of languages and computer systems, university of granada, spain']		
griol15b_interspeech	['dept. of computer science, carlos iii university of madrid, spain', 'dept. of languages and computer systems, university of granada, spain']	11	Spoken Language Processing – Dialogue, Summarization, Understanding
khan15b_interspeech	['microsoft corporation, redmond wa 98052, usa']	11	Spoken Language Processing – Dialogue, Summarization, Understanding
wu15c_interspeech	['department of electronic engineering, tsinghua university, beijing, china', 'school of electrical and computer engineering, georgia institute of technology, atlanta, ga. usa']	11	Spoken Language Processing – Dialogue, Summarization, Understanding
zukerman15_interspeech	['clayton school of information technology, monash university', 'clayton, victoria 3800, australia']	11	Spoken Language Processing – Dialogue, Summarization, Understanding
wu15e_interspeech	['university of edinburgh, united kingdom', 'university of eastern finland, finland', 'eurecom, france']	4	Speaker and Language Identification
sanchez15_interspeech	['aholab signal processing laboratory, university of the basque country upv/ehu, spain', 'ikerbasque, basque foundation for science, bilbao, spain']	4	Speaker and Language Identification
wester15b_interspeech	['the centre for speech technology research, the university of edinburgh, uk', 'national institute of informatics, japan']	4	Speaker and Language Identification
xiao15_interspeech	['temasek laboratories, nanyang technological university (ntu), singapore', 'school of computer engineering, ntu,singapore', 'joint ntu-ubc research center of excellence in active living for the elderly, ntu, singapore', 'human language technology department, institute for infocomm research, singapore', 'school of ee & telecom, university of new south wales, australia']	4	Speaker and Language Identification
hanilci15_interspeech	['school of computing, university of eastern finland, finland', 'department of electrical and electronic engineering, bursa technical university, turkey']	4	Speaker and Language Identification
patel15_interspeech	['dhirubhai ambani institute of information and communication technology (da-iict),', 'gandhinagar-382007, gujarat, india']	4	Speaker and Language Identification
villalba15_interspeech	['vivolab, aragon institute for engineering research (i3a),', 'university of zaragoza, spain']	4	Speaker and Language Identification
alam15b_interspeech	['crim, montreal, quebec, canada']	4	Speaker and Language Identification
janicki15_interspeech	['institute of telecommunications, warsaw university of technology, warsaw, poland']		
liu15f_interspeech	['tsinghua national laboratory for information science and technology,', 'department of electronic engineering, tsinghua university, beijing 100084, china', 'speech and signal processing lab, department of electrical and computer engineering,', 'marquette university, milwaukee, wi 53233, usa']	4	Speaker and Language Identification
sahidullah15_interspeech	['school of computing, university of eastern finland, finland']	4	Speaker and Language Identification
wang15f_interspeech	['nagaoka university of technology, japan', 'toyohashi university of technology, japan']	4	Speaker and Language Identification
chen15j_interspeech		4	Speaker and Language Identification
lee15h_interspeech	['dmc r&d center, samsung electronics, suwon, korea']	9	Speech Recognition – Architecture, Search, and Linguistic Components
oualil15_interspeech	['spoken language systems group (lsv), saarland university, saarbrucken, germany', 'german aerospace center (dlr), institute of flight guidance, braunschweig, germany']	9	Speech Recognition – Architecture, Search, and Linguistic Components
allauzen15_interspeech	['google, inc']	9	Speech Recognition – Architecture, Search, and Linguistic Components
xu15d_interspeech	['center for language and speech processing', 'human language technology center of excellence', 'the johns hopkins university, baltimore, md 21218, usa']	9	Speech Recognition – Architecture, Search, and Linguistic Components
lecouteux15_interspeech	['getalp - laboratory of informatics of grenoble (lig) - univ. grenoble alpes']	9	Speech Recognition – Architecture, Search, and Linguistic Components
gysel15_interspeech	['university of amsterdam, amsterdam, the netherlands', 'google, inc., new york, ny usa', 'google, inc., mountain view, ca usa']	9	Speech Recognition – Architecture, Search, and Linguistic Components
xu15e_interspeech	['temasek laboratories, nanyang technological university, singapore', 'computer engineering school, nanyang technological university, singapore']	9	Speech Recognition – Architecture, Search, and Linguistic Components
ratajczak15_interspeech	['graz university of technology, signal processing and speech communication laboratory', 'eth zurich, learning & adaptive systems group']	9	Speech Recognition – Architecture, Search, and Linguistic Components
jalalvand15_interspeech	['fbk - fondazione bruno kessler, via sommarive 18', ' trento, italy', 'ict doctoral school, university of trento, italy']	9	Speech Recognition – Architecture, Search, and Linguistic Components
parida15_interspeech	['electrical engineering, indian institute of technology (iit), kharagpur-721302, india', 'electrical engineering, indian institute of science (iisc), bangalore-560012, india']	1	Speech Perception, Production, and Acquisition
canevari15_interspeech	['robotics, brain and cognitive sciences department, istituto italiano di tecnologia, genova, italy']	1	Speech Perception, Production, and Acquisition
csapo15b_interspeech	['department of telecommunications and media informatics,', 'budapest university of technology and economics, budapest, hungary', 'department of speech and hearing sciences, indiana university, bloomington, in, usa']	1	Speech Perception, Production, and Acquisition
bandini15_interspeech	['dinfo-universita degli studi di firenze, firenze, italy', 'dei-universita di bologna, bologna, italy', 'universite de lorraine, loria, umr 7503, villers-les-nancy, f-54600, france', 'istc-cnr, uos padova, italy']	1	Speech Perception, Production, and Acquisition
chi15_interspeech	['tianjin key laboratory of cognitive computation and application, tianjin university, tianjin,', 'china', 'school of information science, jaist, ishikawa, japan']		
drioli15_interspeech	['department of mathematics and computer science', 'university of udine', 'via delle scienze 206,', 'udine, italy']	1	Speech Perception, Production, and Acquisition
kolb15_interspeech	['marquette university electrical and computer engineering, milwaukee, wi, usa', 'marquette university speech pathology and audiology, milwaukee, wi, usa']	1	Speech Perception, Production, and Acquisition
andrademiranda15_interspeech	['centro de tecnologia biomedica, universidad politecnica de madrid.', 'univ. grenoble alpes / cnrs, gipsa-lab, grenoble, france']	1	Speech Perception, Production, and Acquisition
kochetov15_interspeech	['university of toronto, canada']	1	Speech Perception, Production, and Acquisition
zhu15_interspeech	"[""school of software and microelectronics, northwestern polytechnical university, xi'an, china"", ""school of computer science, northwestern polytechnical university, xi'an, china""]"	1	Speech Perception, Production, and Acquisition
ruiz15_interspeech	['fondazione bruno kessler, trento, italy', 'microsoft research, redmond, wa, usa']	12	Spoken Language Processing – Translation, Information Retrieval, and Resources
bechet15_interspeech	['aix marseille universite, cnrs-lif']	12	Spoken Language Processing – Translation, Information Retrieval, and Resources
ng15_interspeech	['department of computer science, university of sheffield, united kingdom']	12	Spoken Language Processing – Translation, Information Retrieval, and Resources
pelemans15b_interspeech	['esat, ku leuven, belgium', 'centre for computational linguistics, ku leuven, belgium', 'elis, ghent university, belgium']	12	Spoken Language Processing – Translation, Information Retrieval, and Resources
mieno15_interspeech	['graduate school of information science, nara institute of science and technology, japan']	12	Spoken Language Processing – Translation, Information Retrieval, and Resources
junczysdowmunt15_interspeech	['samsung poland r&d center, warsaw, poland', 'dmc r&d center, samsung electronics, suwon, south korea']	12	Spoken Language Processing – Translation, Information Retrieval, and Resources
kenny15_interspeech	['crim, canada', 'voicetrust, canada']	4	Speaker and Language Identification
correia15_interspeech	['l2f - spoken language systems lab, inesc-id lisboa', 'ist - instituto superior tecnico, university of lisbon', 'fondazione bruno kessler, cit, trento']	4	Speaker and Language Identification
li15c_interspeech	['dept. of electronic and information engineering', 'the hong kong polytechnic university, hong kong sar']	4	Speaker and Language Identification
rahman15b_interspeech	['speech and audio research laboratory', 'queensland university of technology, brisbane, australia']	4	Speaker and Language Identification
glembek15_interspeech	['phonexia s.r.o., brno, czech republic']	4	Speaker and Language Identification
kanagasundaram15_interspeech	['speech and audio research laboratory', 'queensland university of technology, brisbane, australia']	4	Speaker and Language Identification
gobl15_interspeech	['phonetics and speech laboratory, trinity college dublin, ireland']	2	Phonetics, Phonology, and Prosody
airaksinen15_interspeech	['department of signal processing and acoustics, aalto university, finland', 'international audio laboratories erlangen, friedrich-alexander university (fau), germany']	2	Phonetics, Phonology, and Prosody
narendra15_interspeech	['school of information technology, indian institute of technology kharagpur,', 'kharagpur - 721302, west bengal, india.']	2	Phonetics, Phonology, and Prosody
bundgaardnielsen15b_interspeech	['marcs institute, university of western sydney, australia', 'la trobe university, australia', 'melbourne university, australia']	2	Phonetics, Phonology, and Prosody
kreiman15_interspeech		2	Phonetics, Phonology, and Prosody
jiao15_interspeech	['school of foreign languages, tongji university, shanghai, china', 'department of speech, hearing and phonetic sciences, university college london, london, uk']	2	Phonetics, Phonology, and Prosody
morioka15_interspeech	['department of computer science, waseda university, tokyo, japan', 'ntt communication science laboratories, ntt corporation, kyoto, japan']	9	Speech Recognition – Architecture, Search, and Linguistic Components
irie15_interspeech	['human language technology and pattern recognition,', 'computer science department, rwth aachen university, aachen, germany', 'spoken language processing group, limsi cnrs, paris, france']	9	Speech Recognition – Architecture, Search, and Linguistic Components
emami15_interspeech	['ibm t.j. watson research center', 'kitchawan rd, yorktown heights, ny 10598']	9	Speech Recognition – Architecture, Search, and Linguistic Components
masumura15b_interspeech	['† ntt media intelligence laboratories, ntt corporation, japan', '‡ graduate school of engineering, tohoku university, japan']	9	Speech Recognition – Architecture, Search, and Linguistic Components
chunwijitra15_interspeech	['nectec, national science and technology development agency (nstda),', 'pahonyothin road, pathumthani', ', thailand']		
gangireddy15_interspeech	['centre for speech technology research, university of edinburgh, uk', 'department of computer science, nagoya institute of technology, nagoya, japan']	9	Speech Recognition – Architecture, Search, and Linguistic Components
anderson15_interspeech	['university of british columbia', 'max planck institute for psycholinguistics', 'university of saskatchewan']	1	Speech Perception, Production, and Acquisition
mcloughlin15_interspeech	['the university of kent, school of computer science, rochester, kent, uk', 'the university of science and technology of china, hefei, anhui, china']	1	Speech Perception, Production, and Acquisition
bocquelet15_interspeech	['inserm, clinatec, u1167, grenoble france', 'univ. grenoble alpes, clinatec, u1167, grenoble, france', 'cea, leti, clinatec, grenoble, france', 'cnrs/univ. grenoble alpes, gipsa-lab, grenoble, france']	1	Speech Perception, Production, and Acquisition
fabre15_interspeech	['univ. grenoble alpes, gipsa-lab, f38000 grenoble, france', 'cnrs, gipsa-lab, f38000 grenoble, france', 'inserm / cea, leti, clinatec, grenoble, france']	1	Speech Perception, Production, and Acquisition
wang15g_interspeech	['speech disorders & technology lab, department of bioengineering', 'callier center for communication disorders', 'university of texas at dallas, richardson, texas, united states', 'university of texas southwestern medical center, dallas, texas, united states']	1	Speech Perception, Production, and Acquisition
diener15_interspeech	['cognitive systems lab, karlsruhe institute of technology (kit)', 'karlsruhe, germany']	1	Speech Perception, Production, and Acquisition
mirbagheri15_interspeech	['institute for learning and brain sciences', 'department of speech & hearing sciences', 'department of electrical engineering', 'university of washington', 'seattle, wa, usa']	1	Speech Perception, Production, and Acquisition
mirsamadi15_interspeech	['center for robust speech systems (crss)', 'the university of texas at dallas, richardson, tx 75080-3021, u.s.a.']	8	Speech Recognition – Signal Processing, Acoustic Modeling, Robustness, and Adaptation
mimura15_interspeech	['kyoto university, academic center for computing and media studies,', 'sakyo-ku, kyoto 606-8501, japan']	8	Speech Recognition – Signal Processing, Acoustic Modeling, Robustness, and Adaptation
peddinti15_interspeech	['center for language and speech processing &', 'human language technology center of excellence', 'the johns hopkins university, baltimore, md 21218, usa']	8	Speech Recognition – Signal Processing, Acoustic Modeling, Robustness, and Adaptation
kumar15e_interspeech	['microsoft corporation, redmond, wa']	8	Speech Recognition – Signal Processing, Acoustic Modeling, Robustness, and Adaptation
mitra15_interspeech	['dimitra', 'vergyri, horacio franco', 'speech technology and research laboratory, sri international, menlo park, ca, usa.']	8	Speech Recognition – Signal Processing, Acoustic Modeling, Robustness, and Adaptation
karafiat15_interspeech		8	Speech Recognition – Signal Processing, Acoustic Modeling, Robustness, and Adaptation
harvilla15_interspeech	['department of electrical and computer engineering', 'carnegie mellon university, pittsburgh, pa 15213 usa']	8	Speech Recognition – Signal Processing, Acoustic Modeling, Robustness, and Adaptation
huang15e_interspeech	['school of information science and technology, beijing forestry university, beijing, china', 'institute of automation, chinese academy of sciences, beijing, china', 'institute for integrated and intelligent systems, griffith university, brisbane, australia']	8	Speech Recognition – Signal Processing, Acoustic Modeling, Robustness, and Adaptation
wang15h_interspeech	['the ohio state university, columbus, oh', 'google inc., mountain view, ca']	8	Speech Recognition – Signal Processing, Acoustic Modeling, Robustness, and Adaptation
su15b_interspeech	['key laboratory of human-machine intelligence-synergy systems,', 'shenzhen institutes of advanced technology, chinese academy of sciences', 'cambridge university engineering dept, trumpington st., cambridge, cb2 1pz u.k.', 'the chinese university of hong kong, hong kong, china']	8	Speech Recognition – Signal Processing, Acoustic Modeling, Robustness, and Adaptation
baby15_interspeech	['department esat, ku leuven, belgium']	8	Speech Recognition – Signal Processing, Acoustic Modeling, Robustness, and Adaptation
han15_interspeech	['department of computer science and engineering12345', '& center for cognitive and brain sciences45', 'the ohio state university, columbus, oh, usa']	8	Speech Recognition – Signal Processing, Acoustic Modeling, Robustness, and Adaptation
xiao15b_interspeech	['sail, dept. electrical engineering, university of southern california, u.s.a.', 'dept. educational psychology, university of utah, u.s.a.', 'dept. psychiatry & behavioral sciences, university of washington, u.s.a.', 'http://sail.usc.edu']	3	Analysis of Paralinguistics in Speech and Language
ando15_interspeech	['ntt media intelligence laboratories, ntt corporation, japan']		
nasir15_interspeech	['signal analysis & interpretation laboratory, univ. of southern california, los angeles, ca, usa', 'dept. of psychology, university of utah, salt lake city, ut, usa.']	3	Analysis of Paralinguistics in Speech and Language
gosztolya15b_interspeech	['mta-szte research group on artificial intelligence, szeged, hungary']	3	Analysis of Paralinguistics in Speech and Language
kaushik15_interspeech	['center for robust speech systems (crss), eric jonsson school of engineering,', 'the university of texas at dallas (utd), richardson, texas, u.s.a.']	3	Analysis of Paralinguistics in Speech and Language
pappu15_interspeech	['yahoo! labs']	3	Analysis of Paralinguistics in Speech and Language
azais15_interspeech	['department of computing, imperial college, london, uk', 'audeering ug (limited), gilching, germany']	3	Analysis of Paralinguistics in Speech and Language
sergienko15_interspeech	['institute of communications engineering, ulm university, ulm, germany']	3	Analysis of Paralinguistics in Speech and Language
hsiao15_interspeech	['department of electrical engineering, national tsing hua university, taiwan', 'national academy for educational research, taiwan']		
tsai15b_interspeech	['eecs department, university of california berkeley, berkeley, ca usa', 'international computer science institute, berkeley, ca usa']	3	Analysis of Paralinguistics in Speech and Language
akira15_interspeech		3	Analysis of Paralinguistics in Speech and Language
koster15_interspeech	['quality and usability lab, telekom innovation labs', 'technische universitat berlin, germany']	6	Speech Coding and Enhancement
berger15_interspeech	['swissqual ag, zuchwil, switzerland']	6	Speech Coding and Enhancement
gaich15_interspeech	['signal processing and speech communication lab', 'graz university of technology, graz, austria']	6	Speech Coding and Enhancement
marxer15_interspeech	['department of computer science, university of sheffield, sheffield s1 4dp, uk', 'ikerbasque, spain']	6	Speech Coding and Enhancement
andersen15_interspeech	['dept. of electronic systems, aalborg university', ' aalborg oest, denmark', 'oticon a/s', ' smoerum, denmark']	6	Speech Coding and Enhancement
tang15_interspeech	['acoustic research centre, university of salford, uk', 'ikerbasque (basque science foundation), bilbao, spain', 'language and speech laboratory, universidad del pais vasco, vitoria, spain']	6	Speech Coding and Enhancement
chen15k_interspeech	['deptpartment of electrical & electronic engineering, south university of science and technology', 'of china, china']	6	Speech Coding and Enhancement
li15d_interspeech	['georgia institute of technology, atlanta, ga 30332-0250, usa', 'university of science and technology of china, hefei, anhui, p r. china']	6	Speech Coding and Enhancement
pulakka15_interspeech	['microsoft phone technologies, tampere, finland', 'nokia research center, tampere, finland', 'department of signal processing and acoustics, aalto university, espoo, finland']	6	Speech Coding and Enhancement
turan15_interspeech	['multimedia, vision and graphics laboratory,', 'college of engineering, koc university, istanbul, turkey']	6	Speech Coding and Enhancement
wang15i_interspeech	['school of information and electronics, beijing institute of technology, beijing 100081, china', 'school of computer science, carnegie mellon university', 'sysu-cmu joint inst. of eng., sun yat-sen university', 'department of ece, carnegie mellon university', 'sysu-cmu shunde international joint research institute']		
liu15g_interspeech	['national laboratory of pattern recognition, institute of automation, chinese academy of sciences,', 'beijing 100190；']	6	Speech Coding and Enhancement
dalen15_interspeech	['department of engineering, university of cambridge, united kingdom']	8	Speech Recognition – Signal Processing, Acoustic Modeling, Robustness, and Adaptation
manohar15_interspeech	['∗center for language and speech processing', '† human language technology center of excellence', 'the johns hopkins university, baltimore, md 21218, usa']	8	Speech Recognition – Signal Processing, Acoustic Modeling, Robustness, and Adaptation
zhang15d_interspeech	['national engineering laboratory for speech and language information processing', 'university of science and technology of china, hefei, anhui, p r. china', 'department of electrical engineering and computer science', 'york university', ' keele street, toronto, ontario, m3j 1p3, canada']	8	Speech Recognition – Signal Processing, Acoustic Modeling, Robustness, and Adaptation
he15c_interspeech	['department of computer science and engineering', 'the ohio state university, columbus, oh, usa']	8	Speech Recognition – Signal Processing, Acoustic Modeling, Robustness, and Adaptation
chen15l_interspeech	['department of computer science and engineering', 'the hong kong university of science and technology']	8	Speech Recognition – Signal Processing, Acoustic Modeling, Robustness, and Adaptation
gelly15_interspeech	['∗limsi - cnrs, spoken language processing group, orsay, france', '†paris-sud university, orsay, france']	8	Speech Recognition – Signal Processing, Acoustic Modeling, Robustness, and Adaptation
quatieri15_interspeech		3	Analysis of Paralinguistics in Speech and Language
zhang15e_interspeech	['center for robust speech systems (crss)', 'erik jonsson school of engineering and computer science', 'university of texas at dallas, richardson, texas, usa.']	3	Analysis of Paralinguistics in Speech and Language
toth15_interspeech	['mta-szte research group on artificial intelligence, szeged, hungary', 'university of szeged, department of linguistics, szeged, hungary', 'research institute for linguistics, hungarian academy of sciences, budapest, hungary', 'university of szeged, department of psychiatry, szeged, hungary']	3	Analysis of Paralinguistics in Speech and Language
sidorov15_interspeech	['ulm university, ulm germany', 'siberian state aerospace university, krasnoyarsk russia']	3	Analysis of Paralinguistics in Speech and Language
ferrer15_interspeech	['center of study on electronics & information technology. central university of las villas. cuba', 'centre for application of advanced technologies, cenatav, cuba.', 'department of electrical and computer engineering, university of new brunswick, canada']	3	Analysis of Paralinguistics in Speech and Language
kaushik15b_interspeech	['center for robust speech systems (crss), eric jonsson school of engineering,', 'the university of texas at dallas (utd), richardson, texas, u.s.a.']	3	Analysis of Paralinguistics in Speech and Language
pasupat15_interspeech	['stanford university, palo alto, ca, united states', 'microsoft research, mountain view, ca, united states']	11	Spoken Language Processing – Dialogue, Summarization, Understanding
nguyen15_interspeech	['graduate school of information science, nara institute of science and technology']	11	Spoken Language Processing – Dialogue, Summarization, Understanding
bokaei15_interspeech	['department of computer engineering, sharif university of technology, tehran, iran', 'department of computer science, the university of texas at dallas, u.s.a']	11	Spoken Language Processing – Dialogue, Summarization, Understanding
liu15h_interspeech		11	Spoken Language Processing – Dialogue, Summarization, Understanding
mokaram15_interspeech	['spandh, department of computer science, university of sheffield, s1 4dp, united kingdom']	11	Spoken Language Processing – Dialogue, Summarization, Understanding
sousa15_interspeech	['university of minnesota, usa', 'technical university of darmstadt, germany', 'university of applied sciences darmstadt, germany', 'german institute for educational research (dipf), germany']	11	Spoken Language Processing – Dialogue, Summarization, Understanding
huang15f_interspeech	['human language technology department, institute for infocomm research/a*star', '#21-01 connexis (south tower), singapore 138632']	7	Speech Synthesis and Spoken Language Generation
aihara15_interspeech	['graduate school of system informatics, kobe university', '-1, rokkodai, nada, kobe, japan']	7	Speech Synthesis and Spoken Language Generation
kobayashi15b_interspeech	['graduate school of information science, nara institute of science and technology (naist), japan']	7	Speech Synthesis and Spoken Language Generation
tian15b_interspeech	['school of computer engineering, nanyang technological university (ntu),singapore', 'joint ntu-ubc research center of excellence in active living for the elderly, ntu, singapore', 'center for speech technology research, university of edinburgh, united kingdom', 'human language technology department, institute for infocomm research, singapore']	7	Speech Synthesis and Spoken Language Generation
alonso15_interspeech	['aholab, university of the basque country (upv/ehu), bilbao, spain', 'basque foundation for science (ikerbasque), bilbao, spain']	7	Speech Synthesis and Spoken Language Generation
tajiri15_interspeech	['graduate school of information science, nara institute of science and technology, japan']	7	Speech Synthesis and Spoken Language Generation
jyothi15_interspeech	['beckman institute, university of illinois at urbana-champaign, usa', 'department of ece, university of illinois at urbana-champaign, usa']	12	Spoken Language Processing – Translation, Information Retrieval, and Resources
chowdhury15b_interspeech	['dept. of information engineering & computer science, univ. of trento, trento, italy', 'dept. de sistemes informatics i computacio, univ. politecnica de valencia, valencia, spain']	12	Spoken Language Processing – Translation, Information Retrieval, and Resources
rothwell15_interspeech	['michael', 'kennewick, bob kennewick', 'voicebox technologies, bellevue, wa, usa']	12	Spoken Language Processing – Translation, Information Retrieval, and Resources
rothwell15b_interspeech	['voicebox technologies, bellevue, wa, usa']	12	Spoken Language Processing – Translation, Information Retrieval, and Resources
polzehl15b_interspeech	['quality and usability lab, telekom innovation laboratories, technische universitat', 'berlin']	12	Spoken Language Processing – Translation, Information Retrieval, and Resources
naderi15_interspeech	['quality and usability labs, telekom innovation laboratories, tu-berlin']	12	Spoken Language Processing – Translation, Information Retrieval, and Resources
leemann15b_interspeech	"['department of theoretical and applied linguistics, university of cambridge', ""laboratoire d'informatique pour la mecanique et les sciences de l'ingenieur, limsi-cnrs orsay"", ""laboratoire d'analyse et technologie du langage, universite de geneve"", 'department of comparative linguistics, universitat zurich', 'seminar for statistics, eth zurich', 'ibros.ch']"		
loukina15b_interspeech	['educational testing service, usa']	12	Spoken Language Processing – Translation, Information Retrieval, and Resources
kacorri15_interspeech	['the graduate center, city university of new york, ny – usa', 'ibm research - tokyo, ibm japan, tokyo – japan']	12	Spoken Language Processing – Translation, Information Retrieval, and Resources
burgos15_interspeech	['center for language studies, radboud university nijmegen, the netherlands', 'center for language and speech technology, radboud university nijmegen, the netherlands']	12	Spoken Language Processing – Translation, Information Retrieval, and Resources
wray15_interspeech	['qatar computing research institute', 'hamad bin khalifa university', 'doha, qatar']	12	Spoken Language Processing – Translation, Information Retrieval, and Resources
gaur15_interspeech	['language technologies institute, carnegie mellon university', 'human computer interaction institute, carnegie mellon university']	12	Spoken Language Processing – Translation, Information Retrieval, and Resources
byun15_interspeech	['new york university', 'montclair state university']	12	Spoken Language Processing – Translation, Information Retrieval, and Resources
wang15j_interspeech	['department of computer science and engineering, the ohio state university, usa', 'center for cognitive and brain sciences, the ohio state university, usa']	8	Speech Recognition – Signal Processing, Acoustic Modeling, Robustness, and Adaptation
rath15_interspeech	['human language technology department', 'institute for infocomm research (i2r), singapore']	8	Speech Recognition – Signal Processing, Acoustic Modeling, Robustness, and Adaptation
abe15_interspeech	['department of computer science and engineering, toyohashi university of technology, japan']	8	Speech Recognition – Signal Processing, Acoustic Modeling, Robustness, and Adaptation
yu15_interspeech	['the university of texas at dallas, richardson, tx, u.s.a.', 'ntt communication science laboratories, ntt corporation']	8	Speech Recognition – Signal Processing, Acoustic Modeling, Robustness, and Adaptation
borsky15_interspeech	['faculty of electrical engineering,', 'czech technical university in prague,', 'czech republic.']	8	Speech Recognition – Signal Processing, Acoustic Modeling, Robustness, and Adaptation
lu15d_interspeech	['centre for speech technology research, university of edinburgh, edinburgh, uk']	8	Speech Recognition – Signal Processing, Acoustic Modeling, Robustness, and Adaptation
cardinal15_interspeech	['mit computer science and artificial intelligence laboratory,', 'cambridge, massachusetts 02139, usa', 'ecole de technologie superieure,', 'montreal, canada']	8	Speech Recognition – Signal Processing, Acoustic Modeling, Robustness, and Adaptation
karanasou15_interspeech	['department of engineering, university of cambridge', 'trumpington street, cambridge cb2 1pz, uk']	8	Speech Recognition – Signal Processing, Acoustic Modeling, Robustness, and Adaptation
garimella15_interspeech	['amazon.com, india', 'amazon.com, usa']	8	Speech Recognition – Signal Processing, Acoustic Modeling, Robustness, and Adaptation
tomashenko15_interspeech	['speech technology center, saint-petersburg, russia', 'itmo university, saint-petersburg, russia', 'stc-innovations ltd, saint-petersburg, russia']	8	Speech Recognition – Signal Processing, Acoustic Modeling, Robustness, and Adaptation
hsiao15b_interspeech	['raytheon bbn technologies', 'moulton street, cambridge, ma 02138, usa']	8	Speech Recognition – Signal Processing, Acoustic Modeling, Robustness, and Adaptation
li15e_interspeech	['school of informatics, kyoto university, sakyo-ku, kyoto 606-8501, japan', 'national institute of information and communications technology, kyoto, japan']	8	Speech Recognition – Signal Processing, Acoustic Modeling, Robustness, and Adaptation
doulaty15_interspeech	['speech and hearing group, university of sheffield, sheffield, uk']	8	Speech Recognition – Signal Processing, Acoustic Modeling, Robustness, and Adaptation
lustyk15_interspeech	['czech technical university in prague, faculty of electrical engineering,', 'department of circuit theory,', 'technicka 2', ' 27, prague, czech republic', 'lehrstuhl fur mustererkennung, universitat erlangen-nurnberg,', 'martensstrasse 3', ' erlangen, germany']	1	Speech Perception, Production, and Acquisition
alnasheri15_interspeech	['digital speech processing group, department of computer engineering, college of computer and', 'information sciences', 'king saud university, riyadh 11543, saudi arabia', 'centre for intelligent signal and imaging research (cisir), department of electrical and', 'electronic engineering', 'universiti tekhnologi petronas, tronoh 31750, perak, malaysia']	1	Speech Perception, Production, and Acquisition
wu15f_interspeech	"['key laboratory of human-machine intelligence-synergy systems, shenzhen institutes of', 'advanced technology, chinese academy of sciences/the chinese university of hong kong,', 'shenzhen, china', ""department of otorhinolaryngology head and neck surgery, chinese people's liberation army"", 'general hospital, beijing 100853, china', 'changchun university of science and technology, changchun, china', 'speech science laboratory, university of hong kong, china']"	1	Speech Perception, Production, and Acquisition
kasisopa15_interspeech	['marcs institute, university of western sydney, australia', 'department of electrical and computer engineering, faculty of engineering, thammasat', 'university, thailand']	1	Speech Perception, Production, and Acquisition
rong15_interspeech	['mgh institute of health professions, boston, usa', 'department of speech-language pathology, university of toronro, toronto, canada']	1	Speech Perception, Production, and Acquisition
a15_interspeech	['research institute of national rehabilitation center for persons with disabilities, saitama, japan']	1	Speech Perception, Production, and Acquisition
bigi15_interspeech	['laboratoire parole et langage, aix-marseille universite, cnrs', ', avenue pasteur 13100 aix-en-provence, france', 'institute of linguistics, adam mickiewicz university, poznan']	1	Speech Perception, Production, and Acquisition
meyer15_interspeech	['medizinische physik and cluster of excellence hearing4all, universitat oldenburg, germany']	1	Speech Perception, Production, and Acquisition
knoll15_interspeech	['applied psychology research group, the university of the west of scotland, scotland, uk']	1	Speech Perception, Production, and Acquisition
yeung15_interspeech	['human-computer communications laboratory,', 'department of systems engineering and engineering management', 'stanley ho big data decision analytics research centre', 'the chinese university of hong kong, hong kong sar, china']	1	Speech Perception, Production, and Acquisition
wodarczak15_interspeech	['∗department of linguistics, stockholm university', '† speech, music and hearing, kth royal institute of technology', 'stockholm, sweden']	2	Phonetics, Phonology, and Prosody
reichel15b_interspeech	['institute of phonetics and speech processing, university of munich', 'department of linguistics, university of illinois']	2	Phonetics, Phonology, and Prosody
cervone15_interspeech	['school of informatics, university of edinburgh, edinburgh eh8 9ab, uk', 'google inc.', ' zurich, switzerland']	2	Phonetics, Phonology, and Prosody
rosenberg15_interspeech	['queens college (cuny)', 'ibm tj watson research center, yorktown heights, ny – usa']	2	Phonetics, Phonology, and Prosody
looze15b_interspeech	['phonetics and speech laboratory, trinity college dublin, ireland']	2	Phonetics, Phonology, and Prosody
freeman15_interspeech	['department of linguistics', 'department of electrical engineering', 'university of washington', 'seattle, wa usa']	2	Phonetics, Phonology, and Prosody
choi15b_interspeech	['hanyang phonetics and psycholinguistics laboratory, hanyang university, korea', 'max planck institute for psycholinguistics, the netherlands', 'centre for language studies, radboud university nijmegen, the netherlands', 'marcs institute, university of western sydney, australia']	1	Speech Perception, Production, and Acquisition
grohe15_interspeech	['english linguistics, university of tubingen, germany', 'english linguistics, university of munster, germany', 'german linguistics, university of freiburg, germany']	1	Speech Perception, Production, and Acquisition
ordin15_interspeech	['universitat bielefeld, fakultat der sprach- und literaturwissenschaft, germany']	1	Speech Perception, Production, and Acquisition
scharenborg15_interspeech	['centre for language studies, radboud university nijmegen, the netherlands', 'donders institute for brain, cognition and behaviour, radboud university nijmegen, the netherlands']	1	Speech Perception, Production, and Acquisition
chen15m_interspeech	['key laboratory of human-machine intelligence-synergy systems, shenzhen institutes of', 'advanced technology, chinese academy of sciences, shenzhen, china', 'department of linguistics and modern languages, and joint research centre for language &', 'human complexity, the chinese university of hong kong, hong kong sar']	1	Speech Perception, Production, and Acquisition
ooigawa15_interspeech	['phonetics laboratory, sophia university, tokyo, japan']	2	Phonetics, Phonology, and Prosody
saon15_interspeech	['ibm t j. watson research center, yorktown heights, ny']	10	Speech Recognition – Technologies and Systems for New Applications
liu15i_interspeech	['university of cambridge engineering dept,', 'trumpington st., cambridge, cb2 1pz, u.k.']	10	Speech Recognition – Technologies and Systems for New Applications
thomas15_interspeech	['ibm t.j. watson research center, yorktown heights, usa.']	10	Speech Recognition – Technologies and Systems for New Applications
shaik15_interspeech	['human language technology and pattern recognition – computer science department', 'rwth aachen university', ' aachen, germany', 'spoken language processing group, limsi cnrs, paris, france']	10	Speech Recognition – Technologies and Systems for New Applications
fragasilva15_interspeech	['vocapia research', ' rue jean rostand', ' orsay, france', 'cnrs/limsi, spoken language processing group', ' orsay cedex, france']	10	Speech Recognition – Technologies and Systems for New Applications
jyothi15b_interspeech	['beckman institute, university of illinois at urbana-champaign, usa', 'department of ece, university of illinois at urbana-champaign, usa']	10	Speech Recognition – Technologies and Systems for New Applications
versteegh15_interspeech	['ecole normale superieure / psl research university / ehess / cnrs, france', 'telefonica research, barcelona, spain', 'hltcoe and clsp, johns hopkins university, usa', 'sierra project-team ecole normale superieure / inria / cnrs, france']	5	Analysis of Speech and Audio Signals
badino15_interspeech	['rbcs, istituto italiano di tecnologia, italy', 'dibris, universita degli studi di genova, italy', 'lcsl, istituto italiano di tecnologia and massachusetts institute of technology, usa']	5	Analysis of Speech and Audio Signals
thiolliere15_interspeech	['ecole normale superieure / psl research university / ehess / cnrs, france']	5	Analysis of Speech and Audio Signals
agenbag15_interspeech	['department of electrical and electronic engineering, stellenbosch university, south africa']	5	Analysis of Speech and Audio Signals
chen15n_interspeech	"['shaanxi provincial key laboratory of speech and image information processing,', ""school of computer science, northwestern polytechnical university, xi'an, china"", 'institute for infocomm research, a⋆star, singapore']"	5	Analysis of Speech and Audio Signals
baljekar15_interspeech	['carnegie mellon university, usa']	5	Analysis of Speech and Audio Signals
renshaw15_interspeech	['∗,†,§ilcc and †cstr, school of informatics, university of edinburgh, uk', '‡hltcoe and clsp, johns hopkins university, usa']	5	Analysis of Speech and Audio Signals
rasanen15_interspeech	['aalto university, department of signal processing and acoustics, finland', 'stanford university, language & cognition lab, california']	5	Analysis of Speech and Audio Signals
lyzinski15_interspeech	['human language technology center of excellence & center for language and speech processing', 'the johns hopkins university, baltimore, md usa']	5	Analysis of Speech and Audio Signals
peddinti15b_interspeech	['center for language and speech processing &', 'human language technology center of excellence', 'johns hopkins university, baltimore, md 21218, usa']	8	Speech Recognition – Signal Processing, Acoustic Modeling, Robustness, and Adaptation
li15f_interspeech	['speech and hearing research center,', 'key laboratory of machine perception (ministry of education),', 'peking university, beijing']	8	Speech Recognition – Signal Processing, Acoustic Modeling, Robustness, and Adaptation
zhang15f_interspeech	['cambridge university engineering dept., trumpington st., cambridge, cb2 1pz u.k.']	8	Speech Recognition – Signal Processing, Acoustic Modeling, Robustness, and Adaptation
zhang15g_interspeech	['center for brains, minds and machines, massachusetts institute of technology, usa', 'lcsl, massachusetts institute of technology and istituto italiano di tecnologia', 'dibris, universita degli studi di genova, italy']	8	Speech Recognition – Signal Processing, Acoustic Modeling, Robustness, and Adaptation
sivadas15_interspeech	['human language technology department, institute for infocomm research (i2r), singapore.', 'mcgill university, montreal, canada.']	8	Speech Recognition – Signal Processing, Acoustic Modeling, Robustness, and Adaptation
su15c_interspeech	['international computer science institute, berkeley, california, us', 'dept. of electrical engineering & computer science, university of california, berkeley, ca, usa', 'nanyang technological university, singapore']	8	Speech Recognition – Signal Processing, Acoustic Modeling, Robustness, and Adaptation
cui15_interspeech	['ibm t j. watson research center, yorktown heights, ny, usa']	8	Speech Recognition – Signal Processing, Acoustic Modeling, Robustness, and Adaptation
lu15e_interspeech	['centre for speech technology research, university of edinburgh, edinburgh, uk', 'institute for language, cognition and computation, university of edinburgh, edinburgh, uk', 'montreal institute for learning algorithms, university of montreal, montreal, canada']	8	Speech Recognition – Signal Processing, Acoustic Modeling, Robustness, and Adaptation
zhu15b_interspeech	['international center for advanced communication technologies - interact,', 'institute of anthropomatics and robotics', 'karlsruhe institute of technology (kit), germany']	8	Speech Recognition – Signal Processing, Acoustic Modeling, Robustness, and Adaptation
bi15_interspeech	['key lab. of shanghai education commission for intelligent interaction and cognitive engineering', 'speechlab, department of computer science and engineering', 'shanghai jiao tong university, shanghai, china']	8	Speech Recognition – Signal Processing, Acoustic Modeling, Robustness, and Adaptation
chan15_interspeech	['carnegie mellon university', 'electrical and computer engineering', ' language technologies institute', '∗equal contribution']	8	Speech Recognition – Signal Processing, Acoustic Modeling, Robustness, and Adaptation
liu15j_interspeech	['microsoft search technology center asia, beijing, china', 'microsoft corporation, one microsoft way, redmond, wa 98052']	8	Speech Recognition – Signal Processing, Acoustic Modeling, Robustness, and Adaptation
chen15o_interspeech	['mitsubishi electric research laboratories (merl)', ' broadway, cambridge ma', ', usa', 'columbia university, new york, ny, usa', 'sabanci university, orhanli tuzla', ', istanbul, turkey']	8	Speech Recognition – Signal Processing, Acoustic Modeling, Robustness, and Adaptation
liu15k_interspeech	['department of computer science and engineering, the ohio state university, usa', 'center for cognitive and brain sciences, the ohio state university, usa']	5	Analysis of Speech and Audio Signals
p15_interspeech	['ittiam systems, banglore, india.', 'xerox research center india, banglore, india.', 'department of electrical engineering, indian institute of science, banglore, india.']	5	Analysis of Speech and Audio Signals
prasad15b_interspeech	['speech and vision laboratory,', 'international institute of information technology, hyderabad, india']	5	Analysis of Speech and Audio Signals
huang15g_interspeech	['key laboratory of speech acoustics and content understanding, chinese academy of sciences']	5	Analysis of Speech and Audio Signals
salvati15_interspeech	['department of mathematics and computer science, university of udine']	5	Analysis of Speech and Audio Signals
ma15d_interspeech	['department of computer science, university of sheffield, sheffield s1 4dp, uk', 'hearing systems group, technical university of denmark, dk - 2800 kgs. lyngby, denmark']	5	Analysis of Speech and Audio Signals
nie15b_interspeech	['national laboratory of patten recognition, institute of automation, chinese academy of sciences', 'college of computer science, inner mongolia university', 'electric power research institute of shanxi electric power company, china state grid corp']	5	Analysis of Speech and Audio Signals
gong15_interspeech	['ircam - umr stms ircam-cnrs-upmc', 'inria, mutant team-project', 'paris, france']	5	Analysis of Speech and Audio Signals
lee15i_interspeech	['kwangwoon university, seoul, rep. of korea']		
yen15_interspeech	['department of electrical and computer engineering', 'national chiao tung universty, hsinchu, taiwan 300, r.o.c']	5	Analysis of Speech and Audio Signals
lim15_interspeech	['school of electrical engineering', 'korea advanced institute of science and technology (kaist), daejeon, republic of korea']	5	Analysis of Speech and Audio Signals
tiainen15_interspeech	['institute of behavioural sciences, university of helsinki']	1	Speech Perception, Production, and Acquisition
hecht15_interspeech	['the hebrew university of jerusalem, israel', 'advance technical center israel, general motors, israel', 'microsoft research, israel']	1	Speech Perception, Production, and Acquisition
andrei15_interspeech	['speech and dialogue research laboratory, university “politehnica” of bucharest, romania']	1	Speech Perception, Production, and Acquisition
chen15p_interspeech	['dept. of electrical & electronic engineering, south univ. of science and technology of china', 'division of speech and hearing sciences, the university of hong kong']	1	Speech Perception, Production, and Acquisition
ishida15_interspeech	['sophia university, japan,', 'research fellow of the japan society for the promotion of science']	1	Speech Perception, Production, and Acquisition
bhat15_interspeech	['tcs innovation labs, mumbai']	1	Speech Perception, Production, and Acquisition
oreilly15b_interspeech	['sigmedia, department of electrical & electronic engineering, trinity college dublin, ireland', 'trinity centre for biodiversity research & department of zoology, trinity college dublin, ireland']	5	Analysis of Speech and Audio Signals
choi15c_interspeech	['department of electrical and computer engineering and inmc,', 'seoul national university, republic of korea']	5	Analysis of Speech and Audio Signals
ming15_interspeech	"[""school of computer science, northwestern polytechnical university, xi'an, china"", 'institute for infocomm research, a⋆star, singapore']"	5	Analysis of Speech and Audio Signals
xiao15c_interspeech	['temasek laboratories, nanyang technological university (ntu), singapore', 'advanced digital sciences center, singapore', 'school of computer engineering, ntu,singapore', 'human language technology department, institute for infocomm research, singapore', 'school of ee & telecom, university of new south wales, australia']	5	Analysis of Speech and Audio Signals
pang15_interspeech	['key laboratory of machine perception (ministry of education),', 'engineering lab on intelligent perception for internet of things (elip),', 'shenzhen graduate school, peking university, china']	5	Analysis of Speech and Audio Signals
phan15_interspeech	['⋆institute for signal processing, university of lubeck, germany', '†graduate school for computing in medicine and life sciences, university of lubeck, germany']	5	Analysis of Speech and Audio Signals
ferrer15b_interspeech	['departamento de computacion, fcen, universidad de buenos aires and conicet, argentina', 'speech technology and research laboratory, sri international, california, usa']	4	Speaker and Language Identification
ajili15_interspeech	"[""university of avignon, laboratoire informatique d'avignon (lia), france"", 'university of grenoble, laboratoire informatique de grenoble (lig), france', ""laboratoire national de metrologie et d'essais (lne), france"", 'afeka tel-aviv college of engineering, afeka center for language processing (aclp), israel']"	4	Speaker and Language Identification
dean15_interspeech		4	Speaker and Language Identification
aronowitz15b_interspeech	['ibm research - haifa, israel']	4	Speaker and Language Identification
misra15_interspeech	['center for robust speech systems (crss)', 'erik jonsson school of engineering & computer science', 'the university of texas at dallas (utd), richardson, tx 75080-3021, usa']	4	Speaker and Language Identification
carne15_interspeech	['college of asia and the pacific, the australian national university']	4	Speaker and Language Identification
wester15c_interspeech	['the centre for speech technology research, university of edinburgh, united kingdom']	7	Speech Synthesis and Spoken Language Generation
chevelu15_interspeech	['irisa - university of rennes 1, lannion, france', 'saarland university, saarbrucken, germany']	7	Speech Synthesis and Spoken Language Generation
latacz15_interspeech	['vrije universiteit brussel, dep. of electronics and informatics, pleinlaan 2', ' brussel, belgium', 'iminds, multimedia technologies dep., gaston crommenlaan 8 bus 102', ' gent, belgium']	7	Speech Synthesis and Spoken Language Generation
nose15_interspeech	['graduate school of engineering, tohoku university', 'interdisciplinary graduate school of science and engineering, tokyo institute of technology', 'national institute of information and communications technology']	7	Speech Synthesis and Spoken Language Generation
koriyama15_interspeech	['interdisciplinary graduate school of science and engineering, tokyo institute of technology']	7	Speech Synthesis and Spoken Language Generation
ullmann15_interspeech	['idiap research institute, switzerland', 'ecole polytechnique federale de lausanne (epfl), switzerland']	7	Speech Synthesis and Spoken Language Generation
fohr15_interspeech	['multispeech team', 'universite de lorraine, loria, umr 7503, vandoeuvre-les-nancy, f-54506, france', 'inria, villers-les-nancy, f-54600, france', 'cnrs, loria, umr 7503, vandoeuvre-les-nancy, f-54506, france']	9	Speech Recognition – Architecture, Search, and Linguistic Components
chen15q_interspeech	['university of cambridge engineering department, cambridge, u.k.', 'department of computer science & engineering, shanghai jiao tong university, china']	9	Speech Recognition – Architecture, Search, and Linguistic Components
jin15_interspeech	['key lab of shanghai education commission for intelligent interaction and cognitive engineering', 'speechlab, department of computer science and engineering', 'shanghai jiao tong university, shanghai, china']	9	Speech Recognition – Architecture, Search, and Linguistic Components
yeh15_interspeech	['graduate institute of communication engineering, national taiwan university']	9	Speech Recognition – Architecture, Search, and Linguistic Components
li15g_interspeech	['school of informatics, kyoto university', 'sakyo-ku, kyoto 606-8501, japan']	9	Speech Recognition – Architecture, Search, and Linguistic Components
das15_interspeech	['department of electrical and computer engineering', 'university of illinois at urbana-champaign', 'illinois, il 61801, usa']	9	Speech Recognition – Architecture, Search, and Linguistic Components
ribas15b_interspeech	['advanced technologies application center (cenatav), habana, cuba', 'inria, villers-les-nancy, f-54600, france']	8	Speech Recognition – Signal Processing, Acoustic Modeling, Robustness, and Adaptation
tachioka15_interspeech	['information technology r&d center, mitsubishi electric corporation', 'mitsubishi electric research laboratories']	8	Speech Recognition – Signal Processing, Acoustic Modeling, Robustness, and Adaptation
saeidi15b_interspeech	['department of signal processing and acoustics, aalto university, espoo, finland']	8	Speech Recognition – Signal Processing, Acoustic Modeling, Robustness, and Adaptation
mallidi15_interspeech	['center for language and speech processing, johns hopkins university, baltimore, u.s.a', 'human language technology center of excellence, johns hopkins university, baltimore, u', '.', 's', '.', 'a', 'waseda university, department of computer science and engineering, tokyo, japan']	8	Speech Recognition – Signal Processing, Acoustic Modeling, Robustness, and Adaptation
huemmer15_interspeech	['multimedia communications and signal processing,', 'university of erlangen-nuremberg, erlangen, germany', 'spoken language systems laboratory, inesc-id-lisboa, lisboa, portugal']	8	Speech Recognition – Signal Processing, Acoustic Modeling, Robustness, and Adaptation
abdelaziz15_interspeech	['cognitive signal processing group, institute of communication acoustics,', 'ruhr-universitat bochum, germany', 'mitsubishi electric research laboratories, cambridge, ma, usa', 'inria, villers-les-nancy, france']	8	Speech Recognition – Signal Processing, Acoustic Modeling, Robustness, and Adaptation
kuhne15_interspeech	['voicebox technologies europe bv, munich, germany']	8	Speech Recognition – Signal Processing, Acoustic Modeling, Robustness, and Adaptation
narayanan15_interspeech	['google inc.']	8	Speech Recognition – Signal Processing, Acoustic Modeling, Robustness, and Adaptation
astudillo15b_interspeech	['inesc-id / instituto superior tecnico, universidade de lisboa, portugal']	8	Speech Recognition – Signal Processing, Acoustic Modeling, Robustness, and Adaptation
zhang15h_interspeech	['cambridge university engineering dept., trumpington st., cambridge, cb2 1pz u.k.']	8	Speech Recognition – Signal Processing, Acoustic Modeling, Robustness, and Adaptation
ko15_interspeech	"[""huawei noah's ark research lab, hong kong, china"", 'center for language and speech processing &', 'human language technology center of excellence,', 'johns hopkins university, baltimore, md', ', usa']"	8	Speech Recognition – Signal Processing, Acoustic Modeling, Robustness, and Adaptation
zhang15i_interspeech	['center for language and speech processing', 'human language technology center of excellence', 'the johns hopkins university, baltimore, md 21218, usa']	8	Speech Recognition – Signal Processing, Acoustic Modeling, Robustness, and Adaptation
kurata15_interspeech	['ibm research', 'nuance communications']	8	Speech Recognition – Signal Processing, Acoustic Modeling, Robustness, and Adaptation
chen15r_interspeech	['university of science and technology of china, hefei, china', 'microsoft research asia, beijing, china']	8	Speech Recognition – Signal Processing, Acoustic Modeling, Robustness, and Adaptation
swietojanski15_interspeech	['the centre for speech technology research, university of edinburgh, united kingdom']	8	Speech Recognition – Signal Processing, Acoustic Modeling, Robustness, and Adaptation
bell15b_interspeech	['centre for speech technology research, university of edinburgh, edinburgh eh8 9ab, uk']	8	Speech Recognition – Signal Processing, Acoustic Modeling, Robustness, and Adaptation
li15h_interspeech	['interactive digital media technology research center,', 'institute of automation, chinese academy of sciences, beijing, p.r.china']	8	Speech Recognition – Signal Processing, Acoustic Modeling, Robustness, and Adaptation
chen15s_interspeech	['national laboratory of pattern recognition, institute of automation, chinese academy of sciences,', 'beijing 100190, china', 'electric power research institute of shanxi electric power company, china state grid corp']	8	Speech Recognition – Signal Processing, Acoustic Modeling, Robustness, and Adaptation
huang15h_interspeech	['school of ece, georgia institute of technology, atlanta, ga. usa', 'microsoft corporation, one microsoft way, redmond, wa. usa', 'department of telematics, kore university of enna, enna, italy', 'department of electronic engineering, tsinghua university, beijing, china']	8	Speech Recognition – Signal Processing, Acoustic Modeling, Robustness, and Adaptation
parthasarathi15_interspeech	['amazon.com, usa.', 'amazon.com, india.']	8	Speech Recognition – Signal Processing, Acoustic Modeling, Robustness, and Adaptation
li15i_interspeech	['speech and hearing research center,', 'key laboratory of machine perception (ministry of education),', 'peking university, beijing']	8	Speech Recognition – Signal Processing, Acoustic Modeling, Robustness, and Adaptation
doulaty15b_interspeech	['speech and hearing group, university of sheffield, sheffield, uk']	8	Speech Recognition – Signal Processing, Acoustic Modeling, Robustness, and Adaptation
asami15_interspeech	['ntt media intelligence laboratories, ntt corporation, japan']	8	Speech Recognition – Signal Processing, Acoustic Modeling, Robustness, and Adaptation
cho15_interspeech	['institute for anthropomatics and robotics', 'karlsruhe institute of technology, germany']	12	Spoken Language Processing – Translation, Information Retrieval, and Resources
lau15_interspeech	['school of electrical and computer engineering, georgia institute of technology']	12	Spoken Language Processing – Translation, Information Retrieval, and Resources
wang15k_interspeech	['cambridge university engineering department', 'trumpington street, cambridge, cb2 1pz, uk']	12	Spoken Language Processing – Translation, Information Retrieval, and Resources
do15_interspeech	['graduate school of information science', 'nara institute of science and technology, japan']	12	Spoken Language Processing – Translation, Information Retrieval, and Resources
ngo15_interspeech	['national university of singapore, singapore', 'institute for infocomm research, singapore']	12	Spoken Language Processing – Translation, Information Retrieval, and Resources
oouchi15_interspeech	['iwate prefectural university, japan', 'tsukuba university, japan', 'national institute of advanced industrial science and technology, japan']	12	Spoken Language Processing – Translation, Information Retrieval, and Resources
saxena15_interspeech	['speech and vision lab, international institute of information technology, hyderabad, india']	12	Spoken Language Processing – Translation, Information Retrieval, and Resources
lee15j_interspeech	['national institute of advanced industrial science and technology, japan', 'tsukuba university, japan', 'iwate prefectural university, japan']	12	Spoken Language Processing – Translation, Information Retrieval, and Resources
ram15_interspeech	['idiap research institute, martigny, switzerland', 'ecole polytechnique federale de lausanne (epfl), switzerland']	12	Spoken Language Processing – Translation, Information Retrieval, and Resources
nwe15_interspeech	['institute for infocomm research, singapore']	3	Analysis of Paralinguistics in Speech and Language
trouvain15_interspeech	['saarland university, computational linguistics and phonetics, germany', 'university of twente, human media interaction group, the netherlands', 'vu university amsterdam, human movement sciences, the netherlands']	3	Analysis of Paralinguistics in Speech and Language
truong15_interspeech	['university of twente, human media interaction group, the netherlands', 'vu university amsterdam, human movement sciences, the netherlands', 'radboud university, behavioural science institute, the netherlands']	3	Analysis of Paralinguistics in Speech and Language
paul15_interspeech	['golisano college of computing & information science', 'college of liberal arts', 'rochester institute of technology']	3	Analysis of Paralinguistics in Speech and Language
tsiartas15_interspeech	['sri international, menlo park, ca, usa']		
pietrowicz15_interspeech	['university of illinois, department of computer science', 'university of illinois, department of electrical and computer engineering']	3	Analysis of Paralinguistics in Speech and Language
daoudi15_interspeech	['inria bordeaux-sud ouest, geostat team', 'talence. france.', 'http://geostat.bordeaux.inria.fr']	3	Analysis of Paralinguistics in Speech and Language
vergyri15_interspeech	['sri international, menlo park, ca', 'conicet and university of buenos aires, argentina', 'nyu langone medical center, department of psychiatry, new york, ny']	3	Analysis of Paralinguistics in Speech and Language
yu15b_interspeech	['mit lincoln laboratory, lexington, massachusetts, usa', 'center for psych consulting, usa']	3	Analysis of Paralinguistics in Speech and Language
gomezgarcia15_interspeech	['universidad politecnica de madrid, spain', 'universidad nacional de colombia, manizales, colombia.']	3	Analysis of Paralinguistics in Speech and Language
