paper_id	affiliations
itakura17_interspeech	"['Nagoya University, Japan', 'Monday', ' August', ':45–10:15, Aula Magna', 'Biography', 'Fumitada Itakura was born in Toyokawa, in Japan, in August 1940. He studied electronic', 'engineering at Nagoya University', '–1963. He advanced to its graduate school and studied', 'information engineering with topics such as statistical optical character recognition and time', ""series analysis of cardiac rhythmicity. After finishing his master's degree in 1965, he worked on"", 'speech signal processing using a statistical approach. He received his doctorate in engineering', 'from Nagoya University in 1971 for his work on a statistical method for speech analysis and', 'synthesis.', ""Itakura's early work on speech spectral envelope and formant estimation using the maximum"", 'likelihood methods (1967) laid the groundwork for much of the research in speech signal process-', 'ing in the three subsequent decades, ranging from vocoder designs for low bit-rate transmission', 'to distance measures (Itakura-Saito distance) for speech pattern recognition. He introduced the', 'concepts of the auto-regressive model and the partial auto-correlation to the speech area and', 'developed the first mathematically tractable formulation of the speech recognition problem', 'based on the minimum prediction residual principle, providing a solid framework for integrat-', 'ing speech analysis, representation, and pattern matching into a complete engineering system.', 'His work on autoregressive modeling of speech is used in almost every low-to-medium bit rate', 'speech transmission system. The Line Spectral Pair (LSP) representation, which he developed', 'in the 1975, is now used in nearly every cellular phone system and handset. Itakura and Hong', ""Wang's recent work in sub-band dereverberation algorithms has also become the foundation for"", 'many new breakthroughs. His singular and yet broad contributions to speech signal processing', 'earned him the IEEE Morris Liebmann Award in 1986, the most prestigious Society Award from', 'the IEEE Signal Processing Society in 1996, IEEE Fellow in 2003, the Purple Ribbon Medal from', 'the Japanese government in 2003 and the Distinguished Achievement and Contributions Award', 'from IEICE in 2003. These technical achievements were accomplished mainly at Nagoya Univer-', 'sity (1965–1968', '–2003), the fourth research section of Musashino Electrical Communication', 'Laboratory of NTT (1963–1973', '–1983), Acoustic Research Laboratory of Bell Telephone', 'Laboratories, Murray Hill (1973–1975), and Meijo University (2003–2011).', 'ISCA Medal for Scientific Achievement', 'The ISCA Medal for Scientific Achievement 2017 will be awarded to Professor Fumitada Itakura', 'by the President of ISCA during the opening ceremony.', 'Copyright © 2017 ISCA', 'INTERSPEECH 2017', 'August 20–24', ', Stockholm, Sweden', 'Copyright © 2017 ISCA', 'INTERSPEECH 2017', 'August 20–24', ', Stockholm, Sweden']"
kinnunen17_interspeech	['Tomi Kinnunen1, Md Sahidullah1, Hector Delgado2, Massimiliano Todisco2,', 'Nicholas Evans2, Junichi Yamagishi3,4, Kong Aik Lee5']
font17_interspeech	['Biometric Vox S. L., Spain']
patil17_interspeech	['Speech Research Lab, Dhirubhai Ambani Institute of Information and Communication Technology', '(DA-IICT), Gandhinagar, Gujarat, India']
cai17_interspeech	['SYSU-CMU Joint Institute of Engineering, School of Electronics and Information Technology,', 'Sun Yat-sen University, Guangzhou, China', 'SYSU-CMU Shunde International Joint Research Institute, Guangdong, China', 'Jiangsu Jinling Science and Technology Group Limited']
jelil17_interspeech	['Department of Electronics and Electrical Engineering,', 'Indian Institute of Technology Guwahati, Guwahati-781039, India']
witkowski17_interspeech	['AGH University of Science and Technology', 'Department of Electronics, Krakow, Poland']
wang17_interspeech	['Beijing Samsung Telecom R&D Center, China', 'Beijing Institute of Technology, China']
ylmaz17_interspeech	['CLS/CLST, Radboud University, Nijmegen, Netherlands', 'Fryske Akademy, Leeuwarden, Netherlands', 'Omrop Fryslˆan, Leeuwarden, Netherlands']
ylmaz17b_interspeech	['CLS/CLST, Radboud University, Nijmegen, Netherlands']
ramanarayanan17_interspeech	['Educational Testing Service R&D', 'New Montgomery Street, Suite 1500, San Francisco, CA']
rallabandi17_interspeech	['Language Technologies Institute, Carnegie Mellon University, Pittsburgh, PA, USA']
chandu17_interspeech	['Carnegie Mellon University, USA', 'Microsoft Research India']
amazouz17_interspeech	['LPP-CNRS Universite Sorbonne Nouvelle Paris-III, Paris, France', 'LIMSI, CNRS, Paris Saclay University, Orsay, France']
guzman17_interspeech	['University of Texas at Austin, United States']
westhuizen17_interspeech	['Department of Electrical and Electronic Engineering, Stellenbosch University, South Africa']
soto17_interspeech	['Columbia University, NY, USA']
lavrentyeva17_interspeech	['ITMO University, St.Petersburg, Russia', 'STC-innovations Ltd., St.Petersburg, Russia']
ji17_interspeech	['National Computer network Emergency Response technical Team', 'Coordination Center of China(CNCERT/CC), China', 'Big Data Innovation Center, Creditease, China']
nagarsheth17_interspeech	['Pindrop, Atlanta, USA']
chen17_interspeech	['School of Electronic and Information Engineering', 'South China University of Technology, GuangZhou, China']
hartmann17_interspeech	['Raytheon BBN Technologies, Cambridge, MA, USA']
wong17_interspeech	['Department of Engineering, University of Cambridge', 'Trumpington Street, CB2 1PZ Cambridge, England']
cui17_interspeech	['IBM T. J. Watson Research Center, Yorktown Heights, NY 10598, USA']
ma17_interspeech	['Raytheon BBN Technologies, Cambridge, MA, USA']
saon17_interspeech	['IBM Watson, Yorktown Heights, USA', 'IBM Research - Tokyo, Japan', 'Appen, Sydney, Australia']
stolcke17_interspeech	['Microsoft AI and Research, Redmond, WA, USA']
petukhova17_interspeech	['Spoken Language Systems Group, Saarland University, Germany', 'Tilburg Center for Communication and Cognition, Tilburg University, The Netherlands']
bone17_interspeech	['Signal Analysis and Interpretation Laboratory (SAIL), USC, Los Angeles, CA, USA', 'Face Lab, Emerson College, Boston, MA, USA', 'Department of Communication Sciences and Disorders, Emerson College, Boston, MA, USA']
burmania17_interspeech	['Multimodal Signal Processing (MSP) Lab, Department of Electrical and Computer Engineering', 'The University of Texas at Dallas, Richardson TX 75080, USA']
fotedar17_interspeech	['Electrical Engineering, Indian Institute of Science, Bangalore 560012, India']
huang17_interspeech	['Human Language Technology Department, Institute for Infocomm Research, Singapore', 'National Engineering Research Center for E-Learning, Central China Normal University', 'ECE Department, National University of Singapore, Singapore']
dohen17_interspeech	['Univ. Grenoble Alpes, CNRS, GIPSA-lab, F-38000 Grenoble, France', 'UroMems SAS, F-38000 Grenoble, France']
guzewich17_interspeech	['Electrical and Computer Engineering Department, Binghamton University, Binghamton NY, USA']
bulling17_interspeech	['Daimler AG, D-89081 Ulm, Germany', 'Kiel University, D-24143 Kiel, Germany']
franzen17_interspeech	['Institute for Communications Technology, Technische Universit¨at Braunschweig,', 'Schleinitzstr. 22', ' Braunschweig, Germany']
wang17b_interspeech	['CRSS Lab, Dept. Electrical Engineering', 'The University of Texas at Dallas', 'Richardson, Texas 75080']
ayllon17_interspeech	['R&D Department, Fonetic, Spain', 'Signal Theory and Communications Department, University of Alcala, Spain']
wu17_interspeech	['Department of Electrical and Computer Engineering', 'National Chiao Tung University, Hsinchu, Taiwan 300, R.O.C.', 'Department of Otolaryngology', 'Hualien Tzu Chi Hospital, Hualian City, Hualien County, Taiwan 970, R.O.C.']
hermes17_interspeech	['University of Illinois at Urbana-Champaign']
elie17_interspeech	['INRIA/CNRS/universite de Lorraine, France']
frej17_interspeech	['The MARCS Institute, Western Sydney University, Australia', 'Haskins Laboratories, New Haven, Connecticut, USA']
turco17_interspeech	['Universite Sorbonne-Nouvelle Paris 3 - Laboratoire de Phonetique et Phonologie', '(LPP), UMR 7018', ' rue des Bernardins, Paris, France']
jones17_interspeech	['MARCS Institute for Brain, Behaviour & Development, Western Sydney University, Australia', 'Department of Linguistics, Macquarie University, Australia']
dutta17_interspeech	['Dept. of Computational Linguistics, The EFL University, Hyderabad', 'University of Illinois at Urbana-Champaign', 'University of Florida, Gainesville', 'Indian Institute of Technology Guwahati']
cabral17_interspeech	['School of Computer Science & Statistics, Trinity College Dublin, Ireland', 'School of Information & Communication Studies, University College Dublin, Ireland']
gully17_interspeech	['and Keiichi Tokuda2', 'Audio Lab, Department of Electronics, University of York, UK', 'Department of Scientific and Engineering Simulation, Nagoya Institute of Technology, Japan']
maguer17_interspeech	['Computational Linguistics & Phonetics, Saarland University, Germany', 'Multimodal Computing and Interaction, Saarland University, Germany', 'German Research Center for Artificial Intelligence (DFKI GmbH), Saarbrucken, Germany']
alexander17_interspeech	['Signal Analysis & Interpretation Laboratory (SAIL)', 'University of Southern California, Los Angeles, CA, USA']
mendelson17_interspeech	['KTH Royal Institute of Technology, Sweden', 'CereProc Ltd. and University of Edinburgh, UK']
cao17_interspeech	['Speech Disorders & Technology Lab, Department of Bioengineering', 'Callier Center for Communication Disorders', 'University of Texas at Dallas, Richardson, Texas, United States', 'Center for Spoken Language Understanding, Oregon Health & Science University', 'Department of Otolaryngology - Head and Neck Surgery', 'University of Texas Southwestern Medical Center, Dallas, Texas, United States']
ma17b_interspeech	['Graduate Center, The City University of New York, NY, USA', 'Google Inc, New York, NY, USA']
oualil17_interspeech	['Spoken Language Systems (LSV)', 'Collaborative Research Center on Information Density and Linguistic Encoding', 'Saarland University, Saarbrucken, Germany']
chen17b_interspeech	['University of Cambridge Engineering Department', 'Chinese University of Hong Kong']
huang17b_interspeech	['IBM Thomas J. Watson Research Center, Yorktown Heights, NY, USA']
kurata17_interspeech	['IBM Research - Tokyo, Japan', 'IBM T. J. Watson Research Center, USA']
benes17_interspeech	['Karel Benes, Murali Karthick B.askar, Luk´as Burget']
poorjam17_interspeech	['Audio Analysis Lab, AD:MT, Aalborg University, Aalborg, DK', 'Engineering and Applied Science, Aston University, Birmingham, UK', 'Media Lab, MIT, Cambridge, Massachusetts, USA']
le17_interspeech	['University of Michigan, Ann Arbor, MI 48109, USA', '†Computer Science and Engineering, ‡University Center for Language and Literacy']
garcia17_interspeech	['Faculty of Engineering, Universidad de Antioquia UdeA, Medellin, Colombia', 'Pattern Recognition Lab, Friedrich-Alexander-Universit¨at Erlangen-Nurnberg, Germany', 'Institute for Infocomm Research I2R, A*STAR, Singapore', 'Center for Language and Speech Processing, Johns Hopkins University, Baltimore, USA']
chien17_interspeech	['Center for Analysis and Design of Intelligent Agents, Reykjavik University, Iceland']
bai17_interspeech	['Department of Electronic Electrical and Systems Engineering,', 'The University of Birmingham, Birmingham B15 2TT, UK']
chen17c_interspeech	['School of Electrical Engineering and Telecommunications', 'The University of New South Wales, UNSW Sydney, NSW 2052, Australia', 'Data61 CSIRO, Australia']
vijayan17_interspeech	['Department of Electrical and Computer Engineering, National University of Singapore, Singapore', 'Department of Electrical Engineering, Indian Institute of Science, Bangalore, India']
meireles17_interspeech	['Federal University of Espirito Santo, Brazil', 'University of Kansas, USA', 'University of Sao Paulo, Brazil']
backstrom17_interspeech	['Aalto University, Department of Signal Processing and Acoustics, Espoo, Finland']
ghosh17_interspeech	['LORIA/CNRS, Nancy, France', 'Speech Cognition - E.A. 1339, LiLPa, University of Strasbourg, France']
jacewicz17_interspeech	['Department of Speech and Hearing Science, The Ohio State University, Columbus, OH, USA']
yoneyama17_interspeech	['Daito Bunka University, Japan', 'Sophia University, Japan', 'Hosei University, Japan']
maastricht17_interspeech	['Tilburg Center for Communication and Cognition, Tilburg University, The Netherlands', 'Radboud University, Nijmegen, The Netherlands']
takiguchi17_interspeech	['Bunkyo Gakuin University, Japan']
zhang17_interspeech	['Institute of Cross-Linguistic Processing and Cognition, School of Foreign Languages,', 'Shanghai Jiao Tong University, China']
kim17_interspeech	['Google Speech']
kinoshita17_interspeech	['NTT Communication Science Labs, NTT corporation']
ichikawa17_interspeech	['Watson Multimodal, IBM, Tokyo 103-8510, Japan', 'Watson Multimodal, IBM, Yorktown Heights, NY 10598, USA']
tu17_interspeech	['University of Science and Technology of China, Hefei, Anhui, China', 'iFlytek Research, Hefei, Anhui, China', 'Georgia Institute of Technology, Atlanta, Georgia, USA']
li17c_interspeech	['Google, Inc. U.S.A']
mirsamadi17_interspeech	['Center for Robust Speech Systems (CRSS)', 'The University of Texas at Dallas, Richardson, TX 75080-3020, U.S.A.']
morise17_interspeech	['Faculty of Engineering, University of Yamanashi, Japan']
loweimi17_interspeech	['Speech and Hearing Research Group (SPandH), University of Sheffield, Sheffield, UK']
stone17_interspeech	['Institute of Acoustics and Speech Communication, Technische Universit¨at Dresden, Germany']
kawahara17_interspeech	['Wakayama University, Japan', 'Health Science University of Hokkaido, Japan', 'University of Yamanashi, Japan', 'Meijo University, Japan', 'Graduate School of Information Science, Nagoya University, Japan']
kumar17_interspeech	['Department of Electronics and Communication Engineering', 'National Institute of Technology Patna, India.']
alradhi17_interspeech	['Department of Telecommunication and Media Informatics', 'Budapest University of Technology and Economics, Budapest, Hungary', 'MTA-ELTE Lendulet Lingual Articulation Research Group, Budapest, Hungary']
wu17b_interspeech	['Investigation Bureau, Ministry of Justice, R.O.C', 'Research Center for Information Technology Innovation, Academia Sinica, R.O.C', 'Dept of Electrical Engineering, National Chi Nan University, R.O.C', 'Department of Electrical Engineering, Yuan Ze University, R.O.C', 'Institute of Information Science, Academia Sinica, R.O.C']
sharma17_interspeech	['Dept. of Electronics and Electrical Engineering, Indian Institute of Technology Guwahati,', 'Guwahati-781039,']
laine17_interspeech	['Aalto University, Espoo, Finland', 'unto.laine(at)aalto.fi']
kroos17_interspeech	['Centre for Vision, Speech and Signal Processing (CVSSP)', 'University of Surrey', 'Guildford, Surrey, GU2 7XH, UK']
dai17_interspeech	['National Laboratory of Pattern Recognition, Institute of Automation, Chinese Academy of', 'Sciences,Beijing, China', 'University of Chinese Academy of Sciences, Beijing, China']
khonglah17_interspeech	['Department of Electronics and Electrical Engineering', 'Indian Institute of Technology (IIT) Guwahati, Guwahati-781039, India', 'Department of Electronics and Communication Engineering', 'Indian Institute of Information Technology (IIIT) Dharwad']
guo17_interspeech	['and Abeer Alwan1', 'Department of Electrical Engineering, University of California, Los Angeles, CA', ', USA', 'Snap Inc., Venice, CA, USA', 'Google Inc., Mountain View, CA, USA']
xia17_interspeech	['School of Electrical, Electronic and Computer Engineering, The University of Western Australia', 'School of Engineering and Information Technology, Murdoch University']
jang17_interspeech	['Media Research Division, Electronics and Telecommunications Research Institute, Korea', 'Department of Electronics Engineering, Chungnam National University, Korea']
sonowal17_interspeech	['Samsung Electronics Co. Ltd., South Korea', 'Department of ECE, Seoul National University, ASRI, South Korea', 'Department of ECE, Seoul National University, INMC, South Korea']
ebbers17_interspeech	['Paderborn University, Germany', 'Carnegie Mellon University, United States']
zohrer17_interspeech	['Intelligent Systems Group, Signal Processing and Speech Communication Laboratory, Graz', 'University of Technology, Austria']
mcauliffe17_interspeech	['Department of Linguistics, McGill University, Canada', 'Department of Linguistics, University of Maryland, USA', 'Centre for Research on Brain, Language, and Music, McGill University, Canada']
meenakshi17_interspeech	['Electrical Engineering, Indian Institute of Science (IISc), Bangalore, Karnataka- 5600012, India']
williams17_interspeech	['Google Inc.']
zenkel17_interspeech	['Carnegie Mellon University; Pittsburgh, PA; U.S.A.', 'Karlsruhe Institute of Technology; Karlsruhe, Germany']
hadian17_interspeech	['Department of Computer Engineering, Sharif University of Technology, Iran', 'Center for Language and Speech Processing, Johns Hopkins University, USA', 'Human Language Technology Center of Excellence, Johns Hopkins University, USA']
chorowski17_interspeech	['Google Brain, USA', 'Nvidia, USA']
li17d_interspeech	"[""School of Computer Science, Northwestern Polytechnical University, Xi'an, China"", 'Tencent AI Lab, Seattle, USA']"
xiang17_interspeech	['Key Lab. of Shanghai Education Commission for Intelligent Interaction and Cognitive Engineering', 'SpeechLab, Department of Computer Science and Engineering', 'Brain Science and Technology Research Center', 'Shanghai Jiao Tong University, Shanghai, China']
chandrashekaran17_interspeech	['Department of Electrical and Computer Engineering,', 'Carnegie Mellon University, USA']
toyama17_interspeech	['Graduate School of Engineering, The University of Tokyo']
pahuja17_interspeech	['IBM Research - Bangalore, India', 'IBM Research - Haifa, Israel']
shen17_interspeech	['Spoken Language Systems (LSV)', 'Saarland University, Saarbrucken, Germany']
moro17_interspeech	['Department of Telecommunications and Media Informatics,', 'Budapest University of Technology and Economics, Budapest, Hungary', 'Spoken Language Systems Group (LSV), Saarland University, Saarbrucken, Germany']
wang17c_interspeech	['Department of Electrical and Electronic Engineering, Southern University of Science and', 'Technology, Shenzhen, China']
wang17d_interspeech	['Department of Electrical and Electronic Engineering, Southern University of Science and', 'Technology, Shenzhen, China']
ishida17_interspeech	['Sophia University, Japan,', 'Japan Society for the Promotion of Science, Japan']
burchfield17_interspeech	['The MARCS Institute, Western Sydney University, Australia', 'Department of Linguistics & Languages, McMaster University, Canada']
davis17_interspeech	['The MARCS Institute, Western Sydney University, Australia']
maslowski17_interspeech	['Max Planck Institute for Psycholinguistics, Nijmegen, The Netherlands', 'International Max Planck Research School for Language Sciences, Nijmegen, The Netherlands', 'Donders Institute for Brain, Cognition and Behaviour, Radboud University, Nijmegen, The', 'Netherlands']
peres17_interspeech	['University of Sao Paulo, Brazil', 'University of York, United Kingdom']
guevararukoz17_interspeech	['Ecole Normale Superieure - PSL Research University / EHESS / CNRS / INRIA, France', 'School of Medicine, Federal University of Minas Gerais, Brazil', 'Laboratoire de Phonetique et Phonologie, UMR7018 CNRS / Sorbonne-Nouvelle, France', 'Graduate School of Arts and Sciences, The University of Tokyo, Japan']
matsui17_interspeech	['Graduate School of Systems Engineering, Wakayama University, Japan', 'Department of Physiology, Development, and Neuroscience, University of Cambridge, UK']
lorenzotrueba17_interspeech	['National Institute of Informatics, Tokyo, Japan', 'The University of Edinburgh, Edinburgh, UK']
niebuhr17_interspeech	['Mads Clausen Institute, IRCA, University of Southern Denmark, Soenderborg, Denmark', 'Dept. of General Linguistics, Kiel University, Kiel, Germany']
marques17_interspeech	['University of Colorado at Boulder, USA']
kim17b_interspeech	['University of Hawai‘i at Mānoa, USA']
silva17_interspeech	['DETI / IEETA, University of Aveiro (Aveiro, Portugal)']
somandepalli17_interspeech	['Signal Analysis and Interpretation Laboratory, University of Southern California, Los Angeles, USA']
asadiabadi17_interspeech	['Multimedia, Vision and Graphics Laboratory,', 'College of Engineering, Koc University, Istanbul, Turkey']
sorensen17_interspeech	['Shrikanth Narayanan', 'University of Southern California, Los Angeles, CA, USA']
cao17b_interspeech	['Beijing Language and Culture University, China']
franken17_interspeech	['Hagoort1,2, James M. McQueen1,2', 'Radboud University, Donders Institute for Brain, Cognition and Behaviour, the Netherlands', 'Max Planck Institute for Psycholinguistics, the Netherlands']
peters17_interspeech	['Centre for Language Studies, Radboud University Nijmegen, the Netherlands']
lai17_interspeech	['Department of Linguistics, University of Pennsylvania']
ito17_interspeech	['GIPSA lab, CNRS, France', 'Haskins Laboratories, USA', 'McGill University, Canada']
renner17_interspeech	['Department of Linguistics', 'Stockholm University', 'Stockholm, Sweden']
kyaw17_interspeech	['Graduate School of Fundamental Science and Engineering', 'Department of Pure and Applied Mathematics', 'Waseda University, Japan']
mehta17_interspeech	['Ctr. for Laryngeal Surgery and Voice Rehab., Mass. General Hospital, Boston, MA, USA', 'Bioengineering Systems and Technologies, MIT Lincoln Laboratory, Lexington, MA, USA']
bandini17_interspeech	['University Health Network: Toronto Rehabilitation Institute, Toronto, Canada', 'Department of Speech-Language Pathology, University of Toronto, Canada', 'Brain Sciences, Sunnybrook Research Institute, Toronto, Canada']
romren17_interspeech	['Oslo and Akershus University College of Applied Sciences/University of Oslo, Norway', 'Utrecht University, The Netherlands']
zhou17_interspeech	['Institute of Automation, Chinese Academy of Sciences', 'University of Chinese Academy of Sciences']
siohan17_interspeech	['Google, USA']
tong17_interspeech	['Idiap Research Institute, Martigny, Switzerland', 'Ecole Polytechnique Federale de Lausanne (EPFL), Switzerland']
karafiat17_interspeech	['Martin Karafi´at, Murali Karthick B.askar, Pavel Matˇejka, Karel Vesely, Frantisek Grezl', 'Luk´as Burget and Jan “Honza” ˇCernocky']
matassoni17_interspeech	['Center for Information and Communication Technology', 'Fondazione Bruno Kessler, via Sommarive 18, Trento (Italy)']
kim17c_interspeech	['School of Electrical Engineering, KAIST, Daejeon, Republic of Korea']
do17_interspeech	['Van Hai Do1,4, Nancy F. Chen2, Boon Pang Lim2, Mark Hasegawa-Johnson1,3']
joy17_interspeech	['Indian Institute of Technology-Madras, India']
samarakoon17_interspeech	['Hong Kong University of Science and Technology', 'Google, Inc']
fainberg17_interspeech	['The Centre for Speech Technology Research, University of Edinburgh, United Kingdom']
sproat17_interspeech	['Google, New York, NY, USA', 'Google, Mountain View, CA, USA (now at NVIDIA)']
rendel17_interspeech	['IBM TJ Watson Research Center, Yorktown Heights, NY – USA', 'IBM Haifa Research Lab, Haifa – Israel']
ijima17_interspeech	['NTT Media Intelligence Laboratories, NTT Corporation.']
ni17_interspeech	['Advanced Speech Technology Laboratory, ASTREC,', 'National Institute of Information and Communications Technology, Japan']
fukuoka17_interspeech	['Faculty of Science and Engineering, Waseda University, Japan']
huang17c_interspeech	['Tsinghua-CUHK Joint Research Center for Media Sciences, Technologies and Systems,', 'Graduate School at Shenzhen, Tsinghua University, Shenzhen 518055, China', 'Department of Systems Engineering and Engineering Management,', 'The Chinese University of Hong Kong, Shatin, N.T., Hong Kong SAR, China']
zheng17_interspeech	['National Laboratory of Pattern Recognition,', 'CAS Center for Excellence in Brain Science and Intelligence Technology,', 'Institute of Automation, Chinese Academy of Sciences, China', 'School of Computer and Control Engineering, University of Chinese Academy of Science, China']
chen17d_interspeech	['Key Lab. of Shanghai Education Commission for Intelligent Interaction and Cognitive Engineering', 'SpeechLab, Department of Computer Science and Engineering', 'Brain Science and Technology Research Center', 'Shanghai Jiao Tong University, Shanghai, China']
chen17e_interspeech	['Key Lab. of Shanghai Education Commission for Intelligent Interaction and Cognitive Engineering', 'SpeechLab, Department of Computer Science and Engineering', 'Brain Science and Technology Research Center', 'Shanghai Jiao Tong University, Shanghai, China']
ribeiro17_interspeech	['Centre for Speech Technology Research, University of Edinburgh, UK', 'National Institute of Informatics, Tokyo, Japan']
szekely17_interspeech	['KTH Royal Institute of Technology, Sweden']
oktem17_interspeech	['Universitat Pompeu Fabra, Spain', 'Catalan Institute for Research and Advanced Studies (ICREA), Spain']
vetchinnikova17_interspeech	['University of Helsinki, Finland']
jochim17_interspeech	['Institute of Phonetics and Speech Processing, Ludwig-Maximilians-Universit¨at Munchen, Germany']
warlaumont17_interspeech	"['Cognitive and Information Sciences, University of California, Merced', 'Washington State University and Hearing Oral Program of Excellence (HOPE) of Spokane', 'Duke University, USA', ""LSCP, Departement d'Etudes Cognitives, ENS, EHESS, CNRS, PSL Research University, Paris,"", 'France.']"
bell17_interspeech	['The Centre for Speech Technology Research, University of Edinburgh, EH8 9AB, UK']
bhat17_interspeech	['TCS Innovation Labs, Mumbai, India', 'Ali Yavar Jung National Institute for Speech and Hearing Disabilities, Mumbai, India']
jaumardhakoun17_interspeech	['Gerard', 'Dreyfus1, Francois-Benoît Vialatte1,2', 'ESPCI Paris, PSL Research University, Paris, France', 'Brain Plasticity Unit, CNRS 8249, Paris, France', 'Drew University, Music Department, Madison, New Jersey', 'College of Saint Elizabeth, Music Department, Morristown, New Jersey']
draxler17_interspeech	['Institute of Phonetics and Speech Processing, Ludwig Maximilian University Munich, Germany']
salimbajevs17_interspeech	['Tilde, Vienibas gatve 75A, Riga, Latvia', 'University of Latvia, Raina bulv. 19, Riga, Latvia']
park17_interspeech	['†Human Language Technology Center', 'Department of Electronic and Computer Engineering', 'Hong Kong University of Science and Technology', '∗EMOS Technologies Inc.']
lennes17_interspeech	['University of Helsinki, Finland', 'CSC - IT Center for Science, Finland']
suzuki17_interspeech	['CLR Phonetics Lab, University of Aizu, Japan']
allen17_interspeech	['Professor of Computer Science, University of Rochester', 'Associate Director of the Institute for Human and Machine', 'Cognition in Pensacola Florida', 'Tuesday', ' August', ':30–9:30, Aula Magna', 'Dialogue as Collaborative Problem Solving']
stasak17_interspeech	['University of New South Wales, Australia', 'Data61-CSIRO, Sydney, Australia', 'Human-Centred Technology, University of Canberra, Canberra, Australia']
novoa17_interspeech	['Richard Stern2, Nestor Becerra Yoma1', 'Speech Processing and Transmission Lab., Universidad de Chile', 'Robust Speech Recognition Group, ECE Dept., Carnegie Mellon University']
turker17_interspeech	['Koc University, Turkey']
baird17_interspeech	['Chair of Complex & Intelligent Systems, Universit¨at Passau, Germany', 'Machine Intelligence & Signal Processing Group, Technische Universit¨at Munchen, Germany', 'Centre for Research in Autism and Education, UCL Institute of Education, U.K.', 'Machine Learning Group, Imperial College London, U.K.']
oertel17_interspeech	['KTH Royal Institute of Technology, Sweden']
lancia17_interspeech	['Laboratoire de Phonetique et Phonologie, France', 'Institut de Neuroscience de la Timone, France', 'Laboratoire Parole et Langage, France']
delalez17_interspeech	"['LIMSI, CNRS, Universite Paris-Saclay, B508, rue John von Neumann, Campus Universitaire,', 'F-91405 Orsay, France', ""Sorbonne Universites, UPMC Univ Paris 06, CNRS, UMR 7190, Institut Jean Le Rond d'Alembert,"", 'place Jussieu, F-75005, Paris, France']"
saryazdi17_interspeech	['University of Toronto, Canada']
ishi17_interspeech	['ATR/HIL, Japan', 'Osaka University, Japan']
ruede17_interspeech	['Karlsruhe Institute of Technology, Karlsruhe, Germany', 'Carnegie Mellon University, Pittsburgh, PA, USA']
raveh17_interspeech	['Multimodal Computing and Interaction, Saarland University, Germany', 'Computational Linguistics & Phonetics, Saarland University, Germany', 'German Research Center for Artificial Intelligence (DFKI GmbH), Saarbrucken, Germany']
ebhotemhen17_interspeech	['Spoken Language Systems Group, Saarland Informatics Campus, Saarland University, Germany']
niebuhr17b_interspeech	['Mads Clausen Institute, University of Southern Denmark, Soenderborg, Denmark']
kouklia17_interspeech	['Laboratoire de Phonetique et Phonologie, UMR7018 CNRS/Sorbonne-Nouvelle, Paris, France']
gallardo17_interspeech	['Quality and Usability Lab, Telekom Innovation Laboratories, TU Berlin, Germany']
ishi17b_interspeech	['ATR/HIL, Japan', 'ATR/IRC, Japan']
simpson17_interspeech	['Institute of German Linguistics, University of Jena, Germany', 'Institute of Music, Media and Speech Studies, University of Halle-Wittenberg, Germany']
schweitzer17_interspeech	['Institute for Natural Language Processing, University of Stuttgart, Germany']
weirich17_interspeech	['Friedrich Schiller University Jena, Germany']
soleraurena17_interspeech	['Ramon Fern´andez-Astudillo1,6, Joana Campos4,5, Ana Paiva4,5, Isabel Trancoso1,4', 'Spoken Language Systems Laboratory, INESC-ID Lisboa, Lisboa, Portugal', 'FLUL/CLUL, Universidade de Lisboa, Lisboa, Portugal', 'Instituto Universit´ario de Lisboa (ISCTE-IUL), Lisboa, Portugal', 'Instituto Superior Tecnico, Universidade de Lisboa, Lisboa, Portugal', 'Intelligent Agents and Synthetic Characters Group, INESC-ID Lisboa, Lisboa, Portugal', 'Unbabel Lda, Portugal']
tatman17_interspeech	['The University of Washington, United States', 'Zonar Systems, United States']
prabhavalkar17_interspeech	['Google Inc., U.S.A', 'NVIDIA, U.S.A.']
zeyer17_interspeech	['Human Language Technology and Pattern Recognition, Computer Science Department,', 'RWTH Aachen University', ' Aachen, Germany']
hori17_interspeech	['Mitsubishi Electric Research Laboratories', 'Massachusetts Institute of Technology', 'Carnegie Mellon University']
lu17_interspeech	['†Toyota Technological Institute at Chicago, USA', '‡School of Computer Science, Carnegie Mellon University, USA', '§Google DeepMind, London, UK', '⋄Computer Science & Engineering, University of Washington, Seattle, USA']
audhkhasi17_interspeech	['IBM T. J. Watson Research Center, Yorktown Heights, NY']
li17e_interspeech	['Google Inc., U.S.A']
lucero17_interspeech	['Dept. Computer Science, University of Brasilia, Brasilia DF 70910-900, Brazil']
sivaraman17_interspeech	['University of Maryland College Park, USA', 'University of Groningen, Netherlands']
arai17_interspeech	['Department of Information and Communication Sciences', 'Sophia University, Tokyo, Japan']
badino17_interspeech	['Istituto Italiano di Tecnologia, Italy', 'University College London, UK', 'Johns Hopkins University, MD,USA']
uchida17_interspeech	['The University of Tokyo', '-3-1, Hongo, Bunkyo-ku, Tokyo', '-8656 Japan']
sorensen17b_interspeech	['Signal Analysis and Interpretation Lab, University of Southern California, Los Angeles, CA, USA', 'Department of Linguistics, University of Southern California, Los Angeles, CA, USA']
snyder17_interspeech	['Center for Language and Speech Processing & Human Language Technology Center of Excellence,', 'The Johns Hopkins University, USA']
villalba17_interspeech	['Center for Language and Speech Processing, Johns Hopkins University, Baltimore, MD, USA', 'Nuance Communications, Inc., South Africa']
ranjan17_interspeech	['Center for Robust Speech Systems (CRSS)', 'The University of Texas at Dallas, Richardson, TX, USA']
shon17_interspeech	['School of Electrical Engineering, Korea University, South Korea', 'Dept. of Visual Information Processing, Korea University, South Korea', 'Dept. of Computer Science and Engineering, Incheon National University, South Korea']
khosravani17_interspeech	['Laboratory for Intelligent Multimedia Processing (LIMP)', 'Amirkabir University of Technology (AUT), Iran']
jorrin17_interspeech	['Nuance Communications, Inc.']
aare17_interspeech	['University of Tartu, Estonia', 'University of Helsinki, Finland', 'Stockholm University, Sweden']
yanushevskaya17_interspeech	['Trinity College Dublin, Ireland']
kalita17_interspeech	['Department of Electronics and Electrical Engineering', 'Department of Humanities and Social Sciences', 'Center for Linguistic Science and Technology', 'Indian Institute of Technology Guwahati', 'Guwahati 781039, India']
mokhtari17_interspeech	['Center for Information and Neural Networks (CiNet)', 'National Institute of Information and Communications Technology (NICT), Japan']
sheena17_interspeech	['Department of Computer Science, Bar-Ilan University, Ramat-Gan, Israel', 'Department of English, Aarhus University, Denmark']
nara17_interspeech	['University of Toronto, Canada']
wang17e_interspeech	['National Institute of Informatics, Japan', 'SOKENDAI University, Japan', 'University of Edinburgh, UK']
klimkov17_interspeech	['Amazon.com']
tanaka17_interspeech	['Graduate School of Information Science, Nara Institute of Science and Technology, Japan', 'NTT Communication Science Laboratories, NTT Corporation, Japan', 'Information Technology Center, Nagoya University, Japan']
hojo17_interspeech	['NTT Media Intelligence Laboratories, NTT Corporation, Japan', 'The University of Tokyo, Japan', 'NTT Communication Science Laboratories, NTT Corporation, Japan']
malisz17_interspeech	['Department of Speech, Music and Hearing, KTH, Stockholm, Sweden', 'STTS – Sodermalms talteknologiservice AB, Stockholm, Sweden']
betz17_interspeech	['Bielefeld University, Bielefeld, Germany', 'CITEC, Bielefeld, Germany']
satt17_interspeech	['IBM Research-Haifa, Israel', 'Technion-Israel Institute of Technology, Israel']
zhang17b_interspeech	['NTT Media Intelligence Laboratories, NTT Corporation, Japan', 'School of Electrical and Computer Engineering,', 'Georgia Tech, North Ave NW, Atlanta', ', GA, USA']
gideon17_interspeech	['∗', ', Zakaria Aldeneh1,', 'Dimitrios Dimitriadis2, Emily Mower Provost1', 'University of Michigan at Ann Arbor', 'IBM T. J. Watson Research Center']
parthasarathy17_interspeech	['Multimodal Signal Processing (MSP) Lab, Department of Electrical and Computer Engineering', 'The University of Texas at Dallas, Richardson TX 75080, USA']
le17b_interspeech	['University of Michigan, Ann Arbor, MI 48109, USA', 'Computer Science and Engineering']
kim17d_interspeech	['Human Media Interaction, University of Twente, Enschede, The Netherlands']
tamamori17_interspeech	['Institute of Innovation for Future Society, Nagoya University, Japan', 'Graduate School of Information Science, Nagoya University, Japan', 'Information Technology Center, Nagoya University, Japan']
gu17_interspeech	['National Engineering Laboratory for Speech and Language Information Processing', 'University of Science and Technology of China, Hefei, P.R.China']
takaki17_interspeech	['National Institute of Informatics, Japan.', 'NTT Communication Science Laboratories, Nippon Telegraph and Telephone Corporation, Japan.', 'The Centre for Speech Technology Research, University of Edinburgh, United Kingdom.']
ronanki17_interspeech	['The Centre for Speech Technology Research (CSTR), University of Edinburgh, UK']
kobayashi17_interspeech	['Information Technology Center, Nagoya University, Japan', 'Graduate School of Information Science, Nagoya University, Japan', 'Institute of Innovation for Future Society, Nagoya University, Japan']
wan17_interspeech	['Google, London, UK']
kain17_interspeech	['Center for Spoken Language Understanding, Oregon Health & Science University', 'Portland, OR, USA', 'University at Buffalo, Buffalo, NY, USA']
irino17_interspeech	['Faculty of Systems Engineering, Wakayama University,', 'Department of Physiology, Development, and Neuroscience, University of Cambridge']
bosch17_interspeech	['Radboud University Nijmegen, NL', 'Max Planck Institute for Psycholinguistics']
jahromi17_interspeech	['⋆Dept. of Electronic Systems, Aalborg University, Fredrik Bajers Vej 7', ' Aalborg, Denmark', '†Oticon A/S, Kongebakken 9, DK-2765 Smoerum, Denmark']
huber17_interspeech	['Medizinische Physik and Cluster of Excellence Hearing4all, Carl von Ossietzky Universit¨at', 'Oldenburg, Oldenburg, Germany']
neufeld17_interspeech	['University of Maryland']
wang17f_interspeech	['University of Science and Technology of China, Hefei, Anhui, P. R. China', 'Georgia Institute of Technology, Atlanta, GA. USA']
higuchi17_interspeech	['NTT Communication Science Laboratories, NTT Corporation, Kyoto, Japan']
andrei17_interspeech	['University “Politehnica” of Bucharest']
li17f_interspeech	['Key Laboratory of Speech Acoustics and Content Understanding,', 'Institute of Acoustics, Chinese Academy of Sciences, Beijing 1001090, China', 'University of Chinese Academy of Sciences, China', 'Xinjiang Laboratory of Minority Speech and Language Information Processing']
quiroz17_interspeech	['Leibniz-ZAS & Berlin School of Mind and Brain, Berlin, Germany', 'Leibniz-ZAS & Humboldt-Universitaet zu Berlin, Berlin, Germany']
simko17_interspeech	['University of Helsinki, Finland', 'University of Tampere, Finland']
ip17_interspeech	['The MARCS Institute, Western Sydney University, Penrith South, NSW 2751, Australia', 'ARC Centre of Excellence for the Dynamics of Language, Canberra, ACT 2601, Australia']
zahner17_interspeech	['Linguistics Department, University of Konstanz, Germany;', 'The MARCS Institute for Brain, Behaviour & Development, Australia;', 'The ARC Centre of Excellence for the Dynamics of Language, Australia']
rognoni17_interspeech	['Appen Limited, Australia']
maekawa17_interspeech	['National Institute for Japanese Language and Linguistics, Japan']
ma17c_interspeech	['Tsinghua-CUHK Joint Research Center for Media Sciences, Technologies and Systems,', 'Graduate School at Shenzhen, Tsinghua University, Shenzhen 518055, China', 'Department of Systems Engineering and Engineering Management,', 'The Chinese University of Hong Kong, Shatin, N.T., Hong Kong SAR, China', 'Tsinghua National Laboratory for Information Science and Technology (TNList),', 'Department of Computer Science and Technology, Tsinghua University, Beijing 100084, China']
sahu17_interspeech	['Speech Communication Laboratory, University of Maryland, College Park, MD, USA', 'Amazon.com, USA', 'VoiceVibes, Marriottsville, MD; Information Sciences Institute, USC, Los Angeles, CA, USA']
dang17_interspeech	['School of Electrical Engineering and Telecommunications, UNSW, Sydney, Australia', 'DATA61, CSIRO, Sydney, Australia']
khorram17_interspeech	['University of Michigan at Ann Arbor', 'IBM T. J. Watson Research Center']
chasaide17_interspeech	['Phonetics and Speech Laboratory, School of Linguistic, Speech and Communication Sciences', 'Trinity College Dublin, Ireland']
neumann17_interspeech	['University of Stuttgart, Germany']
miyoshi17_interspeech	['Graduate School of Information Science and Technology, The University of Tokyo,', '-3-1 Hongo, Bunkyo-ku, Tokyo 113-8656, Japan']
hsu17_interspeech	['Computer Science and Artificial Intelligence Laboratory', 'Massachusetts Institute of Technology', 'Cambridge, MA 02139, USA']
hashimoto17_interspeech	['Graduate School of Engineering, The University of Tokyo, Japan']
kaneko17_interspeech	['NTT Communication Science Laboratories, NTT Corporation, Japan']
ardaillon17_interspeech	['IRCAM - UMR STMS (IRCAM - CNRS - Sorbonne Universits) Paris, France']
mohammadi17_interspeech	['Center for Spoken Language Understanding, Oregon Health & Science University', 'Portland, OR, USA']
sak17_interspeech	['Google Inc., USA']
pundak17_interspeech	['Google Inc., New York, NY, USA']
ravanelli17_interspeech	['Fondazione Bruno Kessler, Trento, Italy', 'Universite de Montreal, Montreal, Canada']
ratajczak17_interspeech	['Graz University of Technology, Signal Processing and Speech Communication Laboratory', 'ETH Zurich, Learning & Adaptive Systems Group']
han17_interspeech	['Capio Inc., Belmont, CA, USA']
colibro17_interspeech	['Nuance Communications, Inc.', 'Politecnico di Torino, Italy']
zhang17c_interspeech	['Center for Robust Speech Systems (CRSS), Erik Jonsson School of Engineering,', 'University of Texas at Dallas, Richardson, Texas, U.S.A.']
plchot17_interspeech	['Nuance Communications, Inc.', 'CRIM, Montreal (Quebec), Canada']
sadjadi17_interspeech	['Reynolds2, Elliot Singer2, Lisa Mason3, Jaime Hernandez-Cordero3', 'NIST ITL/IAD/Multimodal Information Group, MD, USA', 'MIT Lincoln Laboratory, Lexington, MA, USA', 'U.S. Department of Defense, MD, USA']
kawahara17b_interspeech	[', Hideki Banno', ', Tomoki Toda5', 'Toshio Irino1', 'Wakayama University, Japan', 'Health Science University of Hokkaido, Japan', 'Graduate School of Science and Technology, Meijo University, Japan', 'Interdisciplinary Graduate School of Medicine and Engineering, University of Yamanashi, Japan', 'Graduate School of Information Science, Nagoya University, Japan']
lopez17_interspeech	['Department of Signal Processing and Acoustics, Aalto University, Finland.']
juvela17_interspeech	['Aalto University, Department of Signal Processing and Acoustics, Finland', 'National Institute of Informatics, Japan', 'The Centre for Speech Technology Research, University of Edinburgh, United Kingdom']
sorin17_interspeech	['IBM Research – Haifa, Israel']
manriquez17_interspeech	['Universidad Tecnica Federico Santa Maria, Chile', 'University of Waterloo, Canada', 'Universidad de Valparaiso, Chile']
espic17_interspeech	['The Centre for Speech Technology Research (CSTR), University of Edinburgh, UK']
kember17_interspeech	['The MARCS Institute, Western Sydney University, Australia;', 'ARC Centre of Excellence for the Dynamics of Language, Australia;', 'University of', 'Tubingen, Germany;', 'Konstanz University, Germany']
hou17_interspeech	['Utrecht University']
athanasopoulou17_interspeech	['UC San Diego, USA', 'University of Delaware, USA']
plug17_interspeech	['University of Leeds, United Kingdom', 'University of Glasgow, United Kingdom']
yang17_interspeech	['Communication Sciences and Disorders, University of Central Arkansas, USA', 'Communication Sciences and Disorders, Ohio University, USA', 'Chinese Academy of Social Sciences, China']
ewald17_interspeech	['Lund University, Sweden', 'University of Tartu, Estonia']
yue17_interspeech	['The University of Tokyo,', 'Tokyo International University,', 'Kyoto University']
lee17b_interspeech	['Educational Testing Service', 'Rosedale Road, Princeton, NJ, USA', 'clee001, syoon, xwang002,']
arora17_interspeech	['Faculty of Linguistics, Philology and Phonetics, University of Oxford, UK', 'Goethe University, Frankfurt am Main, Germany']
proenca17_interspeech	['Instituto de Telecomunicacões, Coimbra, Portugal', 'Department of Electrical and Computer Engineering, University of Coimbra, Portugal', 'Polytechnic Institute of Leiria, Leiria, Portugal', 'Microsoft & University of Washington, Seattle, WA, USA', 'Microsoft AI and Research, Mountain View, CA, USA', 'Microsoft, Digital Advisory Services, Lisbon, Portugal']
escuderomancebo17_interspeech	['Department of Computer Science, University of Valladolid, Spain', 'Department of Spanish Philology, Universitat Aut`onoma de Barcelona, Spain', 'Department of Modern Languages, UNED, Spain']
ward17_interspeech	['E. Shriberg3, Andreas Tsiartas3', 'University of Texas at El Paso, USA', 'Kyoto University, Japan', 'SRI International']
levow17_interspeech	['University of Washington,', 'Seattle, WA USA']
barriere17_interspeech	['LTCI, Telecom ParisTech, Universite Paris Saclay, F-75013, Paris, France']
luo17_interspeech	['+Department of Electronic Engineering, Tsinghua University, Beijing, China', 'oSignal Analysis and Interpretation Lab, University of Southern California, Los Angeles, CA, USA']
schroder17_interspeech	['Institute of Acoustics and Speech Communication, Technische Universit¨at Dresden']
mendels17_interspeech	['Columbia University, USA']
swart17_interspeech	['Nuance Communications, Inc. (South Africa)']
dey17_interspeech	['Idiap Research Institute, Martigny, Switzerland', 'Ecole Polytechnique Federale de Lausanne, Lausanne, Switzerland']
zhang17d_interspeech	['Center for Robust Speech Systems (CRSS), University of Texas at Dallas, Richardson, TX 75080', 'Microsoft Corporation, One Microsoft Way, Redmond, WA 98052']
yu17_interspeech	['Beijing University of Posts and Telecommunications, China', 'Aalborg University, Denmark']
ma17d_interspeech	['School of Electrical Engineering and Telecommunications, UNSW Australia', 'DATA61, CSIRO, Sydney, Australia', 'Institute for Infocomm Research, A*STAR, Singapore']
zhong17_interspeech	['Department of Systems Engineering & Engineering Management,', 'The Chinese University of Hong Kong, Hong Kong SAR of China,', 'Speech Group, Microsoft Research Asia, Beijing, China']
vestman17_interspeech	['School of Computing, University of Eastern Finland, Finland', 'DMC R&D Center, Samsung Electronics, Seoul, Korea', 'Department of Signal Processing and Acoustics, Aalto University, Finland']
bhattacharya17_interspeech	['McGill University, Montreal, Canada', 'Computer Research Institute of Montreal, Montreal, Canada']
park17b_interspeech	['Dept of Electrical Engineering, University of California Los Angeles, USA', 'Dept of Head and Neck Surgery, School of Medicine, University of California Los Angeles, USA', 'Dept of Linguistics, University of California Los Angeles, USA']
lee17c_interspeech	['Institute for Infocomm Research (I2R), A⋆STAR, Singapore', 'Department of Electrical and Computer Engineering, National University of Singapore']
heo17_interspeech	['School of Computer Science, University of Seoul, Korea']
chen17f_interspeech	['School of Computer Science and Technology, Harbin Institute of Technology, China']
li17g_interspeech	['Center for Speech and Language Technologies, Research Institute of Information Technology', 'Department of Computer Science and Technology, Tsinghua University, Beijing', ', China']
bousquet17_interspeech	['University of Avignon - LIA, France']
mccree17_interspeech	['Human Language Technology Center of Excellence', 'Johns Hopkins University, Baltimore, MD, USA']
borgstrom17_interspeech	['MIT Lincoln Laboratory, Lexington, MA', 'NIST ITL/IAD/Multimodal Information Group, MD']
tan17_interspeech	['Dept. of Electronic and Information Engineering, The Hong Kong Polytechnic University']
matejka17_interspeech	['Mireia Diez S´anchez, Jan “Honza” ˇCernocky']
silnova17_interspeech	['Brno University of Technology, Czech Republic']
travadi17_interspeech	['Signal Analysis and Interpretation Lab, University of Southern California']
rahman17_interspeech	['Speech and Audio Research Laboratory, Queensland University of Technology, Brisbane, Australia']
cheng17_interspeech	['Sanjeev Khudanpur4,5,Yonghong Yan1,2,3', 'Key Laboratory of Speech Acoustics and Content Understanding, Institute of Acoustics,', 'Xinjiang Laboratory of Minority Speech and Language Information Processing, Xinjiang Technical', 'Institute of Physics and Chemistry,', 'Chinese Academy of Sciences, China', 'University of Chinese Academy of Sciences', 'Center of Language and Speech Processing', 'Human Language Technology Center Of Excellence,', 'The Johns Hopkins University, Baltimore, MD, USA']
kim17e_interspeech	['Samsung Semiconductor, Inc.', 'Directors Place, San Diego, CA, USA']
tran17_interspeech	['NTT Communication Science Laboratories, NTT corporation,', '-4, Hikaridai, Seika-cho (Keihana Science City), Soraku-gun, Kyoto 619-0237 Japan', 'Nara Institute of Science and Technology', '-5 Takayama, Ikoma, Nara, Japan']
karita17_interspeech	['NTT Communication Science Laboratories, NTT Corporation, Kyoto, Japan']
ark17_interspeech	['Baidu Silicon Valley Artificial Intelligence Lab', ' Bordeaux Dr. Sunnyvale, CA 94089, USA', '*Equal contribution']
wu17c_interspeech	['Cambridge University Engineering Dept,', 'Trumpington St., Cambridge, CB2 1PZ, U.K.']
heck17_interspeech	['Watson Multimodal, IBM Research - Tokyo, Japan', 'Graduate School of Information Science, Nara Institute of Science and Technology, Japan']
grosz17_interspeech	['Institute of Informatics, University of Szeged, Hungary', 'MTA-SZTE Research Group on Artificial Intelligence, Szeged, Hungary']
grosz17b_interspeech	['University of Szeged, Institute of Informatics, Szeged, Hungary', 'MTA-SZTE Research Group on Artificial Intelligence, Szeged, Hungary']
wang17h_interspeech	['Center for Language and Speech Processing', 'Human Language Technology Center of Excellence', 'The Johns Hopkins University, Baltimore, MD 21218, USA']
takeda17_interspeech	['The Institute of Scientific and Industrial Research, Osaka University, Japan', 'Honda Research Institute Japan, Co. Ltd., Japan']
variani17_interspeech	['Google Inc, Mountain View, CA, USA']
sim17_interspeech	['Google Inc., USA']
tuske17_interspeech	['Human Language Technology and Pattern Recognition, Computer Science Department,', 'RWTH Aachen University', ' Aachen, Germany']
tang17_interspeech	['Toyota Technological Institute at Chicago, USA']
masumura17_interspeech	['NTT Media Intelligence Laboratories, NTT Corporation, Japan']
wodarczak17_interspeech	['Stockholm University, Sweden,', 'Carnegie Mellon University, Pittsburgh PA, USA', 'Voci Technologies, Inc., Pittsburgh PA, USA', 'University of Tartu, Estonia']
maier17_interspeech	['Semantic Computing Group, CITEC, Bielefeld University', 'Dialogue Systems Group, CITEC, Bielefeld University']
ishimoto17_interspeech	['Center for Corpus Development, National Institute for Japanese Language and Linguistics, Japan', 'School of Media Science, Tokyo University of Technology, Japan']
liu17_interspeech	['ATR Hiroshi Ishiguro Lab, Japan.', 'Graduate School of Engineering Science, Osaka University.']
inaguma17_interspeech	['Graduate School of Informatics Kyoto University, Japan']
reverdy17_interspeech	['ADAPT Centre, School of Computer Science and Statistics, Trinity College Dublin, Ireland']
crook17_interspeech	['Microsoft Corporation, Redmond, WA U.S.A.']
ramanarayanan17b_interspeech	['Hillary Molloy† and David Suendermann-Oeft†', 'Educational Testing Service R&D,', '†90 New Montgomery Street, Suite 1500, San Francisco, CA', '‡660 Rosedale Rd., Princeton, NJ']
ando17_interspeech	['NTT Media Intelligence Laboratories, NTT Corporation, Japan']
ultes17_interspeech	['Engineering Department, University of Cambridge, Cambridge, United Kingdom']
nakamura17_interspeech	['Graduate School of Informatics, Kyoto University, Japan']
fatima17_interspeech	['Multimedia, Vision and Graphics Laboratory,', 'College of Engineering, Koc University, Istanbul, Turkey']
elsner17_interspeech	['Department of Linguistics, The Ohio State University']
bohn17_interspeech	['Department of English, Aarhus University, Denmark', 'Center on Autobiographical Memory Research, Dept. of Psychology, Aarhus University, Denmark']
kleber17_interspeech	['Institute of Phonetics and Speech Processing, LMU Munich, Germany']
reidy17_interspeech	['Callier Center for Communication Disorders, University of Texas at Dallas, USA', 'Department of Linguistics, Ohio State University, USA', 'Department of Hearing and Speech Sciences, University of Maryland, USA', 'Department of Speech-Language-Hearing Sciences, University of Minnesota, USA']
xiao17_interspeech	['South China University of Technology, Guangzhou, China', 'Microsoft Research Asia, Beijing, China']
chen17g_interspeech	['Department of Chinese and Bilingual Studies, The Hong Kong Polytechnic University, Hong Kong', 'SAR, China', 'Department of Modern and Classical Languages, University of North Georgia, U. S.']
wiener17_interspeech	['Carnegie Mellon University, Pittsburgh, PA, USA']
chen17h_interspeech	['School of Foreign Studies, Nanjing University of Science and Technology, China', 'Department of Linguistics, University of Oregon, USA']
luo17b_interspeech	['School of Electronic Communication Technology, Shenzhen Institute of Information Technology,', 'China,', 'School of Applied Foreign Languages, Shenzhen Polytechnic, China,', 'Shenzhen Seaskyland Technologies, China']
hanulikova17_interspeech	['University of Freiburg, Germany', 'Freiburg Institute for Advanced Studies, University of Freiburg, Germany', 'University of Stockholm, Sweden']
fernandez17_interspeech	['Department of Linguistics, Stockholm University, Sweden']
sjons17_interspeech	['Department of Linguistics, Stockholm University, Sweden', 'Center for Language and Cognition Groningen, University of Groningen, The Netherlands']
zhang17e_interspeech	['Department of Chinese and Bilingual Studies, The Hong Kong Polytechnic University, Hong Kong', 'Shenzhen Institutes of Advanced Technology, Chinese Academy of Sciences, China']
marklund17_interspeech	['Stockholm Babylab, Phonetics Laboratory, Dept. of Linguistics, Stockholm University, Sweden']
berisha17_interspeech	['Visar Berisha1,2, Julie Liss1, Timothy Huston2, Alan Wisler1, Yishan Jiao1, Jonathan Eig3']
castellana17_interspeech	['Department of Electronics and Telecommunications, Politecnico di Torino, Italy', 'Department of Speech, Music and Hearing, KTH, Stockholm, Sweden', 'Department of Energy, Politecnico di Torino, Italy']
bandini17b_interspeech	['University Health Network: Toronto Rehabilitation Institute, Toronto, Canada', 'MGH Institute of Health Professions, Boston, USA', 'Neurology, Sunnybrook Health Sciences Centre, Toronto, Canada', 'Brain Sciences, Sunnybrook Research Institute, Toronto, Canada', 'Department of Speech-Language Pathology, University of Toronto, Canada']
adiga17_interspeech	['Department of Electronics and Electrical Engineering', 'Indian Institute of Technology Guwahati, India', 'VIT University, Chennai, India']
laaridh17_interspeech	['University of Avignon, CERI/LIA, France', 'Aix Marseille Universite, CNRS, LPL UMR 7309', ', Aix-en-Provence, France']
klumpp17_interspeech	['Orozco-Arroyave1,2, Elmar N¨oth1', 'Friedrich-Alexander-Universit¨at Erlangen-Nurnberg, Germany', 'Universidad de Antioquia, Colombia']
hlavnicka17_interspeech	['Czech Technical University in Prague, Faculty of Electrical Engineering, Department of Circuit', 'Theory, Technicka 2', ' 27, Prague 6, Czech Republic', 'Charles University in Prague, First Faculty of Medicine, Department of Neurology and Centre of', 'Clinical Neuroscience, Katerinska 30', ' 00, Prague 2, Czech Republic']
tu17b_interspeech	['Speech and Hearing Science Department', 'School of Electrical, Computer, and Energy Engineering', 'Arizona State University']
vachhani17_interspeech	['TCS Innovation Labs, Mumbai']
lilley17_interspeech	['Nemours Biomedical Research, Wilmington DE, USA']
li17h_interspeech	['Institute of Linguistics, Chinese Academy of Social Sciences, Beijing, China', 'Clinical Audiology Center, Beijing Tongren Hospital, Beijing, China', 'Beijing Institute of Otolaryngology, Beijing, China']
gu17b_interspeech	['Nanjing Normal University, China', 'George Washington University, USA']
kumar17b_interspeech	['Language Technologies Institute, School of Computer Science', 'Carnegie Mellon University']
huang17d_interspeech	['Key Laboratory of Speech Acoustics and Content Understanding, Institute of Acoustics, Chinese', 'Academy of Sciences', 'University of Chinese Academy of Sciences', 'Xinjiang Laboratory of Minority Speech and Language Information Processing, Xinjiang', 'Technical Institute of Physics and Chemistry, Chinese Academy of Sciences']
pradhan17_interspeech	['Department of Electronics and Communication Engineering', 'National Institute of Technology Patna, India.']
gao17_interspeech	['School of Electrical/Electronic and Computer Engineering, The University of Western Australia,', 'Australia']
xu17_interspeech	['School of Computer Science and Engineering, Nanyang Technological University, Singapore', 'School of Computer Science, Northwestern Polytechnical University, China', 'Department of Electrical and Computer Engineering, National University of Singapore, Singapore']
guo17b_interspeech	['Shanghai Institute of Microsystem and Information Technology, Chinese Academy of Sciences', 'Beijing Unisound Information Technology Co. Ltd.', 'HuaWei Technologies Co. Ltd.']
wang17i_interspeech	['Speech and Audio Signal Processing Laboratory, Faculty of Information Technology, Beijing', 'University of Technology, Beijing, China', 'Department of Electrical and Computer Engineering, The University of Auckland,', 'Auckland 1142, New Zealand']
shannon17_interspeech	['Google Inc., USA']
he17_interspeech	['Coordinated Science Lab, University of Illinois at Urbana-Champaign, Urbana, Illinois, USA 61801', 'Inspirit IoT, Inc, Champaign, Illinois, USA 61822', 'Beckman Institute, University of Illinois at Urbana-Champaign, Urbana, Illinois, USA 61801']
zegers17_interspeech	['KU Leuven, Dept. ESAT, Belgium']
yang17b_interspeech	['Key Laboratory of Machine Perception,', 'Shenzhen Graduate School, Peking University, China']
karthik17_interspeech	['Electrical Engineering, Indian Institute of Science (IISc), Bengaluru-560012, India']
chen17i_interspeech	['Dept. Electrical Engineering, National Tsing Hua University, Taiwan']
maas17_interspeech	['Amazon.com, USA']
kothapally17_interspeech	['Center for Robust Speech Systems (CRSS), University of Texas at Dallas, USA']
wu17d_interspeech	['Institute of Information Science, Academia Sinica, Taipei, Taiwan', 'Research Center for Information Technology Innovation, Academia Sinica, Taipei, Taiwan']
zhang17f_interspeech	['Department of Computer Science, Inner Mongolia University, China']
ogawa17_interspeech	['NTT Communication Science Laboratories, NTT Corporation, Kyoto, Japan']
gelderblom17_interspeech	['Acoustics Research Centre, SINTEF Digital, Trondheim, Norway']
koutsogiannaki17_interspeech	['Samsung Electronics']
hirsch17_interspeech	['Institute for Pattern Recognition, Niederrhein University of Applied Sciences, Krefeld, Germany', 'Fraunhofer Institute IAIS, St. Augustin, Germany']
rehr17_interspeech	['Signal Processing Group, Department of Informatics, University of Hamburg, Germany']
marxer17_interspeech	['University of Sheffield, UK']
park17c_interspeech	['Carnegie Mellon University, USA', 'Qualcomm Research, USA']
li17i_interspeech	['University of Tsukuba, Japan', 'NTT Communication Science Laboratories, NTT Corporation, Japan', 'Information Technology Center, Nagoya University, Japan']
websdale17_interspeech	['University of East Anglia']
michelsanti17_interspeech	['Department of Electronic Systems, Aalborg University, Denmark']
qian17b_interspeech	['Dinei Florencio3, Mark Hasegawa-Johnson1', 'University of Illinois at Urbana-Champaign, USA', 'IBM Watson Research Center, USA', 'Microsoft Research, USA']
zhang17g_interspeech	['Department of Computer Science, Inner Mongolia University, China', 'Department of Computer Science and Engineering, The Ohio State University, USA', 'Center for Cognitive and Brain Sciences, The Ohio State University, USA']
zorila17_interspeech	['Toshiba Cambridge Research Laboratory, United Kingdom', 'Computer Science Department, University of Crete, Greece']
meermeier17_interspeech	['Raytheon BBN Technologies, Cambridge, Massachusetts, USA']
cernak17_interspeech	['Idiap Research Institute, Switzerland']
lenarczyk17_interspeech	['IPI PAN – Institute of Computer Science of the Polish Academy of Sciences, Warsaw, Poland']
chennupati17_interspeech	['Speech Processing Lab, International Institute of Information Technology, Hyderabad, India.', 'Research Centre Imarat, Hyderabad, India.']
daniel17_interspeech	['NXP Semiconductors, Sophia Antipolis, France']
hagerer17_interspeech	['audEERING GmbH, Gilching, Germany', 'Chair of Complex & Intelligent Systems, University of Passau, Germany']
jeon17_interspeech	['School of Electrical Engineering and Computer Science', 'Gwangju Institute of Science and Technology (GIST), Gwangju 61005, Korea']
rouhe17_interspeech	['Aalto University School of Electrical Engineering, Finland']
pelachaud17_interspeech	['Director of Research CNRS at ISIR,', 'University of Pierre and Marie Curie', 'Wednesday', ' August', ':30–9:30, Aula Magna', 'Conversing with social agents that smile and laugh']
papadopoulos17_interspeech	['Pourdamghani2, Michael Pust2, Boliang Zhang3, Xiaoman Pan3, Di Lu3, Ying Lin3,', 'Glembek4, Murali Karthick B.askar4, Martin Karafi´at4, Luk´as Burget4,', 'Heng Ji3, Jonathan May2, Kevin Knight2, Shrikanth Narayanan', 'Signal Analysis and Interpretation Lab, University of Southern California, U.S.A.', 'Information Sciences Institute, University of Southern California, U.S.A.', 'Computer Science Department, Rensselaer Polytechnic Institute, U.S.A', 'Statistical Speech Technology Group, University of Illinois Urbana-Champaign, U.S.A.']
mihajlik17_interspeech	['Budapest University of Technology and Economics, Hungary', 'THINKTech Research Center, Hungary', 'University of Hradec Kralove, Czech Republic']
feng17_interspeech	['Department of Electronic Engineering, The Chinese University of Hong Kong, Hong Kong']
das17_interspeech	['University of Illinois, USA', 'Brno University of Technology, Czech Republic']
gutkin17_interspeech	['Google, London, United Kingdom', 'Google, New York City, NY, USA']
hall17_interspeech	['University of British Columbia, Canada']
schwarz17_interspeech	['Stockholm Babylab, Phonetics Laboratory, Dept. of Linguistics, Stockholm University, Sweden', 'CLINTEC, Speech Pathology Unit, Karolinska Institutet, Stockholm, Sweden']
casillas17_interspeech	['Max Planck Institute for Psycholinguistics, The Netherlands', 'Psychology and Neuroscience, Duke University, USA', 'Speech, Language, and Hearing Sciences, Purdue University, USA', 'Psychology, University of Manitoba, Canada', 'Cognitive and Information Sciences, University of California, Merced, USA']
casillas17b_interspeech	"['Soderstrom5, Mark VanDam6, and Han Sloetjes1', 'Max Planck Institute for Psycholinguistics, The Netherlands', 'Duke University, USA', 'Cognitive and Information Sciences, University of California Merced', 'Laboratoire de Sciences Cognitives et Psycholinguistique (ENS, EHESS, CNRS), Departement', ""d'Etudes Cognitives, Ecole Normale Superieure, PSL Research University, Paris, France."", 'University of Manitoba, Canada', 'Washington State University and Hearing Oral Program of Excellence (HOPE) of Spokane, USA']"
bergmann17_interspeech	"[""LSCP, Departement d' Etudes Cognitives, ENS, EHESS, CNRS, PSL Research University, Paris,"", 'France', 'University of Pennsylvania, Philadelphia, PA, USA']"
tsuji17b_interspeech	['University of Pennsylvania, Philadelphia, USA', 'LSCP, Departement detudes cognitives, ENS, EHESS, CNRS, PSL Research University, Paris,', 'France.']
chasaide17b_interspeech	['The Phonetics and Speech Lab., School of Linguistic, Speech and Communication Sciences,', 'Trinity College, Dublin']
saeb17_interspeech	['Department of Electrical and Electronic Engineering, Stellenbosch University, South Africa', 'UN Global Pulse, Kampala, Uganda']
malandrakis17_interspeech	['Signal Analysis and Interpretation Laboratory (SAIL), USC, Los Angeles, CA 90089, USA', 'Brno University of Technology, Bozetechova 2', ' Brno, Czech Republic']
kocharov17_interspeech	['Saint Petersburg State University, Russia']
bhati17_interspeech	['Department of Electrical Engineering, IIT Hyderabad, Hyderabad, India']
gauthier17_interspeech	"[""Laboratoire d'Informatique de Grenoble (LIG), Univ. Grenoble Alpes, Grenoble, France"", 'Laboratoire Dynamique Du Langage (DDL), CNRS - Universite Aix Marseille, France']"
glarner17_interspeech	['Department of Communications Engineering – Paderborn University', ' Paderborn, Germany', 'Cognitive Signal Processing Group – Ruhr-Universit¨at Bochum', ' Bochum, Germany']
zhuang17_interspeech	['Apple Inc., USA']
abraham17_interspeech	['Indian Institute of Technology-Madras, India']
abraham17b_interspeech	['Indian Institute of Technology-Madras, India']
helgadottir17_interspeech	['Center for Analysis and Design of Intelligent Agents, Reykjavik University, Iceland']
alumae17_interspeech	['School of Information Technologies, Tallinn University of Technology, Tallinn, Estonia', 'North Estonian Medical Centre, Tallinn, Estonia']
niekerk17_interspeech	['Multilingual Speech Technologies, North-West University, South Africa', 'Google Inc.']
gutkin17b_interspeech	['Google Inc., United Kingdom']
mendelson17b_interspeech	['KTH Royal Institure of Technology, Sweden', 'Centre for Speech Technology Research, University of Edinburgh, Edinburgh, EH8 9AB, UK']
tong17b_interspeech	['Institute for Infocomm Research, Singapore']
larsen17_interspeech	"[""Laboratoire de Sciences Cognitives et Psycholinguistique, Departement d'Etudes Cognitives, ENS,"", 'EHESS, CNRS, PSL Research University, Paris, France.']"
wiren17_interspeech	['Department of Linguistics, Stockholm University, Sweden']
marklund17b_interspeech	['Stockholm Babylab, Phonetics Laboratory, Dept. of Linguistics, Stockholm University, Sweden']
strombergsson17_interspeech	['Division of Speech and Language Pathology, Department of Clinical Science, Intervention and', 'Technology (CLINTEC), Karolinska Institutet (KI), Stockholm, Sweden', 'Department of Speech, Music and Hearing, KTH, Stockholm, Sweden', 'Department of Linguistics, Stockholm University, Stockholm, Sweden']
chaabouni17_interspeech	"[""Departement d'Etudes Cognitives, Ecole Normale Superieure, Ecole des Hautes Etudes en Sciences"", 'Sociales, PSL Research University, Centre National de la Recherche Scientifique, Paris, France.', 'Facebook AI Research, Paris']"
obuchi17_interspeech	['School of Media Science, Tokyo University of Technology']
bosker17_interspeech	['Max Planck Institute for Psycholinguistics, PO Box 310', ' AH, Nijmegen, Netherlands', 'Donders Institute for Brain, Cognition and Behaviour, Radboud University, Nijmegen, Netherlands']
gallardo17b_interspeech	['Quality and Usability Lab, Telekom Innovation Laboratories, TU Berlin, Germany']
trouvain17_interspeech	['Language Science and Technology, Saarland University, Saarbrucken, Germany']
schweitzer17b_interspeech	['Institute for Natural Language Processing, University of Stuttgart, Germany']
novaktot17_interspeech	['Mads Clausen Institute, University of Southern Denmark, Denmark', 'Utrecht University, the Netherlands']
michalsky17_interspeech	['Institute of German Studies, University of Oldenburg, Germany']
jiao17_interspeech	['School of Foreign Languages, Tongji University, China', 'Department of Speech, Hearing and Phonetic Sciences, University College London, UK', 'Institute of Acoustics and Speech Communication, Technische Universitat Dresden, Germany']
baumann17_interspeech	['Language Technology Institute, Carnegie Mellon University, Pittsburgh, USA', 'Natural Language Systems Group, Department of Informatics, Universitat Hamburg, Germany']
signorello17_interspeech	['Laboratoire de Phonetique et Phonologie (LPP), Universite Sorbonne Nouvelle, Paris 3, France', 'Hôpital Erasme, Universite Libre de Bruxelles, Belgium']
serrurier17_interspeech	['Clinic for Phoniatrics, Pedaudiology & Com. Disorders, Uniklinik RWTH Aachen, Germany', 'GIPSA-Lab, Univ. Grenoble Alpes & CNRS, F-38000 Grenoble, France', 'Inserm US 17 - CNRS UMS 3552 - Univ. Grenoble Alpes & CHU Grenoble, UMS IRMaGe, France']
patil17b_interspeech	['Signal Analysis and Interpretation Laboratory', 'University of Southern California, USA']
tang17b_interspeech	['University of British Columbia, Canada', 'Massachusetts General Hospital, USA', 'University of Maryland Dental School, USA']
uezu17_interspeech	['Kyushu University', '-9-1 Shiobaru, Minami-ku, Fukuoka, Japan']
gangamohan17_interspeech	['Speech Processing Laboratory', 'International Institute of Information Technology, Hyderabad, India']
hua17_interspeech	['University of Illinois, U.S.A.']
dhiman17_interspeech	['Department of Electrical Engineering, Indian Institute of Science, Bangalore - 560 012, India']
miwa17_interspeech	['School of Information Science, Japan Advanced Institute of Science and Technology', '-1 Asahidai, Nomi, Ishikawa 923–1292 Japan']
graf17_interspeech	['Acoustic Speech Enhancement Research, Nuance Communications Deutschland GmbH, Ulm,', 'Germany', 'Digital Signal Processing and System Theory, Christian-Albrechts-Universit¨at zu Kiel, Kiel,', 'Germany']
morise17b_interspeech	['Faculty of Engineering, University of Yamanashi, Japan']
stehwien17_interspeech	['University of Stuttgart, Germany']
galvez17_interspeech	['Departamento de Computacion, FCEyN, Universidad de Buenos Aires, Argentina', 'Constantine the Philosopher University in Nitra, Slovakia', 'Institute of Informatics, Slovak Academy of Sciences, Slovakia', 'Instituto de Investigacion en Ciencias de la Computacion, CONICET-UBA, Buenos Aires, Argentina']
zellers17_interspeech	['Institut fur Linguistik: Anglistik, Universit¨at Stuttgart, Germany', 'Institut fur Maschinelle Sprachverarbeitung, Universit¨at Stuttgart, Germany']
mukherjee17_interspeech	['Center for Translational Neurophysiology of Speech and Communication,', 'Istituto Italiano di Tecnologia, Ferrara, Italy', 'Aix Marseille Univ, CNRS, LPL, Aix-en-Provence, France', 'Section of Human Physiology, University of Ferrara, Italy']
luque17_interspeech	['Telefonica Research Edificio Telefonica-Diagonal 00, Barcelona, Spain']
brusco17_interspeech	['Departamento de Computacion, FCEyN, Universidad de Buenos Aires, Argentina', 'Instituto de Investigacion en Ciencias de la Computacion, CONICET-UBA, Buenos Aires, Argentina']
egorow17_interspeech	['Cognitive Systems Group, Otto von Guericke University', ' Magdeburg, Germany']
chen17j_interspeech	['Department of Electrical Engineering, National Tsing Hua University, Taiwan', 'Department of Psychiatry, National Taiwan University Hospital and College of Medicine, Taiwan']
lin17_interspeech	['Department of Electrical Engineering, National Tsing Hua University, Taiwan']
brueckner17_interspeech	['Machine Intelligence & Signal Processing group, MMK,', 'Technische Universit¨at Munchen, Germany', 'Chair of Complex & Intelligent Systems, University of Passau, Germany', 'Department of Computing, Imperial College London, UK', 'EEMCS, University of Twente, The Netherlands', 'Nuance Communications, Ulm, Germany']
gosztolya17_interspeech	['MTA-SZTE Research Group on Artificial Intelligence, Szeged, Hungary', 'Department of Informatics, University of Szeged, Hungary']
haider17_interspeech	['ADAPT Centre, Trinity College Dublin, Ireland', 'IPHSI, University of Edinburgh, UK']
li17j_interspeech	['Microsoft AI and Research, One Microsoft Way, Redmond, WA 98052']
ahmad17_interspeech	['Department of Electronics and Communication Engineering, NIT Sikkim, India.', 'Department of Electronics and Communication Engineering, NIT Patna, India.', 'Department of Computer Science and Engineering, NIT Sikkim, India', '.']
xie17_interspeech	['Key Laboratory of Human-Machine Intelligence-Synergy Systems,', 'Shenzhen Institutes of Advanced Technology, Chinese Academy of Sciences, Shenzhen, China', 'Chinese University of Hong Kong, Hong Kong, China']
srinivasamurthy17_interspeech	['Idiap Research Institute, Martigny, Switzerland', 'Spoken Language Systems Group, Saarland University (UdS), Saarbrucken, Germany', 'Institute for Flight Guidance, German Aerospace Center (DLR), Braunschweig, Germany']
kim17f_interspeech	['MILA, Universite de Montreal, Canada', 'Samsung Advanced Institute of Technology, Republic of Korea']
bosker17b_interspeech	['Max Planck Institute for Psycholinguistics, PO Box 310', ' AH, Nijmegen, Netherlands', 'Donders Institute for Brain, Cognition and Behaviour, Radboud University, Nijmegen, Netherlands']
wang17j_interspeech	['The Chinese University of Hong Kong, Hong Kong', 'The Hong Kong Polytechnic University, Hong Kong', 'Shenzhen Institutes of Advanced Integration Technology, Chinese Academy of Sciences, China']
verma17_interspeech	['Indian Institute of Technology Madras, India', 'Massachusetts Institute of Technology, Cambridge, USA']
watanabe17_interspeech	['Graduate School of Information Science, Nara Institute of Science and Technology, Japan']
rietmolen17_interspeech	['U.R.I Octogone-Lordat (E.A. 4156), Universite de Toulouse, UTM, Toulouse, France', 'Laboratoire CLLE-LTC (UMR 5263), Universite de Toulouse, UTM, Toulouse, France', 'Laboratoire Parole & Langage (UMR 7309), Aix-Marseille Universite, Aix-en-Provence, France']
zhao17_interspeech	['Tianjin Key Laboratory of Cognitive Computing and Application, Tianjin University, China', 'Japan Advanced Institute of Science and Technology, Japan']
agrawal17_interspeech	['Learning and Extraction of Acoustic Patterns Lab, Dept. of Electrical Engg.,', 'Indian Institute of Science, Bengaluru-560012, India.']
mimura17_interspeech	['Kyoto University, School of Informatics, Sakyo-ku, Kyoto606-8501, Japan', 'RIKEN Center for Advanced Intelligence Project (AIP), Chuo-ku, Tokyo103-0027, Japan']
yu17b_interspeech	['Tencent AI Lab, Seattle, USA', 'Department of Computer Science and Engineering, Shanghai Jiao Tong University, Shanghai, China']
tachioka17_interspeech	['Information Technology R&D Center, Mitsubishi Electric Corporation, Japan', 'Department of Computer Science and Intelligent Systems, Faculty of Eng., Oita University, Japan', 'Mitsubishi Electric Research Laboratories, USA']
loweimi17b_interspeech	['Speech and Hearing Research Group (SPandH), University of Sheffield, Sheffield, UK']
king17_interspeech	['Parthasarathi1, Bj¨orn Hoffmeister1', 'Amazon, U.S.A.', 'University of California, San Diego, U.S.A']
bapna17_interspeech	['Google Research, Mountain View']
georgiadou17_interspeech	['Technical University of Crete, Department of Electrical & Computer Engineering, Greece']
jannet17_interspeech	['LIMSI, CNRS, Universite Paris-Saclay, F-91405 Orsay, France', 'LNE, F-78190 Trappes, France', 'LPP–CNRS UMR 7018, Universite Sorbonne Nouvelle']
dinarelli17_interspeech	['Lattice, CNRS, ENS Paris, Universite Sorbonne Nouvelle - Paris 3', 'PSL Research University, USPC (Universite Sorbonne Paris Cite)', 'INSA Rennes, France', 'INRIA/IRISA, Rennes, France']
meng17_interspeech	['School of Electrical and Computer Engnineering, Georgia Institute of Technology', '5th Street NW, Atlanta, GA 30308, USA']
liu17b_interspeech	['Center for Language and Speech Processing, The Johns Hopkins University, USA', 'Human Language Technology Center of Excellence, The Johns Hopkins University, USA']
liu17c_interspeech	['Electrical and Computer Engineering, Carnegie Mellon University', 'Language Technologies Institute, Carnegie Mellon University']
cuayahuitl17_interspeech	['University of Lincoln, School of Computer Science, Lincoln, United Kingdom', 'Samsung Electronics Ltd., Artificial Intelligence Team, Seoul, South Korea']
bayer17_interspeech	['Signals and Interactive Systems Lab - University of Trento, Italy']
akhtiamov17_interspeech	['Ulm University, Germany', 'ITMO University, Russia', 'SPIIRAS, St. Petersburg, Russia']
ramanarayanan17c_interspeech	['Educational Testing Service R&D', '†90 New Montgomery Street, #1500, San Francisco, CA', '‡660 Rosedale Rd., Princeton, NJ']
kraljevski17_interspeech	['voice INTER connect GmbH, Dresden, Germany']
milde17_interspeech	['Fraunhofer Institute IAIS, Sankt Augustin, Germany']
zhang17h_interspeech	['Center for Language and Speech Processing', 'Human Language Technology Center of Excellence', 'The Johns Hopkins University, Baltimore, MD 21218, USA']
shinozaki17_interspeech	['Tokyo Institute of Technology, Japan', 'Mitsubishi Electric Research Laboratories, USA', 'The Institute of Statistical Mathematics, Japan', 'Carnegie Mellon University, USA']
smit17_interspeech	['Department of Signal Processing and Acoustics, Aalto University, Finland']
bruguier17_interspeech	['Google Inc, USA']
naaman17_interspeech	['Department of Computer Science, Bar-Ilan University, Ramat-Gan, Israel']
gelly17_interspeech	['LIMSI, CNRS, Univ. Paris-Sud, Universite Paris-Saclay', ' Orsay, France']
jin17_interspeech	['National Engineering Laboratory of Speech and Language Information Processing', 'University of Science and Technology of China, Hefei, China', 'School of Computing, University of Kent, Medway, UK']
zhang17i_interspeech	['Center for Robust Speech Systems (CRSS), Erik Jonsson School of Engineering', 'University of Texas at Dallas, Richardson, Texas, U.S.A.']
irtza17_interspeech	['School of Electrical Engineering and Telecommunications, UNSW Australia', 'DATA61, CSIRO, Sydney, Australia', 'National University of Singapore, Singapore']
khurana17_interspeech	['Glass2', 'Qatar Computing Research Institute, HBKU, Doha, Qatar', 'MIT Computer Science and Artificial Intelligence Laboratory (CSAIL), Cambridge, MA, USA']
sailor17_interspeech	['Speech Research Lab, Dhirubhai Ambani Institute of Information and Communication Technology', '(DA-IICT), Gandhinagar-382007, Gujarat, India']
suthokumar17_interspeech	['School of Electrical Engineering and Telecommunications, UNSW Australia', 'DATA61, CSIRO, Sydney, Australia']
sarkar17_interspeech	['Department of Electronic Systems, Aalborg University, Denmark', 'Speech and Image Processing Unit, School of Computing, University of Eastern Finland, Finland']
nagrani17_interspeech	['Visual Geometry Group, Department of Engineering Science,', 'University of Oxford, UK']
jones17b_interspeech	['Linguistic Data Consortium, University of Pennsylvania, USA']
weiss17_interspeech	['Google Brain', 'Nvidia']
kano17_interspeech	['Graduate School of Information Science, Nara Institute of Science and Technology, Japan']
ruiz17_interspeech	['Fondazione Bruno Kessler, Italy', 'Interactions, LLC, USA']
do17b_interspeech	['Graduate School of Information Science', 'Nara Institute of Science and Technology, Japan']
cho17_interspeech	['Institute for Anthropomatics and Robotics', 'Karlsruhe Institute of Technology, Germany']
drude17_interspeech	['Paderborn University, Department of Communications Engineering, Paderborn, Germany']
zmolikova17_interspeech	['NTT Communication Science Laboratories, NTT Corporation, Kyoto, Japan']
pfeifenberger17_interspeech	['Signal Processing and Speech Communication Laboratory', 'Graz University of Technology, Graz, Austria', 'Ognios GmbH Salzburg, Austria']
ji17b_interspeech	['Computer and Telecomm. Eng. Division', 'Yonsei University, Wonju, Korea']
zhang17j_interspeech	['University of Illinois, Urbana-Champaign, IL, USA', 'Microsoft Research, Redmond, WA, USA']
liu17d_interspeech	['Yuanyuan Liu1,2, Tan Lee1,2, P.C. Ching1, Thomas K.T. Law3, Kathy Y.S. Lee2,3']
ylmaz17c_interspeech	['CLS/CLST, Radboud University, Nijmegen, Netherlands']
smith17_interspeech	['Data61, CSIRO, Hobart, Australia', 'University of Sydney, Sydney, Australia', 'Acoustics Research Centre, University of Salford, Manchester, U.K.', 'Health and Biosecurity, CSIRO, Sydney, Australia', 'Murdoch Childrens Research Institute, Melbourne, Australia']
joy17b_interspeech	['Indian Institute of Technology-Madras, India']
simantiraki17_interspeech	['Language and Speech Laboratory, Universidad del Pais Vasco, Vitoria, Spain', 'Gnosis Data Analysis PC, Heraklion, Greece', 'Le2i Laboratory, University of Burgundy, Le Creusot, France', 'Technological Educational Institute of Greece and FORTH, Heraklion, Greece']
sadeghian17_interspeech	['Department of Analytics, Harrisburg University of Science and Technology, Pennsylvania, USA', 'Institute for Multigenerational Studies, Binghamton University, New York, USA', 'Department of Electrical and Computer Engineering, Watson School, Binghamton University,', 'New York, USA']
biadsy17_interspeech	['Google, Inc., USA']
deena17_interspeech	['Speech and Hearing Research Group, The University of Sheffield, UK', 'Natural Language Processing Research Group, The University of Sheffield, UK']
singh17_interspeech	['Spoken Language Systems (LSV)', 'Saarbrucken Graduate School of Computer Science, Saarland Informatics Campus', 'Saarland University, Saarbrucken, Germany']
chelba17_interspeech	['Google, Inc., Mountain View', 'Google, Inc., New York City']
kumar17c_interspeech	['Signal Analysis and Interpretation Lab, University of Southern California, Los Angeles, CA', 'Gould School of Law, University of Southern California, Los Angeles, CA']
zhu17_interspeech	['Microsoft', ' 110th Ave NE, Bellevue, WA, United States']
dimitriadis17_interspeech	['IBM', 'Yorktown Heights, USA', 'Prague, Czech Republic']
seshadri17_interspeech	['Department of Signal Processing and Acoustics, Aalto University, Finland.', 'Department of Mathematics and Statistics, University of Helsinki, Finland.']
proenca17b_interspeech	['Jorge Proenca1,2, Carla Lopes1,3, Michael Tjalve4, Andreas Stolcke5, Sara Candeias6,', 'Fernando Perdigao1,2']
yoon17_interspeech	['Educational Testing Service,', 'Rosedale Road, Princeton, NJ, USA', 'syoon, clee001, ichoi001,']
li17k_interspeech	['School of Electrical and Computer Engineering, Georgia Institute of Technology, Atlanta, USA', 'Institute for Infocomm Research, Singapore', 'Department of Telematics, Kore University of Enna, Enna, Italy']
tsujimura17_interspeech	['Department of Computer Science and Engineering, Toyohashi University of Technology, Japan', 'Department of Computer Science, Chubu University, Japan']
kim17g_interspeech	['Speech Disorders & Technology Lab, Department of Bioengineering', 'Callier Center for Communication Disorders, University of Texas at Dallas, United States', 'Department of Otolaryngology-Head and Neck Surgery, University of Texas Southwestern Medical', 'Center, United States']
knill17_interspeech	['ALTA Institute / Engineering Department', 'Cambridge University, UK']
yi17_interspeech	['National Laboratory of Pattern Recognition, Institute of Automation, Chinese Academy of', 'Sciences, Beijing, China', 'School of Computer and Control Engineering, University of Chinese Academy of Sciences, Beijing,', 'China', 'CAS Center for Excellence in Brain Science and Intelligence Technology, Institute of Automation,', 'Chinese Academy of Sciences, Beijing, China']
pusateri17_interspeech	['Apple Inc., USA', 'Charles University, Czech Republic']
chen17k_interspeech	['Beckman Institute, University of Illinois at Urbana-Champaign, USA', 'Institute for Infocomm Research, A*STAR, Singapore']
gale17_interspeech	['The University of Adelaide, Australia', 'Microsoft, USA']
kaushik17_interspeech	['Center for Robust Speech Systems (CRSS), Eric Jonsson School of Engineering,', 'The University of Texas at Dallas (UTD), Richardson, Texas, U.S.A.']
mclaren17_interspeech	['Speech Technology and Research (STAR) Laboratory, SRI International, Menlo Park, USA', 'Instituto de Investigacion en Ciencias de la Computacion (ICC), CONICET-UBA, Argentina.']
fernando17_interspeech	['School of Electrical Engineering and Telecommunications, UNSW Australia', 'DATA61, CSIRO, Sydney, Australia']
shen17b_interspeech	['Institute of Information and Communications Technology, Japan']
miguel17_interspeech	['ViVoLAB, Aragon Institute for Engineering Research (I3A), University of Zaragoza, Spain']
yun17_interspeech	['Qualcomm Research†,', 'Nonhyun-dong, Gangnam-gu, Seoul', '-820, Korea']
vinals17_interspeech	['ViVoLAB, Aragon Institute for Engineering Research (I3A), University of Zaragoza, Spain', 'Center for Language and Speech Processing, Johns Hopkins University, Baltimore, MD, USA']
india17_interspeech	['TALP Research Center, Universitat Politecnica de Catalunya, Spain']
gresse17_interspeech	['LIA - University of Avignon (France)']
ajili17_interspeech	"['University of Avignon, LIA-CERI, Avignon, France', 'University of Grenoble, LIG , Grenoble, France', ""Laboratoire Nationale de metrologie et d'Essai, LNE, Paris""]"
solewicz17_interspeech	['National Police, Israel', 'Bundeskriminalamt, Germany', 'Netherlands Forensic Institute, Netherlands']
liu17e_interspeech	['Alibaba Group (U.S.) Inc.', '*University of Missouri, U.S.']
kumar17d_interspeech	['Indian Institute of Technology Guwahati, Guwahati-781039, India.', 'Indian Institute of Science, Bangalore-560012, India.', 'Indian Institute of Technology Hyderabad, Sangareddy-502285, India.']
misra17_interspeech	['Center for Robust Speech Systems (CRSS)', 'Erik Jonsson School of Engineering & Computer Science', 'The University of Texas at Dallas (UTD), Richardson, Texas, USA']
shon17b_interspeech	['School of Electrical Engineering, Korea University, South Korea', 'Dept. of Visual Information Processing, Korea University, South Korea']
settle17_interspeech	['TTI-Chicago, USA', 'Johns Hopkins University, USA']
kaneko17b_interspeech	['Iwate Prefectural University, Japan', 'University of Tsukuba, Japan', 'National Institute of Advanced Industrial Science and Technology, Japan']
khokhlov17_interspeech	['STC-Innovations Ltd, Saint-Petersburg, Russia', 'LIUM, University of Le Mans, France', 'ITMO University, Saint-Petersburg, Russia']
chen17l_interspeech	['National Taiwan Normal University, Taiwan', 'Academia Sinica, Taiwan']
tasaki17_interspeech	['Department of Computer Science and Engineering', 'Toyohashi University of Technology']
lu17b_interspeech	['College of Electrical Engineering and Computer Science, National Taiwan University, Taiwan']
tsuchiya17_interspeech	['Department of Computer Science and Engineering, Toyohashi University of Technology, Japan']
lopezotero17_interspeech	['AtlantTIC Research Center, Multimedia Technologies Group, University of Vigo, Spain']
kumar17e_interspeech	['Amazon Inc, USA', 'University of Illinois at Urbana-Champaign, USA']
tsunoo17_interspeech	['The University of Edinburgh, United Kingdom', 'Sony Corporation, Japan']
bang17_interspeech	['Chungbuk National University, South Korea', 'Electronics and Telecommunications Research Institute, South Korea']
svec17_interspeech	['NTIS, University of West Bohemia, Czechia', 'Department of Cybernetics, University of West Bohemia, Czechia', 'Center for Language and Speech Processing, Johns Hopkins University, USA']
gallardo17c_interspeech	['Quality and Usability Lab, Telekom Innovation Laboratories, TU Berlin, Germany', 'TNO, The Hague, Netherlands']
botinhao17_interspeech	['The Centre for Speech Technology Research, University of Edinburgh, UK', 'National Institute of Informatics, Japan', 'SOKENDAI University, Japan']
yamamoto17_interspeech	['Faculty of Systems Engineering, Wakayama University, Japan', 'NTT Communication Science Laboratories, Japan']
chen17m_interspeech	['Institute of Information and Engineering, CAS, Beijing, China', 'Key Laboratory of Noise and Vibration Research, Institute of Acoustic, CAS, Beijing, China', 'School of Cyber Security, University of Chinese Academy of Sciences, Beijing, China']
ward17b_interspeech	['Acoustics Research Centre, University of Salford, Manchester, U.K.']
andersen17_interspeech	['Dept. of Electronic Systems, Aalborg University', ' Aalborg Øst, Denmark', 'Oticon A/S', ' Smoerum, Denmark']
spille17_interspeech	['Medizinische Physik and Cluster of Excellence Hearing4all,', 'Carl von Ossietzky Universit¨at, Oldenburg', ', Germany']
sugai17_interspeech	['Kindai University, Japan']
ying17_interspeech	['MARCS Institute, Western Sydney University, Australia', 'Department of Linguistics, Yale University, USA', 'Institute of Language, Brain & Behaviour, University of Canterbury, New Zealand', 'Department of Linguistics, Macquarie University, Australia', 'Haskins Laboratories, USA']
klingler17_interspeech	['Acoustics Research Institute, Austrian Academy of Sciences, Austria', 'Department of German Studies, University of Salzburg, Austria']
issa17_interspeech	['University of Leeds, UK']
brandt17_interspeech	['Universit¨at des Saarlandes, Saarbrucken, Germany']
boril17_interspeech	['Institute of Phonetics, Charles University, Prague, Czech Republic']
tabain17_interspeech	"['Department of Languages and Linguistics, La Trobe University, Melbourne, Australia', 'Department of Medicine, Monash University, Melbourne, Australia', ""Murdoch Children's Research Institute, Melbourne, Australia""]"
gobl17_interspeech	['Phonetics and Speech Laboratory, School of Linguistic, Speech and Communication Sciences', 'Trinity College Dublin, Ireland']
benus17_interspeech	['Constantine the Philosopher University in Nitra, Slovakia, II SAS, Bratislava, Slovakia', 'University of Helsinki, Finland']
jochim17b_interspeech	['Institute of Phonetics and Speech Processing, Ludwig-Maximilians-Universitat Munchen, Germany']
nellore17_interspeech	['Speech Processing Laboratory,', 'International Institute of Information Technology, Hyderabad, India']
ding17_interspeech	['Institute of Cross-Linguistic Processing and Cognition, School of Foreign Languages,', 'Shanghai Jiao Tong University, China', 'Department of Chinese and Bilingual Studies, The Hong Kong Polytechnic University, Hong Kong']
schatz17_interspeech	"['Laboratoire de Sciences Cognitives et Psycholinguistique (ENS, EHESS, CNRS),', ""Departement d'Etudes Cognitives de l'Ecole Normale Superieure, PSL Research University, France"", ""SIERRA Project-Team (ENS, INRIA, CNRS), Laboratoire d'Informatique de l'Ecole Normale"", 'Superieure, PSL Research University, France', 'Department of Linguistics, University of Hawai‘i at M¯anoa, USA']"
lin17b_interspeech	['Singapore University of Technology and Design, Singapore', 'Chinese University of Hong Kong, Hong Kong']
phan17_interspeech	['and Alfred Mertins⋆', '⋆Institute for Signal Processing, University of Lubeck', '†Graduate School for Computing in Medicine and Life Sciences, University of Lubeck']
sandsten17_interspeech	['Mathematical Statistics, Centre for Mathematical Sciences, Lund University, Sweden', 'Department of Biomedical Engineering, Lund University, Sweden,']
matousek17_interspeech	['Department of Cybernetics', ' New Technology for the Information Society (NTIS)', 'Faculty of Applied Sciences, University of West Bohemia, Pilsen, Czech Rep.']
qi17_interspeech	['National Laboratory of Pattern Recognition, Institute of Automation, Chinese Academy of', 'Sciences, China', 'CAS Center for Excellence in Brain Science and Intelligence Technology, Institute of Automation,', 'Chinese Academy of Sciences, China', 'School of Computer and Control Engineering, University of Chinese Academy of Sciences, China']
jesus17_interspeech	['School of Health Sciences (ESSUA) and Institute of Electronics and Informatics Engineering of', 'Aveiro (IEETA), University of Aveiro, Portugal', 'Department of Communication and Art (DeCA), University of Aveiro, Portugal', 'Department of Mathematics (DMat) and Centre of Research and Development in Mathematics and', 'Applications (CIDMA), University of Aveiro, Portugal']
guan17_interspeech	['Harbin Institute of Technology Shenzhen Graduate School, Shenzhen', ', China', 'Newcastle University, Newcastle upon Tyne, NE1 7RU, UK', 'Nanjing Tech University, Nanjing', ', China', 'University of Surrey, Guildford, GU2 7XH, UK']
hyder17_interspeech	['Bangladesh University of Engineering and Technology (BUET), Dhaka, Bangladesh.', 'Robert Bosch Research and Technology Center (RTC), Palo Alto, CA.', 'Center for Robust Speech Systems (CRSS), The University of Texas at Dallas, Richardson, TX.']
feng17b_interspeech	['MIT Computer Science and Artificial Intelligence Laboratory, Cambridge, MA, USA', 'Ford Motor Company']
xu17b_interspeech	['Center for Vision, Speech and Signal Processing, University of Surrey, UK']
pan17_interspeech	['SYSU-CMU Joint Institute of Engineering, School of Electronics and Information Technology', 'Sun Yat-sen University, Guangzhou, China', 'School of Preschool Education, Shandong Yingcai University, Jinan, China']
chowdhury17_interspeech	['Indian Institute of Technology, Kanpur']
wang17k_interspeech	['Language Technologies Institute, Carnegie Mellon University, Pittsburgh, PA, U.S.A.']
mostafa17_interspeech	['The Hong Kong University of Science and Technology', 'Department of Electronic and Computer Engineering', 'Clear Water Bay, Kowloon, Hong Kong']
sailor17b_interspeech	['Speech Research Lab, Dhirubhai Ambani Institute of Information and Communication Technology', '(DA-IICT), Gandhinagar, India']
soni17_interspeech	['Speech Research Lab,', 'Dhirubhai Ambani Institute of Information and Communication Technology, Gandhinagar, Gujrat']
weiner17_interspeech	['Cognitive Systems Lab, Universit¨at Bremen, Germany']
gupta17_interspeech	['∗Amazon.com, USA', '+Speech Communication Laboratory, University of Maryland, College Park, MD, USA', 'oSignal Analysis and Interpretation Lab, University of Southern California, Los Angeles, CA, USA']
gillespie17_interspeech	['Georgia Institute of Technology, United States of America', 'Georgia State University, United States of America', 'Grady Memorial Hospital, United States of America', 'Northeastern University, United States of America']
novotny17_interspeech	['Department of Circuit Theory, Faculty of Electrical Engineering, Czech Technical University in', 'Prague, Prague, Czech Republic', 'Department of Neurology and Centre of Clinical Neuroscience, First Faculty of Medicine, Charles', 'University in Prague, Prague, Czech Republic', 'Institute of Anatomy, First Faculty of Medicine, Charles University in Prague, Prague, Czech', 'Republic']
hantke17_interspeech	['Chair of Complex & Intelligent Systems, University of Passau, Germany', 'Machine Intelligence & Signal Processing Group, Technische Universit¨at Munchen, Germany', 'audEERING GmbH, Gilching, Germany', 'Department of Computing, Imperial College London, UK']
agurto17_interspeech	['Carla Agurto1, Raquel Norel1, Rachel Ostrand1, Gillinder Bedi2,3, Harriet de Wit2,', 'Matthew J. Baggott2, Matthew G. Kirkpatrick4, Margaret Wardle5, Guillermo A. Cecchi1']
mirheidari17_interspeech	['Department of Computer Science, University of Sheffield, Sheffield, UK', 'Sheffield Institute for Translational Neuroscience (SITraN), University of Sheffield, Sheffield, UK', 'Department of Neurology, Royal Hallamshire Hospital, Sheffield, UK', 'Department of Human Communication Sciences, University of Sheffield, Sheffield, UK', 'IRCCS Fondazione Ospedale San Camillo, Venice, Italy', 'Academic Neurology Unit, University of Sheffield, Royal Hallamshire Hospital, Sheffield, UK']
zhang17k_interspeech	['Department of Computing, Imperial College London, London, U.K.', 'Nuance Communications, Ulm, Germany']
lopezotero17b_interspeech	['AtlantTIC Research Center, Multimedia Technologies Group, University of Vigo, Spain', 'L2F - Spoken Language Systems Lab, INESC-ID Lisboa, Portugal', 'IST - Instituto Superior Tecnico, University of Lisbon, Portugal']
wankerl17_interspeech	['Friedrich-Alexander-University Erlangen-Nuremberg, Germany']
mundnich17_interspeech	['Signal Analysis and Interpretation Lab, University of Southern California, USA', 'Signal Processing for Communication Understanding and Behavior Analysis Lab, University of', 'Southern California, USA']
pettorino17_interspeech	"[""L'Orientale University of Naples, Italy"", 'Nanjing Normal University, China', 'Jan Kochanowski University, Poland']"
tu17c_interspeech	['Shanghai Jiao Tong University, China', 'Hong Kong Baptist University, Hong Kong', 'National Tsing Hua University, Taiwan']
sahkai17_interspeech	['Institute of the Estonian Language, Estonia']
hao17_interspeech	['Beijing Language and Culture University, China']
michelas17_interspeech	['Aix Marseille Univ, CNRS, LPL, Aix-en-Provence, France']
wagner17_interspeech	['McGill University, Canada']
kleinhans17_interspeech	['TALN Research Group, DTIC, Universitat Pompeu Fabra, Barcelona, Spain', 'Departamento de Computacion, FCEyN, Universidad de Buenos Aires, Argentina', 'Instituto de Investigacion en Ciencias de la Computacion, CONICET-UBA, Buenos Aires, Argentina', 'School of Informatics, University of Edinburgh, Edinburgh, UK', 'Catalan Institute for Research and Advanced Studies, Barcelona, Spain']
godoy17_interspeech	['MIT Lincoln Laboratory', ' Wood Street, Lexington MA', ' USA']
kakouros17_interspeech	['Department of Signal Processing and Acoustics, Aalto University, Finland']
kuang17_interspeech	['Department of Linguistics, University of Pennsylvania']
skarnitzl17_interspeech	['Institute of Phonetics, Faculty of Arts, Charles University, Czech Republic', 'Department of Linguistics, Stockholm University, Sweden']
wagner17b_interspeech	['Faculty of Linguistics and Literary Studies, Bielefeld University, Germany', 'Center of Excellence Cognitive Interaction Technology (CITEC), Bielefeld University, Germany']
hsu17b_interspeech	['Hong Kong Polytechnic University, Hong Kong']
lundmark17_interspeech	['Centre for Languages and Literature, Lund University, Sweden']
puga17_interspeech	['Justus Liebig University Giessen, Germany,', 'Hong Kong Baptist University, Hong Kong SAR', 'University of Reading, United Kingdom,', 'Chinese University of Hong Kong, Hong Kong SAR']
paradacabaleiro17_interspeech	['Chair of Complex and Intelligent Systems, University of Passau, Germany', 'Machine Intelligence & Signal Processing Group, Technische Universit¨at Munchen, Germany', 'Machine Learning Group, Imperial College London, U.K.']
gibson17_interspeech	['Signal Analysis and Interpretation Lab, University of Southern California, Los Angeles, CA, USA', 'Department of Psychiatry and Behavioral Sciences, University of Washington, Seattle, WA, USA', 'sail.usc.edu,']
wortwein17_interspeech	['Karlsruhe Institute of Technology', 'Carnegie Mellon University', 'University of Southern California', 'McLean Hospital', 'Harvard Medical School']
wu17e_interspeech	['Department of Electrical Engineering, National Tsing Hua University, Taiwan', 'Institute of Biomedical Engineering and Nanomedicine, National Health Research Institute, Taiwan']
vlasenko17_interspeech	['Chair of Complex & Intelligent Systems, Universit¨at Passau, Germany', 'Idiap Research Institute, Martigny, Switzerland', 'Machine Learning Group, Imperial College London, U.K.']
siddique17_interspeech	['Human Language Technology Center', 'Department of Electronic and Computer Engineering', 'The Hong Kong University of Science and Technology', 'Clear Water Bay, Hong Kong']
arimoto17_interspeech	['Brain Science Institute, RIKEN, Japan', 'Faculty of Science and Engineering, Teikyo University, Japan', 'Graduate School of Engineering, Utsunomiya University, Japan']
fayet17_interspeech	['IRISA, EXPRESSION Team, France', 'Universite de Rennes 1', ' Universite de Bretagne Sud']
akira17_interspeech	['School of Computer Science and Statistics, Trinity College Dublin, Ireland', 'Usher Institute of Population Health Sciences & Informatics, University of Edinburgh, UK']
tseng17_interspeech	['University of Southern California, Department of Electrical Engineering, USA', 'The University of Utah, Department of Psychology, USA']
nasir17_interspeech	['University of Southern California, Los Angeles, CA, USA', 'University of Utah, Salt Lake City, UT, USA']
huang17e_interspeech	['The School of Electrical Engineering and Telecommunications, UNSW, Sydney, Australia', 'Data61, CSIRO, Australia']
sadamitsu17_interspeech	['NTT Media Intelligence Laboratories, Japan']
sawada17_interspeech	['NTT Media Intelligence Laboratories, NTT Corporation, Japan', 'The Integrated Graduate School of Medicine, Engineering, and Agricultural Sciences,', 'University of Yamanashi, Japan', 'Graduate School of Interdisciplinary Research, Faculty of Engineering,', 'University of Yamanashi, Japan']
morchid17_interspeech	['LIA, University of Avignon (France)']
korpusik17_interspeech	['MIT Computer Science and Artificial Intelligence Laboratory, Cambridge, MA 02139, USA']
parcollet17_interspeech	['LIA, University of Avignon (France)']
simonnet17_interspeech	['LIUM, Le Mans University, France', 'LIA, University of Avignon, France', 'McGill University, Montreal, Canada']
ma17e_interspeech	['Department of EECS, Oregon State University, USA', 'IBM Watson Group, T. J. Watson Research Center, IBM, USA']
riou17_interspeech	['CERI-LIA, University of Avignon, France']
martinezhinarejos17_interspeech	['Pattern Recognition and Human Language Technology Research Center,', 'Universitat Politecnica de Valencia, Camino de Vera, s/n', ', Spain', 'Sciling S.L., Carrer del Riu 321, Pinedo', ', Spain']
morales17_interspeech	['Department of Linguistics, CUNY Graduate Center, USA', 'Institute for Creative Technologies, University of Southern California, USA', 'Department of Computer Science, Brooklyn College (CUNY), USA']
huang17f_interspeech	['Speech Communication Lab,', 'School of Computer Science and Statistics, Trinity College Dublin']
hsu17c_interspeech	['Institute of Information Science, Academia Sinica, Taiwan', 'Research Center for Information Technology Innovation, Academia Sinica, Taiwan']
nakashika17_interspeech	['University of Electro-Communications, Tokyo, Japan']
aihara17_interspeech	['Graduate School of System Informatics, Kobe University', '-1, Rokkodai, Nada, Kobe, Japan']
wu17f_interspeech	['School of Computer Science, Northwestern Polytechnical University, Xi′an, China', 'Institute for Infocomm Research, A⋆STAR, Singapore', 'Department of Electrical and Computer Engineering, National University of Singapore']
tanaka17b_interspeech	['Graduate School of Natural Science and Technology, Okayama University, Japan', 'Graduate School of Medicine Dentistry and Pharmaceutical Sciences, Okayama University, Japan']
kaneko17c_interspeech	['NTT Communication Science Laboratories, NTT Corporation, Japan', 'National Institute of Informatics, Japan']
bollepalli17_interspeech	['Department of Signal Processing and Acoustics, Aalto University, Finland']
luo17c_interspeech	['Graduate School of System Informatics, Kobe University, Japan']
doddipatla17_interspeech	['Toshiba Research Europe Limited, Cambridge Research Laboratory, Cambridge, UK.', 'Dept. of Electrical and Electronics Engineering, Federal University of Santa Catarina,', 'Florianopolis, Brazil.']
li17l_interspeech	['Runnan Li1, Zhiyong Wu1,2, Yishuang Ning1, Lifa Sun2, Helen Meng1,2, Lianhong Cai1']
moore17_interspeech	['Speech & Hearing Research Group, Dept. Computer Science, University of Sheffield, UK', 'Dept. Psychology, University of Sheffield, UK']
dominguez17_interspeech	['Universitat Pompeu Fabra, Barcelona, Spain', 'Catalan Institute for Research and Advanced Studies (ICREA), Barcelona, Spain']
gruber17_interspeech	['New Technologies for the Information Society (NTIS)', 'Department of Cybernetics', 'Faculty of Applied Sciences, University of West Bohemia, Czech Republic']
juzova17_interspeech	['New Technologies for the Information Society (NTIS)', 'Department of Cybernetics', 'Faculty of Applied Sciences, University of West Bohemia, Pilsen, Czech Republic']
ghone17_interspeech	['Sasikumar M1, Hema A Murthy2', 'Centre for Development of Advanced Computing, Mumbai', 'Indian Institute of Technology, Madras']
karhila17_interspeech	['Aalto University, Finland', 'University of Helsinki, Finland', 'University of Winchester, UK']
larsson17_interspeech	['University of Gothenburg, Sweden', 'Talkamatic AB, Sweden']
ahmed17_interspeech	['Hooper5, Manny Rayner1, Herve Spechbach2, Irene Strasly1, Nikos Tsourakis1', 'University of Geneva, FTI/TIM, Switzerland', 'Hôpitaux Universitaires de Geneve', 'Geneva Society for the Deaf, Geneva, Switzerland', 'Gypsysnail Arts, South Australia', 'NABS Interpreting Services, South Australia']
duckhorn17_interspeech	['Fraunhofer IKTS, Fraunhofer Institute for Ceramic Technologies and Systems, Dresden, Germany', 'Brandenburg University of Technology Cottbus - Senftenberg, Germany', 'InnoTec21 GmbH, Leipzig, Germany', 'Leipzig University of Telecommunications, Germany']
winata17_interspeech	['Human Language Technology Center', 'Department of Electronic and Computer Engineering', 'Hong Kong University of Science and Technology, Hong Kong', 'EMOS Technologies Inc.']
alam17_interspeech	['BCL Technologies, San Jose, California, USA']
lindblom17_interspeech	['Professor emeritus University of Stockholm, Sweden', 'Professor emeritus University of Texas at Austin, USA', 'Thursday', ' August', ':30–9:30, Aula Magna', 'Re-inventing speech – the biological way']
schuller17_interspeech	['Department of Computing, Imperial College London, UK', 'Chair of Complex & Intelligent Systems, University of Passau, Germany', 'Pattern Recognition Lab, FAU Erlangen-Nuremberg, Germany', 'Psychology and Neuroscience, Duke University, USA', 'University of Wuppertal, Germany', 'Technische Universit¨at Munchen, Germany', 'Max Planck Institute for Psycholinguistics, Nijmegen, The Netherlands', 'Speech, Language, and Hearing Sciences, Purdue University, USA', 'Psychology, University of Manitoba, Canada', 'Cognitive and Information Sciences, University of California, Merced, USA', 'Clinic for ENT Medicine, Head and Neck Surgery, Alfried Krupp Krankenhaus, Essen, Germany', 'Clinic for ENT Medicine, Head and Neck Surgery, Carl-Thiem-Klinikum, Cottbus, Germany', 'University of Oulu, Finland']
huckvale17_interspeech	['University College London, London, U.K.', 'Hungarian Academy of Sciences, Budapest, Hungary']
cai17b_interspeech	['School of Electronics and Information Technology, Sun Yat-sen University, Guangzhou, China', 'SYSU-CMU Shunde International Joint Research Institute, Guangdong, China', 'Jiangsu Jinling Science and Technology Group Limited, Jiangsu, China']
wagner17c_interspeech	['Human Centered Multimedia, Augsburg University, Augsburg, Germany', 'Vocapia Research', ' rue Jean Rostand', ' Orsay, France']
suresh17_interspeech	['Telecommunication Engineering, PES Institute of Technology, Bangalore 560085, India', 'Electrical Engineering, Indian Institute of Science (IISc), Bangalore 560012, Karnataka, India']
kitamura17_interspeech	['Konan University, Japan', 'Chiba Institute of Technology, Japan', 'National Research Institute of Police Science, Japan', 'Showa University, Japan']
arnela17_interspeech	['GTM - Grup de recerca en Tecnologies Media, La Salle, Universitat Ramon Llull, Barcelona,', 'Catalonia, Spain', 'Department of Speech, Music, and Hearing, KTH Royal Institute of Technology, Stockholm,', 'Sweden']
vasudevan17_interspeech	['Department of Electrical and Computer Engineering, University of British Columbia, Canada', 'Department of Advanced Robotics, Istituto Italiano di Tecnologia, Italy']
murtola17_interspeech	['Department of Signal Processing and Acoustics, Aalto University, Finland', 'Department of Mathematics and Systems Analysis, Aalto University, Finland']
degirmenci17_interspeech	['S´anchez-Martin3, Oriol Guasch3, Sten Ternstr¨om4', 'Department of Computational Science and Technology, School of Computer Science and', 'Communication, KTH Royal Institute of Technology, SE-100 44, Stockholm, Sweden', 'BCAM- Basque Center for Applied Mathematics Mazarredo 14', ' Bilbao, Spain', 'GTM Grup de recerca en Tecnologies Media, La Salle, Universitat Ramon Llull, C/ Quatre', 'Camins 30, Barcelona 08022, Catalonia, Spain', 'Department of Speech, Music and Hearing, School of Computer Science and Communication, KTH', 'Royal Institute of Technology, SE-100 44, Stockholm, Sweden']
dabbaghchian17_interspeech	['Department of Speech, Music, and Hearing, KTH Royal Institute of Technology, Sweden', 'GTM Grup de recerca en Tecnologies Media, La Salle, Universitat Ramon Llull, Spain']
freitag17_interspeech	['Chair of Complex & Intelligent Systems, Universit¨at Passau, Germany', 'Machine Intelligence & Signal Processing Group, Technische Universit¨at Munchen, Germany', 'Machine Learning Group, Imperial College London, U.K.']
amiriparian17_interspeech	['Chair of Complex & Intelligent Systems, Universit¨at Passau, Germany', 'Machine Intelligence & Signal Processing Group, Technische Universit¨at Munchen, Germany', 'Machine Learning Group, Imperial College London, U.K.']
tavarez17_interspeech	['AHOLAB, University of the Basque Country (UPV/EHU), Bilbao, Spain']
gosztolya17b_interspeech	['University of Szeged, Institute of Informatics, Szeged, Hungary', 'MTA-SZTE Research Group on Artificial Intelligence, Szeged, Hungary', 'Yahoo Research, New York, NY']
kaya17_interspeech	['Department of Computer Engineering, Namik Kemal University, C¸ orlu, Tekirdag, Turkey', 'St. Petersburg Institute for Informatics and Automation of Russian Academy of Sciences, Russia', 'Department of Speech Information Systems, ITMO University, St. Petersburg, Russia']
toshniwal17_interspeech	['Toyota Technological Institute at Chicago']
shannon17b_interspeech	['Google Inc., USA']
meng17b_interspeech	['School of Electrical and Computer Engnineering, Georgia Institute of Technology', '5th Street NW, Atlanta, GA 30308, USA']
dighe17_interspeech	['Pranay Dighe1,2, Afsaneh Asaei1, Herve Bourlard1,2']
yang17c_interspeech	['Institute of Information Science, Academia Sinica, Taiwan', 'Research Center for Information Technology Innovation, Academia Sinica, Taiwan', 'National Taiwan Normal University, Taiwan']
jati17_interspeech	['University of Southern California, Los Angeles, CA, USA']
lan17_interspeech	['Orange Labs, France', 'LIUM, University of Le Mans, France']
cohen17_interspeech	['Afeka Tel-Aviv College of Engineering, ACLP, Israel']
wisniewksi17_interspeech	['LIMSI, CNRS, Univ. Paris-Sud, Universite Paris Saclay', ' 403 Orsay, France']
bredin17_interspeech	['CNRS, LIMSI, Universite Paris-Saclay, Orsay, France']
chen17n_interspeech	['Multimedia Signal and Intelligent Information Processing Lab,', 'Department of Electronic Engineering, Tsinghua University, Beijing, China']
trmal17_interspeech	['Center for Language and Speech Processing, Johns Hopkins University, USA', 'Human Language Technology Center of Excellence, Johns Hopkins University, USA']
khokhlov17b_interspeech	['STC-innovations Ltd, St.Petersburg, Russia', 'ITMO University, St.Petersburg, Russia']
sun17_interspeech	['Panchapagesan1, Nikko Strom1, Spyros Matsoukas1, Shiv Vitaladevuni1', 'Alexa Machine Learning, Amazon.com', 'Center for Language and Speech Processing, Johns Hopkins University']
suzuki17b_interspeech	['IBM Watson Multimodal, IBM Research - Tokyo, Chuo-ku, Tokyo', '-8510, JP', 'IBM Watson Multimodal, IBM T. J. Watson Research Center, Yorktown Heights, NY', ', US', 'IBM Systems, Lenexa, KS', ', US']
gundogdu17_interspeech	['Bogazici University, Turkey', 'National Defense University Naval Academy, Turkey']
samui17_interspeech	['Indian Institute of Technology Kharagpur, India']
huang17g_interspeech	['Speech and Audio Signal Processing Laboratory, Faculty of Information Technology, Beijing', 'University of Technology, Beijing, China']
chen17o_interspeech	['Microsoft Corporation', 'Electrical and Engineering Department, Columbia University']
yan17_interspeech	['National Taiwan Normal University, Taiwan', 'Delta Research Center, Taiwan']
pascual17_interspeech	['Universitat Politecnica de Catalunya, Barcelona, Spain', 'Telefonica Research, Barcelona, Spain']
maiti17_interspeech	['The Graduate Center, CUNY, USA', 'Brooklyn College, CUNY, USA']
stafylakis17_interspeech	['Computer Vision Laboratory', 'University of Nottingham, UK']
thangthai17_interspeech	['School of Computing Sciences, University of East Anglia, Norwich, UK']
wand17_interspeech	['The Swiss AI Lab IDSIA, USI & SUPSI, Manno-Lugano, Switzerland']
abdelaziz17_interspeech	['International Computer Science Institute, Berkeley, USA']
csapo17_interspeech	['Department of Telecommunications and Media Informatics,', 'Budapest University of Technology and Economics, Budapest, Hungary', 'MTA-ELTE Lendulet Lingual Articulation Research Group, Budapest, Hungary', 'Institute of Informatics, University of Szeged, Hungary', 'MTA-SZTE Research Group on Artificial Intelligence, Szeged, Hungary', 'Department of Phonetics, E¨otv¨os Lor´and University, Budapest, Hungary']
kamper17_interspeech	['Toyota Technological Institute at Chicago']
vesely17_interspeech	['Karel Vesely, Luk´as Burget, Jan “Honza” ˇCernocky']
hou17b_interspeech	['National Engineering Laboratory for Speech and Language Information Processing', 'University of Science and Technology of China, Hefei, Anhui, P. R. China']
fukuda17_interspeech	['IBM Watson Multimodal, IBM Research, Chuo-ku Hakozaki, Tokyo', '-8510, JAPAN', 'IBM T. J. Watson Research Center, Yorktown Heights, NY 10598, US']
prabhavalkar17b_interspeech	['Google, Inc., U.S.A', 'NVIDIA, U.S.A.']
soltau17_interspeech	['Google, New York City, NY, USA']
guo17c_interspeech	['Department of Electrical Engineering, University of California, Los Angeles, CA', ', USA']
ranjan17b_interspeech	['Center for Robust Speech Systems (CRSS)', 'The University of Texas at Dallas, Richardson, TX, USA']
mahto17_interspeech	['Data Science Research Laboratories, NEC Corporation, Japan']
wang17l_interspeech	['Data Science Research Laboratories, NEC Corporation, Japan']
alam17b_interspeech	['Computer Research Institute of Montreal (CRIM)', 'VoiceTrust, Germany']
castan17_interspeech	['Speech Technology and Research Laboratory, SRI International, California, USA', 'Instituto de Investigacion en Ciencias de la Computacion (ICC), CONICET-UBA, Argentina', 'Audias-ATVS, Universidad Autonoma de Madrid, Madrid, Spain']
abidi17_interspeech	"[""Ecole Superieure d'Informatique (ESI), Algiers, Algeria"", 'SMarT Group, LORIA, F-54600, France']"
narwekar17_interspeech	['Dept of Computer Science, University of Illinois at Urbana Champaign, IL, USA 61801', 'Dept of Electrical Engineering, Indian Institute of Science, Bangalore, India 560012']
abdelaziz17b_interspeech	['International Computer Science Institute, Berkeley, USA']
howcroft17_interspeech	['Department of Language Science and Technology', 'Saarland Informatics Campus, Saarland University, Germany']
mansikkaniemi17_interspeech	['Department of Signal Processing and Acoustics, Aalto University, Finland']
abdo17_interspeech	['Alexandria University, Phonetics and linguistics department, Egypt', 'Cairo University, Faculty of Computers & Information, Egypt']
hughes17_interspeech	['Department of Language and Linguistic Science, University of York, UK']
delvaux17_interspeech	['Institut de Recherche en Sciences et Technologies du Langage, UMONS, Belgium', 'Fonds National de la Recherche Scientifique, Belgium']
wu17g_interspeech	['Laboratoire de Phonetique et Phonologie (UMR7018, CNRS-Sorbonne Nouvelle), France', 'LIMSI, CNRS, Universite Paris-Saclay, Rue John von Neumann, F-91405 Orsay Cedex, France']
duran17_interspeech	['Institute for Natural Language Processing, University of Stuttgart, Germany', 'South African Centre for Digital Language Resources, South Africa']
kohtz17_interspeech	['Dept. of General Linguistics, ISFAS, Kiel University, Germany', 'Mads Clausen Institute, IRCA, University of Southern Denmark, Soenderborg, Denmark']
gessinger17_interspeech	['Computational Linguistics & Phonetics, Saarland University, Germany', 'Multimodal Computing and Interaction, Saarland University, Germany', 'German Research Center for Artificial Intelligence (DFKI GmbH), Saarbrucken, Germany']
ghaffarzadegan17_interspeech	['Robert Bosch Research and Technology Center (RTC), Palo Alto, CA', 'Robert Bosch GmbH', ' Stuttgart, Germany']
tran17b_interspeech	['Institute for Infocomm Research A*STAR, Singapore']
chang17_interspeech	['Google Inc., U.S.A']
baby17_interspeech	['Department of Computer Science and Engineering', 'Indian Institute of Technology Madras']
wang17m_interspeech	['College of Electrical Engineering and Computer Science, National Taiwan University']
yin17_interspeech	['LIMSI, CNRS, Univ. Paris-Sud, Universite Paris-Saclay, F-91405 Orsay, France']
do17c_interspeech	['Toshiba Research Europe', ' Cambridge Science Park, Cambridge, United Kingdom']
fujimoto17_interspeech	['National Institute of Information and Communications Technology, Japan']
papadopoulos17b_interspeech	['University of Southern California, Signal Analysis and Interpretation Lab, USA']
ge17_interspeech	"['The Key Laboratory of Speech Acoustic and Content Understanding, Institute of Acoustics, China', 'School of Electrical and Computer Engineering, Georgia Institute of Technology, GA, USA', ""National Laboratory of Radar Signal Processing, Xidian University, Xi'an, China"", 'Faculty of Computer and Telecommunication Engineering, University of Enna Kore, Enna, Italy']"
tran17c_interspeech	['NTT Communication Science Laboratories, NTT corporation,', '-4, Hikaridai, Seika-cho (Keihana Science City), Soraku-gun, Kyoto 619-0237 Japan']
zhang17l_interspeech	['Key Laboratory of Speech Acoustics and Content Understanding, Institute of Acoustics, China', 'University of Chinese Academy of Sciences, China', 'Xinjiang Laboratory of Minority Speech and Language Information Processing,', 'Xinjiang Technical Institute of Physics and Chemistry, Chinese Academy of Sciences, China']
huang17h_interspeech	['Department of Computer Science and Engineering', 'The Hong Kong University of Science and Technology']
kim17h_interspeech	['Electrical Computer Engineering', 'Carnegie Mellon University']
menon17_interspeech	['Department of Electrical and Computer Engineering, Carnegie Mellon University, Pittsburgh, PA', 'Google, Mountain View, CA']
caroselli17_interspeech	['Google, Inc.']
zihlmann17_interspeech	['Phonetics Laboratory, Department of Comparative Linguistics, University of Zurich, Switzerland']
mcauliffe17b_interspeech	['Department of Linguistics, McGill University, Canada', 'Department of Linguistics, University of Maryland, USA']
hughes17b_interspeech	['Department of Language and Linguistic Science, University of York, UK', 'J P French Associates, York, UK']
arantes17_interspeech	['Languages and Linguistics Department, Sao Carlos Federal University, Brazil', 'Department of Linguistics, Stockholm University, Sweden']
volin17_interspeech	['Institute of Phonetics, Faculty of Arts, Charles University in Prague, Czech Republic', 'Department of Circuit Theory, Faculty of Electrical Engineering, Czech Technical University in', 'Prague, Czech Republic']
plantehebert17_interspeech	['Laboratoire de sciences phonetiques, Universite de Montreal, Montreal, Canada', 'Laboratoire de recherche en electrophysiologie cognitive, Hôpital Riviere-des-Prairies, Montreal,', 'Canada']
cooperleavitt17_interspeech	['LIMSI, CNRS, Universite Paris-Saclay, France', 'LPP, CNRS-Paris 3/Sorbonne Nouvelle, France']
murphy17_interspeech	['Phonetics and Speech Laboratory, School of Linguistic, Speech and Communication Sciences', 'Trinity College Dublin, Ireland']
barbosa17_interspeech	['Instituto de Estudos da Linguagem, University of Campinas, Brazil', 'LIACC, Catholic University of Sao Paulo, Brazil', 'LIMSI, CNRS & Univ. Paris-Saclay, Orsay, France']
gendrot17_interspeech	['Universite Sorbonne-Nouvelle Paris 3 - Laboratoire de Phonetique et Phonologie UMR 7018,', 'FRANCE']
christodoulides17_interspeech	['Centre Valibel, IL&C, Universite catholique de Louvain, Belgium']
levit17_interspeech	['Microsoft, USA']
airaksinen17_interspeech	['Aalto University, Finland']
hantke17b_interspeech	['Chair of Complex & Intelligent Systems, University of Passau, Germany', 'Machine Intelligence & Signal Processing Group, Technische Universit¨at Munchen, Germany', 'Department of Computing, Imperial College London, UK']
henter17_interspeech	['Digital Content and Media Sciences Research Division, National Institute of Informatics, Japan', 'The Centre for Speech Technology Research, the University of Edinburgh, UK']
takamichi17_interspeech	['Graduate School of Information Science and Technology, The University of Tokyo, Japan.', 'Interdisciplinary Graduate School of Science and Engineering, Tokyo Institute of Technology,', 'Japan.']
pollet17_interspeech	['TTS Research dept., Nuance Communications']
cooper17_interspeech	['Columbia University, USA', 'Google, USA']
rosenberg17_interspeech	['IBM Watson, USA']
adiga17b_interspeech	['Department of Electronics and Electrical Engineering', 'Indian Institute of Technology Guwahati, India']
gonzalez17_interspeech	['Department of Computer Science, University of Sheffield, Sheffield, UK', 'School of Engineering, University of Hull, Kingston upon Hull, UK', 'Hull and East Yorkshire Hospitals Trust, Castle Hill Hospital, Cottingham, UK', 'Practical Control Ltd, Sheffield, UK']
greenwood17_interspeech	['School of Computing Sciences', 'University of East Anglia', 'United Kingdom']
wester17_interspeech	['CereProc Ltd., Edinburgh, UK']
blaauw17_interspeech	['Music Technology Group, Universitat Pompeu Fabra, Barcelona, Spain']
wang17n_interspeech	['Jaitly, Zongheng Yang, Ying Xiao∗, Zhifeng Chen, Samy Bengio†, Quoc Le,', 'Yannis Agiomyrgiannakis, Rob Clark, Rif A. Saurous∗', 'Google, Inc.']
capes17_interspeech	['Apple Inc., USA']
esch17_interspeech	['Google, Mountain View, CA, USA', 'Google, New York, NY, USA']
nakashika17b_interspeech	['University of Electro-Communications, Tokyo, Japan', 'National Institute of Informatics, Tokyo, Japan', 'University of Edinburgh, Edinburgh, UK']
zioko17_interspeech	['AGH University of Science and Technology,', 'Department of Computer Science, Electronics and Telecommunications,', 'al. Mickiewicza 30, Krak', '´', 'ow, Poland', 'Techmo, Krakow, Poland, techmo.pl']
arai17b_interspeech	['Department of Information and Communication Sciences', 'Sophia University, Tokyo, Japan']
masudakatsuse17_interspeech	['Kindai University, Japan']
bunnell17_interspeech	['Nemours Biomedical Research, USA']
heeringa17_interspeech	['Fryske Akademy, The Netherlands']
