paper_id	affiliations	author_area_id	author_area_label
pucher21_interspeech	['acoustics research institute (ari), austrian academy of sciences ( ¨oaw), vienna, austria', 'university of applied sciences wiener neustadt, wiener neustadt, austria']	7	Speech Synthesis and Spoken Language Generation
rezackova21_interspeech	['new technologies for the information society and department of cybernetics,', 'faculty of applied sciences, university of west bohemia, pilsen, czech republic']		
perrotin21_interspeech	['univ. grenoble alpes, cnrs, grenoble inp, gipsa-lab, f-38000 grenoble, france']	7	Speech Synthesis and Spoken Language Generation
do21_interspeech	['university of groningen, campus fryslˆan, leeuwarden, the netherlands', 'fryske akademy/mercator research centre, leeuwarden, the netherlands', 'readspeaker, driebergen-rijsenburg, the netherlands']	7	Speech Synthesis and Spoken Language Generation
talkar21_interspeech	['speech and hearing bioscience and technology, harvard university, boston, ma, usa', 'mit lincoln laboratory, lexington, ma, usa', 'walter reed national military medical center, bethesda, md, usa', 'uniformed services university of the health sciences, bethesda, md, usa', 'henry m jackson foundation, rockville, md, usa', 'traumatic brain injury center of excellence, silver spring, md, usa', 'national intrepid center of excellence, bethesda, md, usa', 'centre of excellence on post-traumatic stress disorder, ottawa, on, canada', 'general dynamics information technology, falls church, va, usa', 'university of british columbia, vancouver, bc, canada']	13	Speech, Voice, and Hearing Disorders
vasquezcorrea21_interspeech	['pattern recognition lab. friedrich-alexander universitat, erlangen-nurnberg, germany', 'faculty of engineering. universidad de antioquia udea, calle 70 no. 52-21, medellin, colombia', 'idiap research institute, martigny, switzerland', 'ecole polytechnique federale de lausanne, switzerland']	13	Speech, Voice, and Hearing Disorders
daoudi21_interspeech	['inria bordeaux sud-ouest, geostat team, france', 'ent department, university hospital of bordeaux, france', 'department of neurology for neurodegenerative diseases, university hospital of bordeaux', 'and university of bordeaux, cnrs, imn, umr 5293, france', 'msa reference center, clinical investigation center cic1436,', 'dep. neurosciences & clinical pharmacology, university hospital of toulouse, france', 'voice and deglutition unit , ent department, university hospital of toulouse, france.']	13	Speech, Voice, and Hearing Disorders
wang21_interspeech	['department of electrical engineering-esat, ku leuven, belgium', 'school of mathematics, statistics and computer science, college of science, university of tehran,', 'iran']	13	Speech, Voice, and Hearing Disorders
turrisi21_interspeech	"['italian institute of technology, italy', 'university of ferrara, italy', 'dibris, university of genoa, italy', ""neurology unit, azienda ospedaliera universitaria sant'anna, ferrara, italy"", 'pervoice, italy']"	13	Speech, Voice, and Hearing Disorders
bie21_interspeech	['inria, univ. grenoble alpes, cnrs, ljk', ' grenoble, france.', 'univ. grenoble alpes, cnrs, grenoble-inp, gipsa-lab', ' grenoble, france.', 'centralesupelec, ietr', ' cesson-sevigne, france.']	5	Analysis of Speech and Audio Signals
yurt21_interspeech	['fraunhofer iis, erlangen, germany', 'ws audiology, erlangen, germany', 'chair of multimedia communications and signal processing, friedrich-alexander-universitat', 'erlangen-nurnberg, erlangen, germany']	5	Analysis of Speech and Audio Signals
prasad21_interspeech	['idiap research institute, martigny ch-1920, switzerland']	5	Analysis of Speech and Audio Signals
teytaut21_interspeech	['stms lab, umr 9912 (ircam, cnrs, sorbonne university), paris, france']	5	Analysis of Speech and Audio Signals
kim21_interspeech	['school of mechanical engineering, korea advanced institute of science and technology']	4	Speaker and Language Identification
qi21_interspeech	['national engineering laboratory for speech and language information processing,', 'university of science and technology of china, hefei, china']	4	Speaker and Language Identification
zhang21_interspeech	['national sun yat-sen university, taiwan', 'chunghwa telecom laboratories, taiwan']	4	Speaker and Language Identification
wu21_interspeech	['college of artificial intelligence, nankai university, tianjin, china', 'college of computer science, nankai university, tianjin, china']	4	Speaker and Language Identification
zhu21_interspeech	['data science research center, duke kunshan university, kunshan, china', 'school of computer science, wuhan university, wuhan, china']	4	Speaker and Language Identification
tu21_interspeech	['department of electronic and information engineering, the hong kong polytechnic university,', 'hong kong sar, china']	4	Speaker and Language Identification
zhu21b_interspeech	['university of rochester, rochester, ny, usa', 'beijing institute of technology, beijing, china']	4	Speaker and Language Identification
liu21_interspeech	['school of electronic science and engineering, xiamen university, china', 'school of informatics, xiamen university, china']	4	Speaker and Language Identification
zhu21c_interspeech	['school of computing, national university of singapore, singapore', 'department of electrical and computer engineering, national university of singapore, singapore', 'institute for infocomm research, a⋆star, singapore']	4	Speaker and Language Identification
gong21_interspeech	['tianjin key laboratory of cognitive computing and application,', 'college of intelligence and computing, tianjin university, tianjin, china', 'huiyan technology (tianjin) co., ltd, tianjin, china', 'japan advanced institute of science and technology, ishikawa, japan']	7	Speech Synthesis and Spoken Language Generation
bak21_interspeech	['speech ai lab, ncsoft, republic of korea']	7	Speech Synthesis and Spoken Language Generation
nakamura21_interspeech	['graduate school of information science and technology, the university of tokyo, japan']	7	Speech Synthesis and Spoken Language Generation
kakegawa21_interspeech	['the graduate school of interdisciplinary science and engineering', 'in health systems, okayama university, japan', 'ntt coporation, japan']		
dai21_interspeech	['tianjin key laboratory of cognitive computing and application,', 'college of intelligence and computing, tianjin university, tianjin, china', 'tianjin university-huiyan technology joint ai lab, tianjin university, tianjin, china']	7	Speech Synthesis and Spoken Language Generation
dou21_interspeech	['university of cambridge, united kingdom']	7	Speech Synthesis and Spoken Language Generation
elias21_interspeech	['google, israel', 'google, japan', 'google, usa']	7	Speech Synthesis and Spoken Language Generation
wu21b_interspeech	['facebook ai, usa']	7	Speech Synthesis and Spoken Language Generation
jia21_interspeech	['google research, usa', 'google research, japan']	7	Speech Synthesis and Spoken Language Generation
ge21_interspeech	['sony interactive entertainment llc, san mateo, california, usa']	7	Speech Synthesis and Spoken Language Generation
sun21_interspeech	['hertz lab, oppo research institute, beijing, china']	6	Speech Coding and Enhancement
zhang21b_interspeech	['department of electrical and computer engineering, national university of singapore, singapore', 'alibaba group, china', 'australian ehealth research centre, csiro, herston, qld', ', australia']	6	Speech Coding and Enhancement
pan21_interspeech	"['department of electrical and electronic engineering, southern university of science and', 'technology, shenzhen, china', ""department of stomatology, shenzhen second people's hospital, the first affiliated hospital of"", 'shenzhen university, shenzhen, china']"	6	Speech Coding and Enhancement
biswas21_interspeech	['indian institute of technology jammu, india', 'indraprastha institute of information technology delhi, india']	6	Speech Coding and Enhancement
yamamoto21_interspeech	['graduate school of systems engineering, wakayama university, japan', 'ntt communication science laboratories, japan']	6	Speech Coding and Enhancement
liu21b_interspeech	['key laboratory of noise and vibration research, institute of acoustics, chinese academy of', 'sciences, beijing, china', 'university of chinese academy of sciences, beijing, china']	6	Speech Coding and Enhancement
kong21_interspeech	['bytedance, shanghai, china']	6	Speech Coding and Enhancement
hsieh21_interspeech	['research center for information technology innovation, academia sinica, taiwan', 'national institute of information and communications technology, japan']	6	Speech Coding and Enhancement
fu21_interspeech	['research center for information technology innovation, academia sinica, taipei, taiwan', 'the ohio state university, columbus, oh, usa', 'mila-quebec ai institute, montreal, canada', 'national institute of information and communications technology, kyoto, japan']	6	Speech Coding and Enhancement
edraki21_interspeech	"[""department of electrical and computer engineering, queen's university, kingston, canada"", 'department of electronic systems, aalborg university, aalborg, denmark', 'oticon a/s, smoerum, denmark', 'department of speech and hearing science, university of illinois at urbana-champaign,', 'champaign, illinois, usa']"	6	Speech Coding and Enhancement
qiu21_interspeech	['school of natural and computational sciences, massey university, new zealand']	6	Speech Coding and Enhancement
nayem21_interspeech	['department of computer science, indiana university, usa']	6	Speech Coding and Enhancement
zhang21c_interspeech	['arizona state university, usa']	6	Speech Coding and Enhancement
nguyen21_interspeech	['apple', ' apple park way', 'cupertino, california, usa']	11	Spoken Dialog Systems and Conversational Analysis
chen21_interspeech	['adsplab, school of ece, peking university, shenzhen, china', 'department of electrical engineering, yale university, ct, usa', 'peng cheng laboratory, shenzhen, china']	11	Spoken Dialog Systems and Conversational Analysis
su21_interspeech	['georgia institute of technology, usa']	11	Spoken Dialog Systems and Conversational Analysis
chiba21_interspeech	['ntt communication science laboratories, japan', 'graduate school of informatics, nagoya university, japan']	11	Spoken Dialog Systems and Conversational Analysis
yamazaki21_interspeech	['graduate school of engineering, tohoku university, japan', 'ntt communication science laboratories, japan']	11	Spoken Dialog Systems and Conversational Analysis
xu21_interspeech	['adsplab, school of ece, peking university, shenzhen, china', 'peng cheng laboratory, shenzhen, china', 'department of electrical engineering, yale university, ct, usa']	11	Spoken Dialog Systems and Conversational Analysis
tang21_interspeech	['tianjin key laboratory of cognitive computing and application,', 'college of intelligence and computing, tianjin university, tianjin, china', 'tianjin university-huiyan technology joint ai lab, tianjin university, tianjin, china', 'japan advanced institute of science and technology, ishikawa, japan']	11	Spoken Dialog Systems and Conversational Analysis
wang21b_interspeech	['amazon alexa, usa', 'university of toronto, canada', 'amazon alexa, canada']	11	Spoken Dialog Systems and Conversational Analysis
zhang21d_interspeech	['school of artificial intelligence, university of chinese academy of sciences, china', 'nlpr, institute of automation, chinese academy of sciences, china', 'cas center for excellence in brain science and intelligence technology, china']	8	Speech Recognition: Signal Processing, Acoustic Modeling, Robustness, Adaptation
siminyu21_interspeech		8	Speech Recognition: Signal Processing, Acoustic Modeling, Robustness, Adaptation
loweimi21_interspeech	"['centre for speech technology research (cstr), university of edinburgh, uk', ""department of engineering, king's college london, uk""]"	8	Speech Recognition: Signal Processing, Acoustic Modeling, Robustness, Adaptation
fujimoto21_interspeech	['national institute of information and communications technology, japan']	8	Speech Recognition: Signal Processing, Acoustic Modeling, Robustness, Adaptation
ratnarajah21_interspeech	['university of maryland, college park, md 20742, usa']	8	Speech Recognition: Signal Processing, Acoustic Modeling, Robustness, Adaptation
chen21b_interspeech	['ciaic, school of marine science and technology, northwestern polytechnical university, china']	8	Speech Recognition: Signal Processing, Acoustic Modeling, Robustness, Adaptation
chang21_interspeech	['alexa machine learning, amazon, usa']	8	Speech Recognition: Signal Processing, Acoustic Modeling, Robustness, Adaptation
tsunoo21_interspeech	['sony corporation, japan', 'carnegie mellon university, usa']	8	Speech Recognition: Signal Processing, Acoustic Modeling, Robustness, Adaptation
ma21_interspeech	['school of information science and engineering, xinjiang university, urumqi, china', 'tencent minority-mandarin translation, beijing, china']	8	Speech Recognition: Signal Processing, Acoustic Modeling, Robustness, Adaptation
likhomanenko21_interspeech	['facebook ai research, usa', 'facebook ai research, france']	8	Speech Recognition: Signal Processing, Acoustic Modeling, Robustness, Adaptation
lam21_interspeech	['tencent ai lab, shenzhen, china', 'tencent ai lab, bellevue wa, usa']	8	Speech Recognition: Signal Processing, Acoustic Modeling, Robustness, Adaptation
hou21_interspeech	['ghent university, belgium', 'bytedance ai lab, china']	5	Analysis of Speech and Audio Signals
kim21b_interspeech	['corporate research and development center, toshiba corporation, japan']	5	Analysis of Speech and Audio Signals
park21_interspeech	['google inc., usa']	5	Analysis of Speech and Audio Signals
ichikawa21_interspeech	['shiga university, japan', 'the university of tokyo, japan', 'national institute for educational policy research, japan']	5	Analysis of Speech and Audio Signals
zhou21_interspeech	['university of science and technology of china, hefei, anhui, p r. china', 'iflytek research, hefei, anhui, p.r.china', 'georgia institute of technology, atlanta, ga. usa']	5	Analysis of Speech and Audio Signals
makishima21_interspeech	['ntt media intelligence laboratories, ntt corporation, japan']	5	Analysis of Speech and Audio Signals
nonaka21_interspeech	['graduate school of medicine, engineering, and agricultural sciences,', 'university of yamanashi, japan', 'faculty of industrial technology, tsukuba university of technology, japan', 'faculty of engineering, information and systems, university of tsukuba, japan']		
kwon21_interspeech	['university of cambridge, uk', 'university of southampton, uk']	5	Analysis of Speech and Audio Signals
wei21_interspeech	"[', sung-un park 2', ""samsung r&d institute china xi'an, china"", 'samsung advanced institute of technology, republic of korea']"	5	Analysis of Speech and Audio Signals
bhati21_interspeech	['†', '‡']	5	Analysis of Speech and Audio Signals
xu21b_interspeech	['moe key lab of artificial intelligence', 'x-lance lab, department of computer science and engineering', 'ai institute, shanghai jiao tong university, shanghai, china', 'xiaomi corporation, beijing, china']	5	Analysis of Speech and Audio Signals
chlebowski21_interspeech	['universite de paris, clillac-arp, f-75013 paris, france']		
wang21c_interspeech	['department of language and linguistic science, university of york, uk']	2	Phonetics, Phonology, and Prosody
bonneau21_interspeech	['universite de lorraine, cnrs, inria, loria, f-54000 nancy, france']	2	Phonetics, Phonology, and Prosody
chakraborty21_interspeech	['department of electrical engineering, indian institute of technology bombay, india', 'international institute of information technology, pune, india']	2	Phonetics, Phonology, and Prosody
urooj21_interspeech	['center for language engineering, university of engineering and technology, pakistan', 'university of konstanz, germany']	2	Phonetics, Phonology, and Prosody
tamim21_interspeech	['university of amsterdam, the netherlands']	2	Phonetics, Phonology, and Prosody
coy21_interspeech	['department of language and linguistic science, university of york. uk']		
jessen21_interspeech	['bundeskriminalamt, germany']	2	Phonetics, Phonology, and Prosody
lo21_interspeech	['department of language and linguistic science, university of york, uk']	2	Phonetics, Phonology, and Prosody
soo21_interspeech	['department of linguistics, university of british columbia, canada']	2	Phonetics, Phonology, and Prosody
lalhminghlui21_interspeech		2	Phonetics, Phonology, and Prosody
schuller21_interspeech	['glam – group on language, audio & music, imperial college london, uk', 'eihw – chair of embedded intelligence for health care and wellbeing, university of augsburg, germany', 'pattern recognition lab, fau erlangen-nuremberg, germany', 'university of cambridge, uk', 'delft university of technology, the netherlands', 'faculty of science, utrecht university, the netherlands']		
soleraurena21_interspeech	['inesc-id, lisbon, portugal', 'instituto superior tecnico, university of lisbon (ist-ul), portugal']	3	Paralinguistics in Speech and Language: Human and Automatic Analysis and Processing
klumpp21_interspeech	['pattern recognition lab, friedrich-alexander-universitat, erlangen-nurnberg, germany', 'technische hochschule georg simon ohm, nurnberg, germany', 'faculty of engineering, universidad de antioquia udea, calle 70 no. 52-21, medellin, colombia', 'department of otorhinolaryngology, head and neck surgery. ludwig-maximilians university,', 'munich, germany']	3	Paralinguistics in Speech and Language: Human and Automatic Analysis and Processing
casanova21_interspeech	['instituto de ciencias matematicas e de computacao, university of sao paulo, brazil', 'federal university of technology – parana, brazil', 'dept. of computer science, institute of mathematics and statistics, university of sao paulo, brazil']	3	Paralinguistics in Speech and Language: Human and Automatic Analysis and Processing
illium21_interspeech	['mobile and distributed systems group,', 'lmu munich']		
pellegrini21_interspeech	['irit, universite paul sabatier, cnrs, toulouse, france']	3	Paralinguistics in Speech and Language: Human and Automatic Analysis and Processing
muller21_interspeech	['mobile and distributed systems group,', 'lmu munich', 'germany']	3	Paralinguistics in Speech and Language: Human and Automatic Analysis and Processing
zwerts21_interspeech	['department of biology, utrecht university, utrecht, the netherlands', 'information and technology services, utrecht university, utrecht, the netherlands', 'department of information and computing sciences, utrecht university, utrecht, the netherlands']	3	Paralinguistics in Speech and Language: Human and Automatic Analysis and Processing
rizos21_interspeech	['glam – group on language, audio, & music, imperial college london, uk', 'department of life sciences, imperial college london, uk', 'matchlab – department of electrical and electronic engineering, imperial college london, uk', 'eihw – chair of embedded intelligence for health care and wellbeing, university of augsburg,', 'germany']	5	Analysis of Speech and Audio Signals
egaslopez21_interspeech	['institute of informatics, university of szeged, hungary', 'mta-szte research group on artificial intelligence, elrn, szeged, hungary']	3	Paralinguistics in Speech and Language: Human and Automatic Analysis and Processing
verkholyak21_interspeech	['st. petersburg institute for informatics and automation of the russian academy of sciences,', 'st. petersburg federal research center of the russian academy of sciences (spc ras), russia', 'ulm university, ulm, germany', 'itmo university, st. petersburg, russia']	3	Paralinguistics in Speech and Language: Human and Automatic Analysis and Processing
schiller21_interspeech	['human-centered artificial intelligence, augsburg, germany', 'max-planck-institute for empirical aesthetics, frankfurt, germany']	3	Paralinguistics in Speech and Language: Human and Automatic Analysis and Processing
luu21_interspeech	['centre for speech technology research, university of edinburgh, uk']	4	Speaker and Language Identification
rybicka21_interspeech	['agh university of science and technology, institute of electronics, krakow, poland', 'center for language and speech processing, johns hopkins university, baltimore, usa', 'human language technology center of excellence, johns hopkins university, baltimore, usa']	4	Speaker and Language Identification
stafylakis21_interspeech	['omilia - conversational intelligence, athens, greece']	4	Speaker and Language Identification
he21_interspeech	['idiap research institute, switzerland', 'ecole polytechnique federale de lausanne (epfl), switzerland']	4	Speaker and Language Identification
peng21_interspeech	['ping an technology (shenzhen) co., ltd., china', 'peking university, shenzhen graduate school, china']	4	Speaker and Language Identification
xiao21_interspeech	['lpp, sorbonne nouvelle, france', 'lam, sorbonne universite, france']		
block21_interspeech	['phonetics lab, university of california, davis, usa']	1	Speech Perception, Production and Acquisition  by Human Listeners
monesi21_interspeech	[', bernd accou', ', tom francart', ',2', ',2', ', hugo van hamme 1', 'ku leuven, psi, dept. of electrical engineering (esat), leuven, belgium', 'ku leuven, exporl, dept. neurosciences, leuven, belgium']	1	Speech Perception, Production and Acquisition  by Human Listeners
bosch21_interspeech	['centre for language studies, radboud university, nijmegen, the netherlands']	1	Speech Perception, Production and Acquisition  by Human Listeners
bosch21b_interspeech	['centre for language studies, radboud university, nijmegen, the netherlands']	1	Speech Perception, Production and Acquisition  by Human Listeners
brand21_interspeech	['hotel management school maastricht, the netherlands', 'utrecht university, the netherlands', 'centre for language studies, radboud university, nijmegen, the netherlands']	1	Speech Perception, Production and Acquisition  by Human Listeners
kim21c_interspeech	['korea university, south korea', 'drexel university, usa']	5	Analysis of Speech and Audio Signals
wang21d_interspeech	['adsplab, school of ece, peking university, shenzhen, china', 'peng cheng laboratory, shenzhen, china', 'center for vision, speech and signal processing, university of surrey, uk']	5	Analysis of Speech and Audio Signals
zheng21_interspeech	['national engineering laboratory for speech and language information processing,', 'university of science and technology of china, hefei, china', 'ict cluster, singapore institute of technology, singapore', 'iflytek research, iflytek co., ltd, hefei, china']	5	Analysis of Speech and Audio Signals
nandi21_interspeech	['department of computer science and engineering, manipal institute of technology,', 'manipal academy of higher education, manipal', ' 104, india', 'department of electronics and communication engineering, manipal institute of technology,', 'manipal academy of higher education, manipal', ' 104, india']	5	Analysis of Speech and Audio Signals
sundar21_interspeech	['amazon.com inc., cambridge, massachusetts, united states']	5	Analysis of Speech and Audio Signals
gong21b_interspeech	['mit computer science and artificial intelligence laboratory, cambridge, ma 02139, usa']	5	Analysis of Speech and Audio Signals
seo21_interspeech	['dept. of computer science and engineering, sogang university, seoul, republic of korea']	5	Analysis of Speech and Audio Signals
bear21_interspeech	['centre for digital music, queen mary university of london, london, uk', 'the alan turing institute, london, uk']	5	Analysis of Speech and Audio Signals
hori21_interspeech	['mitsubishi electric research laboratories (merl), cambridge, ma, usa']		
si21_interspeech	['ping an technology (shenzhen) co., ltd., shenzhen, china', 'hong kong university of science and technology, hong kong, china', 'university of science and technology of china, hefei, china']	5	Analysis of Speech and Audio Signals
deshmukh21_interspeech		5	Analysis of Speech and Audio Signals
komatsu21_interspeech	['line corporation, japan', 'carnegie mellon university, usa', 'nagoya university, japan', 'human dataware lab. co., ltd., japan']	5	Analysis of Speech and Audio Signals
tseng21_interspeech	['institute of linguistics, academia sinica, taiwan', 'department of information engineering and computer science, feng-chia university, taiwan']	13	Speech, Voice, and Hearing Disorders
wang21e_interspeech	['department of electrical and electronic engineering, southern university of science and', 'technology, shenzhen, china', 'department of machine intelligence, speech and hearing research center, and key laboratory of', 'machine perception (ministry of education), peking university, beijing, china', 'peng cheng laboratory, shenzhen, china']	13	Speech, Voice, and Hearing Disorders
sharma21_interspeech	['electrical engineering, indian institute of science, bengaluru', ', india', 'centre for neuroscience, indian institute of science, bengaluru', ', india']		
abraham21_interspeech	['all india institute of speech and hearing, mysuru, india']	13	Speech, Voice, and Hearing Disorders
wang21f_interspeech	['college of intelligence and computing, tianjin university, tianjin, china', 'tianjin international engineering institute, tianjin university, tianjin, china', 'institute of linguistics, chinese academy of social science, beijing, china', 'shenzhen research institute of big data, the chinese university of hong kong, shenzhen, china']	13	Speech, Voice, and Hearing Disorders
dineley21_interspeech	"['chair of embedded intelligence for health care and wellbeing, university of augsburg, germany', ""institute of psychiatry, psychology and neuroscience, king's college london, london, uk"", 'parc sanitari sant joan de deu, fundacio sant joan de deu, cibersam, barcelona, spain', 'centro de salud bartomeu fabres anglada, gava, idiap jordi gol, spain', ""radar-cns patient advisory board, king's college london, uk"", 'institute of health informatics, university college london, london, uk', 'south london and maudsley national health services foundation trust, london, uk', 'janssen research and development llc, titusville, nj, united states', 'glam - group on language, audio, & music, imperial college london, london, uk', 'www.radar-cns.org']"	13	Speech, Voice, and Hearing Disorders
li21_interspeech	['biomedical engineering, university of cincinnati, usa', 'psychology, university of cincinnati, usa', 'communication sciences and disorders, university of cincinnati, usa']	13	Speech, Voice, and Hearing Disorders
ribeiro21_interspeech	['the centre for speech technology research, university of edinburgh, uk']	13	Speech, Voice, and Hearing Disorders
ferreira21_interspeech	['dep. electronics telec. & informatics, university of aveiro, aveiro, portugal', 'institute of electronics and informatics engineering of aveiro (ieeta), portugal']	13	Speech, Voice, and Hearing Disorders
cao21_interspeech	['department of electrical and computer engineering, university of texas at austin, usa', 'department of neurology, dell medical school, university of texas at austin, usa', 'school of electrical and computer engineering, georgia institute of technology, atlanta, usa', 'department of speech, language, and hearing sciences, university of arizona, usa', 'department of otolaryngology, ut southwestern medical center, usa', 'department of speech, language, and hearing sciences, university of texas at austin, usa']	13	Speech, Voice, and Hearing Disorders
schroter21_interspeech	['friedrich-alexander-universitat erlangen-nurnberg, pattern recognition lab, germany', 'sivantos gmbh, research and development, erlangen, germany']	6	Speech Coding and Enhancement
fontaine21_interspeech	[', kazuyoshi yoshii', 'aip, riken, tokyo, japan', 'graduate school of informatics, kyoto university, kyoto, japan', 'national institute of advanced industrial science and technology (aist), tokyo, japan']	6	Speech Coding and Enhancement
zhang21e_interspeech	['school of engineering, westlake university, hangzhou, china', 'institute of advanced technology, westlake institute for advanced study, hangzhou, china']	6	Speech Coding and Enhancement
song21_interspeech	['school of electrical engineering and computer science,', 'gwangju institute of science and technology, gwangju, republic of korea']	6	Speech Coding and Enhancement
zarazaga21_interspeech	['department of signal processing and acoustics, aalto university, espoo, finland', 'siti lab, national engineering school of tunis, el manar university, tunis, tunisia']	6	Speech Coding and Enhancement
zhang21f_interspeech	['department of computer science and engineering, the ohio state university, usa', 'center for cognitive and brain sciences, the ohio state university, usa']	6	Speech Coding and Enhancement
graetzer21_interspeech	['acoustics research group, university of salford, uk', 'department of computer science, university of sheffield, uk', 'school of medicine, university of nottingham, uk', 'school of psychology, cardiff university, uk']	6	Speech Coding and Enhancement
tu21b_interspeech	['university of sheffield, department of computer science, sheffield, uk']	6	Speech Coding and Enhancement
sivasankaran21_interspeech	['microsoft, one microsoft way, redmond, wa, usa', 'universite de lorraine, cnrs, inria, loria, f-54000 nancy, france.']	6	Speech Coding and Enhancement
huang21_interspeech		6	Speech Coding and Enhancement
cao21b_interspeech	['tencent cloud xiaowei, beijing, china']	8	Speech Recognition: Signal Processing, Acoustic Modeling, Robustness, Adaptation
sadhu21_interspeech	['johns hopkins university, usa', 'amazon alexa, usa']	8	Speech Recognition: Signal Processing, Acoustic Modeling, Robustness, Adaptation
wallington21_interspeech	['centre for speech technology research, university of edinburgh, united kingdom']	8	Speech Recognition: Signal Processing, Acoustic Modeling, Robustness, Adaptation
hsu21_interspeech	['facebook ai, usa', 'facebook ai, france']	8	Speech Recognition: Signal Processing, Acoustic Modeling, Robustness, Adaptation
higuchi21_interspeech	['mitsubishi electric research laboratories (merl), usa', 'waseda university, japan']	8	Speech Recognition: Signal Processing, Acoustic Modeling, Robustness, Adaptation
misra21_interspeech	['google llc, usa']	8	Speech Recognition: Signal Processing, Acoustic Modeling, Robustness, Adaptation
chen21c_interspeech		8	Speech Recognition: Signal Processing, Acoustic Modeling, Robustness, Adaptation
likhomanenko21b_interspeech	['facebook ai research, usa', 'facebook ai research, france']	8	Speech Recognition: Signal Processing, Acoustic Modeling, Robustness, Adaptation
yue21_interspeech	['department of electrical and computer engineering, national university of singapore, singapore']	8	Speech Recognition: Signal Processing, Acoustic Modeling, Robustness, Adaptation
deng21_interspeech	['microsoft, china', 'microsoft, usa']	8	Speech Recognition: Signal Processing, Acoustic Modeling, Robustness, Adaptation
seyfarth21_interspeech	['amazon aws ai, usa']	12	Spoken Language Processing: Translation, Information Retrieval, Summarization, Resources and Evaluation
mcgowan21_interspeech	['alexa machine learning, amazon.com, usa']	12	Spoken Language Processing: Translation, Information Retrieval, Summarization, Resources and Evaluation
rocholl21_interspeech	['google research, usa']	12	Spoken Language Processing: Translation, Information Retrieval, Summarization, Resources and Evaluation
chen21d_interspeech	['speech lab, alibaba group, china']	12	Spoken Language Processing: Translation, Information Retrieval, Summarization, Resources and Evaluation
ihori21_interspeech	['ntt media intelligence laboratories, ntt corporation, japan']	12	Spoken Language Processing: Translation, Information Retrieval, Summarization, Resources and Evaluation
lin21_interspeech	['⋆smart platform product department, tencent technology co., ltd, china']	12	Spoken Language Processing: Translation, Information Retrieval, Summarization, Resources and Evaluation
wintrode21_interspeech	['raytheon applied signal technology, usa']	12	Spoken Language Processing: Translation, Information Retrieval, Summarization, Resources and Evaluation
palaskar21_interspeech	['carnegie mellon university, usa', 'facebook ai, usa']	12	Spoken Language Processing: Translation, Information Retrieval, Summarization, Resources and Evaluation
lee21_interspeech	['ai research center, samsung sds, south korea']	12	Spoken Language Processing: Translation, Information Retrieval, Summarization, Resources and Evaluation
wodarczak21_interspeech	['stockholm university, sweden', 'trinity college dublin, ireland']	11	Spoken Dialog Systems and Conversational Analysis
broughton21_interspeech	['school of computing, national university of singapore, singapore', 'department of computer science, university of sheffield, uk']	7	Speech Synthesis and Spoken Language Generation
zhou21b_interspeech	['∗department of ece, national university of singapore (nus), singapore', '†singapore university of technology and design (sutd), singapore']	7	Speech Synthesis and Spoken Language Generation
ding21_interspeech	['national engineering laboratory for speech and language information processing,', 'university of science and technology of china, hefei, p.r.china', 'iflytek research, iflytek co. ltd., hefei, p.r.china']	7	Speech Synthesis and Spoken Language Generation
he21b_interspeech	['glam – group on language, audio, & music, imperial college london, uk', 'department of computer science, the university of tokyo, japan', 'chair of embedded intelligence for health care and wellbeing, university of augsburg, germany']	7	Speech Synthesis and Spoken Language Generation
chen21e_interspeech	['key laboratory of speech acoustics & content understanding, institute of acoustics, cas, china', 'university of chinese academy of sciences, beijing, china']	7	Speech Synthesis and Spoken Language Generation
wang21g_interspeech		7	Speech Synthesis and Spoken Language Generation
lin21b_interspeech	['college of electrical engineering and computer science, national taiwan university, taiwan', 'r08922048,', 'r08922080,']	7	Speech Synthesis and Spoken Language Generation
liberatore21_interspeech	['texas a&m university, college station, texas, usa']	7	Speech Synthesis and Spoken Language Generation
wang21h_interspeech	['shenzhen international graduate school, tsinghua university, shenzhen, china', 'huya inc., guangzhou, china', 'the chinese university of hong kong, hong kong sar, china']	7	Speech Synthesis and Spoken Language Generation
luong21_interspeech	['vinai research, hanoi, vietnam', 'deezer research and development, paris, france']	7	Speech Synthesis and Spoken Language Generation
chouchane21_interspeech	['security protocols and applied cryptography, eurecom, france', 'audio, security and privacy, eurecom, france']	6	Speech Coding and Enhancement
aloufi21_interspeech	['imperial college london, uk']	6	Speech Coding and Enhancement
novotney21_interspeech	['amazon alexa, usa']	6	Speech Coding and Enhancement
ro21_interspeech	['google inc., u.s.a.', 'courant institute of mathematical sciences, u.s.a.']	6	Speech Coding and Enhancement
koppelmann21_interspeech	['institute of communication acoustics, ruhr-universitat bochum, bochum, germany']	6	Speech Coding and Enhancement
yang21_interspeech	['georgia institute of technology, atlanta, ga, usa', 'faculty of computer and telecommunication engineering, university of enna, italy', 'department of electronic systems, ntnu, trondheim, norway']	6	Speech Coding and Enhancement
ma21b_interspeech	['nlpr, institute of automation, chinese academy of sciences, china', 'school of artificial intelligence, university of chinese academy of sciences, china']	6	Speech Coding and Enhancement
shah21_interspeech	['alexa machine learning, amazon, usa']	6	Speech Coding and Enhancement
fazel21_interspeech	['amazon alexa, usa', 'amazon alexa, uk']	6	Speech Coding and Enhancement
muguli21_interspeech	['†indian institute of science, bangalore, india', '‡p. d hinduja hospital, mumbai, india', '∓kmc hospital, mangalore, india']	13	Speech, Voice, and Hearing Disorders
kamble21_interspeech	['eurecom, france', 'university of granada, spain', 'biometric vox s.l., spain']	3	Paralinguistics in Speech and Language: Human and Automatic Analysis and Processing
karas21_interspeech	['eihw–chair for embedded intelligence for healthcare and wellbeing, university of augsburg,', 'germany', 'glam–group on language, audio and music, imperial college london, uk']	3	Paralinguistics in Speech and Language: Human and Automatic Analysis and Processing
sodergren21_interspeech	['digital services and systems, lulea university of technology, lulea, sweden', 'eislab machine learning, lulea university of technology, lulea, sweden']	3	Paralinguistics in Speech and Language: Human and Automatic Analysis and Processing
das21_interspeech	['department of electrical and computer engineering', 'national university of singapore, singapore']	3	Paralinguistics in Speech and Language: Human and Automatic Analysis and Processing
harvill21_interspeech	['university of illinois at urbana-champaign, united states', 'university of chicago, united states', 'university of illinois at chicago, united states']	3	Paralinguistics in Speech and Language: Human and Automatic Analysis and Processing
deshpande21_interspeech	['tcs research pune, india', 'chair of embedded intelligence for health care and wellbeing, university of augsburg, germany', 'glam – group on language, audio, & music, imperial college london, uk']	3	Paralinguistics in Speech and Language: Human and Automatic Analysis and Processing
ritwik21_interspeech		3	Paralinguistics in Speech and Language: Human and Automatic Analysis and Processing
mallolragolta21_interspeech	['eihw – chair of embedded intelligence for health care & wellbeing, university of augsburg, germany', 'mtg – music technology group, universitat pompeu fabra, spain', 'joint research centre, european commission, spain', 'glam – group on language, audio & music, imperial college london, uk']	3	Paralinguistics in Speech and Language: Human and Automatic Analysis and Processing
bhosale21_interspeech	['tcs research, tata consultancy services limited, mumbai, india']	3	Paralinguistics in Speech and Language: Human and Automatic Analysis and Processing
avila21_interspeech	['†verisk analytics, inc., jersey city, nj, usa', '‡leap lab, indian institute of science, bangalore, india']		
kiss21_interspeech	['budapest university of technology and economics, budapest, hungary']		
weingartova21_interspeech	['newton technologies, prague, czech republic']		
arai21_interspeech	['sophia university, tokyo, japan']		
fabien21_interspeech	['idiap research institute, martigny, switzerland', 'ecole polytechnique federale de lausanne, switzerland', 'saarland university, saarland informatics campus, germany', 'l3s research center, leibniz university hannover, germany']		
flucha21_interspeech	['lium - ea4023, le mans universite', 'avenue olivier messiaen', ' le mans cedex 9, france']		
oh21_interspeech	['artificial intelligence research laboratory, etri, daejeon, republic of korea']		
cmejla21_interspeech	['faculty of mechatronics, informatics, and interdisciplinary studies', 'technical university of liberec, czech republic']		
chorowski21_interspeech	['university of wroclaw, poland', 'navalgo, france', 'nvidia, poland', 'universite de toulon, aix marseille univ, cnrs, lis, france']	10	Speech Recognition: Technologies and Systems for New Applications
chorowski21b_interspeech	['university of wroclaw, poland', 'navalgo, france', 'nvidia, poland', 'universite de toulon, aix marseille univ, cnrs, lis, france']	10	Speech Recognition: Technologies and Systems for New Applications
suter21_interspeech	['spitch, switzerland']	10	Speech Recognition: Technologies and Systems for New Applications
joglekar21_interspeech	['center for robust speech systems (crss), eric jonsson school of engineering,', 'the university of texas at dallas (utd), richardson, texas, usa', 'nist itl/iad/mig, gaithersburg md, usa', 'linguistic data consortium, university of pennsylvania, philadelphia, pa, usa']	10	Speech Recognition: Technologies and Systems for New Applications
leykum21_interspeech	['acoustics research institute, austrian academy of sciences, vienna, austria']	2	Phonetics, Phonology, and Prosody
hutin21_interspeech	['universite paris-saclay, cnrs, lisn', ', orsay, france', 'universite paris 3 sorbonne nouvelle, cnrs, umr 7018, lpp', ' rue des bernardins', 'paris, france', 'universite de lille, cnrs, umr 8163, stl, lille, france']	2	Phonetics, Phonology, and Prosody
kraljevski21_interspeech	"['fraunhofer ikts, fraunhofer institute for ceramic technologies and systems, dresden, germany', ""dipartimento di scienze umane e dell'innovazione per il territorio (disuit),"", ""universita degli studi dell'insubria, como, italy"", 'chair of communications engineering, brandenburg university of technology (btu)', 'cottbus-senftenberg, cottbus, germany']"	2	Phonetics, Phonology, and Prosody
ludusan21_interspeech	['phonetics workgroup, faculty of linguistics and literary studies & citec,', 'bielefeld university, germany', 'department of linguistics, stockholm university, sweden']	2	Phonetics, Phonology, and Prosody
rodriguez21_interspeech	['univ. grenoble alpes, cnrs, grenoble inp, gipsa-lab', ' grenoble, france']	2	Phonetics, Phonology, and Prosody
chanclu21_interspeech	"[""laboratoire informatique d'avignon, ea 4128, avignon universite, france"", 'laboratoire de phonetique et phonologie, umr7018, cnrs - sorbonne nouvelle, france']"	2	Phonetics, Phonology, and Prosody
son21_interspeech	['netherlands cancer institute, amsterdam, the netherlands', 'aclc, university of amsterdam, the netherlands']	3	Paralinguistics in Speech and Language: Human and Automatic Analysis and Processing
steinert21_interspeech	['cognitive systems lab, university of bremen, germany']	3	Paralinguistics in Speech and Language: Human and Automatic Analysis and Processing
hecker21_interspeech	['audeering gmbh, gilching, germany', 'digital health – connected healthcare, hasso plattner institute, university of potsdam, germany', 'eihw – chair of embedded intelligence for health care and wellbeing,', 'university of augsburg, germany', 'division of phoniatrics, medical university of graz, austria', 'glam – group on language, audio, & music, imperial college london, uk']	3	Paralinguistics in Speech and Language: Human and Automatic Analysis and Processing
nguyen21b_interspeech		3	Paralinguistics in Speech and Language: Human and Automatic Analysis and Processing
borgstrom21_interspeech	['mit lincoln laboratory, usa']	4	Speaker and Language Identification
wang21i_interspeech	['data science research center, duke kunshan university, kunshan, china', 'ai lab, lenovo research, beijing, china']	4	Speaker and Language Identification
chen21f_interspeech	['national engineering laboratory for speech and language information processing, university of', 'science and technology of china, hefei, china']	4	Speaker and Language Identification
wang21j_interspeech		4	Speaker and Language Identification
brummer21_interspeech	['phonexia, south africa', 'instituto de investigacion en ciencias de la computacion, conicet-uba, argentina']	4	Speaker and Language Identification
chojnacka21_interspeech			
wang21k_interspeech	['ant group, shanghai, china']	4	Speaker and Language Identification
li21b_interspeech	['school of computer science and technology, harbin institute of technology, harbin, china']	4	Speaker and Language Identification
kataria21_interspeech	['center for language and speech processing, human language technology center of excellence,', 'johns hopkins university, baltimore, md, usa']	4	Speaker and Language Identification
pu21_interspeech	['department of engineering, university of cambridge, uk', 'amazon alexa, california, usa']	4	Speaker and Language Identification
wu21c_interspeech	['tianjin key laboratory of cognitive computing and application, college of intelligence and', 'computing, tianjin university, china', 'institute for infocomm research, a⋆star, singapore', 'japan advanced institute of science and technology, ishikawa, japan']	4	Speaker and Language Identification
zhang21g_interspeech	"[""northwestern polytechnical university, xi'an, china"", 'institute for infocomm research, a⋆star, singapore', 'department of electrical and computer engineering, national university of singapore, singapore']"	4	Speaker and Language Identification
patino21_interspeech	['eurecom, sophia antipolis, france', 'lia, avignon universite, france']	6	Speech Coding and Enhancement
luo21_interspeech	['school of information and electronics, beijing institute of technology, china', 'school of information engineering, inner mongolia university of science and technology, china']	6	Speech Coding and Enhancement
wang21l_interspeech	['peking university, shenzhen, china', 'tencent ai lab, shenzhen, china', 'tencent ai lab, bellevue, wa, usa']	6	Speech Coding and Enhancement
gu21_interspeech	['institute of acoustics, chinese academy of sciences, china', 'university of chinese academy of sciences, china', 'xinjiang technical institute of physics and chemistry, chinese academy of sciences, china']	6	Speech Coding and Enhancement
li21c_interspeech	['institute of automation, chinese academy of sciences (casia), beijing, china', 'school of future technology, university of chinese academy of sciences, beijing, china', 'tencent ai lab, bellevue, usa']	6	Speech Coding and Enhancement
giri21_interspeech	['amazon web services, usa', 'amazon web services, canada']	6	Speech Coding and Enhancement
yemini21_interspeech	['faculty of engineering, bar-ilan university, ramat-gan', ', israel']	6	Speech Coding and Enhancement
tanaka21_interspeech	['†waseda university, japan', '‡sony corporation, japan']	6	Speech Coding and Enhancement
zhang21h_interspeech	['department of computer science and engineering, the ohio state university, usa', 'center for cognitive and brain sciences, the ohio state university, usa']	6	Speech Coding and Enhancement
na21_interspeech	['alibaba group, china']	6	Speech Coding and Enhancement
sato21_interspeech	['ntt corporation, japan']	6	Speech Coding and Enhancement
udupa21_interspeech	['electrical engineering, indian institute of science (iisc), bangalore-560012, india', 'amazon alexa, bangalore, india']	5	Analysis of Speech and Audio Signals
yang21b_interspeech	['adsplab, school of ece, peking university, shenzhen, china', 'peng cheng laboratory, shenzhen, china']	5	Analysis of Speech and Audio Signals
jaramillo21_interspeech	['audio analysis lab, create, aalborg university, denmark']	5	Analysis of Speech and Audio Signals
luo21b_interspeech	['ping an technology (shenzhen) co., ltd., china']	5	Analysis of Speech and Audio Signals
yarra21_interspeech	['language technologies research center (ltrc), iiit hyderabad', ', india', 'electrical engineering, indian institute of science (iisc), bangalore 560012, india']	5	Analysis of Speech and Audio Signals
huang21b_interspeech	['department of electrical engineering, national tsing hua university, taiwan', 'institute of communication engineering, national tsing hua university, taiwan', 'most joint research center for ai technology and all vista healthcare, taiwan']	5	Analysis of Speech and Audio Signals
shahrebabaki21_interspeech		5	Analysis of Speech and Audio Signals
lilley21_interspeech		5	Analysis of Speech and Audio Signals
yang21c_interspeech	['national taiwan university, taiwan', 'massachusetts institute of technology, usa', 'facebook ai research, usa', 'johns hopkins university, usa', 'amazon ai, usa', 'carnegie mellon university, usa']	5	Analysis of Speech and Audio Signals
zhang21i_interspeech	['radboud university, netherlands', 'university of michigan, usa']	5	Analysis of Speech and Audio Signals
peplinski21_interspeech	['university of washington, seattle, usa', 'google, japan', 'google, usa']	5	Analysis of Speech and Audio Signals
mori21_interspeech	['utsunomiya university, japan']	5	Analysis of Speech and Audio Signals
kumar21_interspeech	['† , yun wang *', '‡ , vamsi krishna ithapu†, christian fuegen‡', '†facebook reality labs research, redmond, wa, usa', '‡ facebook applied ai research, menlo park, ca, usa']	5	Analysis of Speech and Audio Signals
peng21b_interspeech	['microsoft research, redmond']	12	Spoken Language Processing: Translation, Information Retrieval, Summarization, Resources and Evaluation
radfar21_interspeech	['alexa machine learning, amazon, usa']	11	Spoken Dialog Systems and Conversational Analysis
cao21c_interspeech	"['university of waterloo, canada', ""huawei noah's ark lab, canada""]"	11	Spoken Dialog Systems and Conversational Analysis
muralidharan21_interspeech	['apple, usa', 'apple, uk', 'university of washington, usa']	11	Spoken Dialog Systems and Conversational Analysis
wu21d_interspeech	['georgia institute of technology']	11	Spoken Dialog Systems and Conversational Analysis
chen21g_interspeech	['speech lab, alibaba group, china']	11	Spoken Dialog Systems and Conversational Analysis
do21b_interspeech	['amazon alexa ai, germany']	11	Spoken Dialog Systems and Conversational Analysis
ganhotra21_interspeech	['ibm research ai, yorktown heights, ny, usa']	11	Spoken Dialog Systems and Conversational Analysis
han21_interspeech	['university of illinois at chicago, chicago, usa', 'artificial intelligence application research center, huawei technologies', 'shenzhen, prc']	11	Spoken Dialog Systems and Conversational Analysis
arora21_interspeech		11	Spoken Dialog Systems and Conversational Analysis
sun21b_interspeech	['ke holdings inc, beijing, china']	8	Speech Recognition: Signal Processing, Acoustic Modeling, Robustness, Adaptation
gong21c_interspeech	['moe key lab of artificial intelligence, ai institute', 'x-lance lab, department of computer science and engineering', 'shanghai jiao tong university, shanghai, china']	8	Speech Recognition: Signal Processing, Acoustic Modeling, Robustness, Adaptation
wang21m_interspeech	['department of electrical and computer engineering, university of california los angeles, usa', 'paii inc., usa']	8	Speech Recognition: Signal Processing, Acoustic Modeling, Robustness, Adaptation
sim21_interspeech	['google, usa']	8	Speech Recognition: Signal Processing, Acoustic Modeling, Robustness, Adaptation
kumar21b_interspeech	['samsung r&d institute india - bangalore, india', 'reverie language technologies, india']	8	Speech Recognition: Signal Processing, Acoustic Modeling, Robustness, Adaptation
xu21c_interspeech	['tal education group, beijing, china']	8	Speech Recognition: Signal Processing, Acoustic Modeling, Robustness, Adaptation
lam21b_interspeech	['department of computational linguistics, heidelberg university, germany', 'interdisciplinary center for scientific computing (iwr), heidelberg university, germany']	8	Speech Recognition: Signal Processing, Acoustic Modeling, Robustness, Adaptation
gao21_interspeech	['university of illinois at urbana-champaign, usa', 'mit-ibm watson ai lab, usa']	8	Speech Recognition: Signal Processing, Acoustic Modeling, Robustness, Adaptation
huang21c_interspeech	['microsoft corporation, usa']	8	Speech Recognition: Signal Processing, Acoustic Modeling, Robustness, Adaptation
das21b_interspeech	['georgia institute of technology, usa', 'amazon aws ai, usa']	8	Speech Recognition: Signal Processing, Acoustic Modeling, Robustness, Adaptation
chu21_interspeech	['paii inc., usa']	8	Speech Recognition: Signal Processing, Acoustic Modeling, Robustness, Adaptation
li21d_interspeech	['institute for interdisciplinary information sciences, tsinghua university, china', 'college of computer science and technology, zhejiang university, china', 'shanghai qi zhi institute, china']	7	Speech Synthesis and Spoken Language Generation
huang21d_interspeech	['nagoya university, japan', 'academia sinica, taiwan', 'chi mei hospital, taiwan']	7	Speech Synthesis and Spoken Language Generation
eskimez21_interspeech	['microsoft, one microsoft way, redmond, wa, usa']	7	Speech Synthesis and Spoken Language Generation
koshizuka21_interspeech	['department of information sciences, tokyo university of science, japan']	7	Speech Synthesis and Spoken Language Generation
wang21n_interspeech	"['the chinese university of hong kong, hong kong sar, china', ""huawei noah's ark lab, china""]"	7	Speech Synthesis and Spoken Language Generation
li21e_interspeech	['department of electrical engineering, columbia university, usa']	7	Speech Synthesis and Spoken Language Generation
kumar21c_interspeech	['hike private limited, india', 'indian institute of technology, delhi, india']	7	Speech Synthesis and Spoken Language Generation
sakamoto21_interspeech	['college of information science and engineering, ritsumeikan university, japan', 'ntt communication science laboratories, ntt corporation, japan']	7	Speech Synthesis and Spoken Language Generation
xu21d_interspeech	['school of informatics, xiamen university, china', 'prefectural university of hiroshima, japan', 'kobe university, japan', 'university of york, united kingdom']	7	Speech Synthesis and Spoken Language Generation
liu21c_interspeech	['tencent lightspeed & quantum studios, shenzhen, china', 'south china university of technology, guangzhou, china']	7	Speech Synthesis and Spoken Language Generation
zhou21c_interspeech	['department of electrical and computer engineering, national university of singapore, singapore', 'facebook inc, united states']	7	Speech Synthesis and Spoken Language Generation
du21_interspeech	['northwestern polytechnical university, china']	7	Speech Synthesis and Spoken Language Generation
white21_interspeech	['centre for language sciences, department of linguistics, macquarie university, sydney,', 'australia']	13	Speech, Voice, and Hearing Disorders
penney21_interspeech		13	Speech, Voice, and Hearing Disorders
sfakianaki21_interspeech	['speech signal processing laboratory, department of computer science, university of crete, greece']	13	Speech, Voice, and Hearing Disorders
huckvale21_interspeech	['speech, hearing and phonetic sciences, university college london, uk']		
lulich21_interspeech	['department of speech, language and hearing sciences, indiana university, u.s.a.']	13	Speech, Voice, and Hearing Disorders
perez21_interspeech	['computer science and engineering, university of michigan, ann arbor, michigan, usa', 'communication sciences and disorders, northwestern university, evanston, illinois, usa', 'physical medicine & rehabilitation, university of michigan, ann arbor, mi', 'michigan medicine, university of michigan, ann arbor, mi']	13	Speech, Voice, and Hearing Disorders
ferrer21_interspeech	['informatics research centre, central university “marta abreu” of las villas, cuba', 'friedrich-alexander-university erlangen-nuremberg, germany', 'faculty of medicine and health sciences, antwerp university, belgium', 'faculty of electrical engineering, czech technical university in prague, czech republic', 'departamento de fonoaudiologia, universidade federal de sao paulo, brazil']	13	Speech, Voice, and Hearing Disorders
karpov21_interspeech	['sber, russia']	8	Speech Recognition: Signal Processing, Acoustic Modeling, Robustness, Adaptation
sadhu21b_interspeech	['center for language and speech processing, johns hopkins university, usa', 'human language technology center of excellence, johns hopkins university, usa']	8	Speech Recognition: Signal Processing, Acoustic Modeling, Robustness, Adaptation
alghezi21_interspeech	['aalto university, finland', 'university of helsinki, finland']	8	Speech Recognition: Signal Processing, Acoustic Modeling, Robustness, Adaptation
oneill21_interspeech	['kensho technologies, cambridge ma, usa', 'nvidia technologies, santa clara ca, usa', 'johns hopkins university, baltimore md, usa', 'carnegie mellon university, pittsburgh pa, usa']	8	Speech Recognition: Signal Processing, Acoustic Modeling, Robustness, Adaptation
evain21_interspeech	['univ. grenoble alpes, cnrs, inria, g-inp, lig, france', 'lia, avignon universite, france', 'atos, echirolles, france', 'espci, cnrs lamsade, psl research university, france', 'naver labs europe, france']		
sturm21_interspeech	['institute of phonetics, faculty of arts, charles university, czech republic']	2	Phonetics, Phonology, and Prosody
riverincoutlee21_interspeech	['institute of phonetics and speech processing, ludwig-maximilians-universitat munich, germany', 'academy of albanological sciences, albania']	2	Phonetics, Phonology, and Prosody
zellers21_interspeech	['kiel university, kiel, germany', 'hebrew university of jerusalem, jerusalem, israel', 'oxford university, oxford, uk', 'makerere university, kampala, uganda']	2	Phonetics, Phonology, and Prosody
bodur21_interspeech	['aix-marseille universite, lpl, cnrs, aix-en-provence, france']	2	Phonetics, Phonology, and Prosody
zmolikova21_interspeech	['ntt corporation, japan', 'center for language and speech processing, the johns hopkins university, baltimore, usa', 'language technologies institute, carnegie mellon university, pittsburgh, usa']	5	Analysis of Speech and Audio Signals
borsdorf21_interspeech	['machine listening lab (mll), university of bremen, germany', 'department of electrical and computer engineering, national university of singapore, singapore', 'cognitive systems lab (csl), university of bremen, germany']	5	Analysis of Speech and Audio Signals
mateju21_interspeech	['faculty of mechatronics, informatics and interdisciplinary studies,', 'technical university of liberec, studentska 2', ' 17 liberec, czech republic']	5	Analysis of Speech and Audio Signals
salvati21_interspeech	['department of mathematics, computer science and physics', 'university of udine, italy']	5	Analysis of Speech and Audio Signals
yousefi21_interspeech	['center for robust speech systems (crss), erik jonsson school of engineering,', 'university of texas at dallas, richardson, texas, usa']	5	Analysis of Speech and Audio Signals
liu21d_interspeech	['school of electrical and electronic engineering, nanyang technological university, singapore', 'clsp and hlt-coe, johns hopkins university, usa', 'department of microelectronics, delft university of technology, netherlands', 'psychology, school of social sciences, nanyang technological university, singapore']	4	Speaker and Language Identification
duroselle21_interspeech	['universite de lorraine, cnrs, inria, loria, f-54000 nancy, france']	4	Speaker and Language Identification
wang21o_interspeech	['national engineering laboratory for speech and language information processing,', 'university of science and technology of china, hefei, china.', 'iflytek research, iflytek co., ltd, hefei, china', 'ict cluster, singapore institute of technology, singapore']	4	Speaker and Language Identification
deng21b_interspeech	['tencent cloud xiaowei, beijing, china', 'university of chinese academy of sciences, china']	4	Speaker and Language Identification
fan21_interspeech	['institute of automation, chinese academy of sciences, china', 'school of artificial intelligence, university of chinese academy of sciences, beijing, china']	4	Speaker and Language Identification
ramesh21_interspeech	['department of electrical engineering, indian institute of technology hyderabad, india']	4	Speaker and Language Identification
zhang21j_interspeech	['school of information science and engineering, xinjiang university, urumqi, china', 'school of computer science and engineering, nanyang technological university, singapore']	4	Speaker and Language Identification
tzudir21_interspeech	['indian institute of technology guwahati, guwahati - 781039, india', 'indian institute of technology dharwad, dharwad - 580011, india']	4	Speaker and Language Identification
khare21_interspeech	['ibm research, india', 'iit bombay, india']	8	Speech Recognition: Signal Processing, Acoustic Modeling, Robustness, Adaptation
feng21_interspeech	['multimedia computing group, delft university of technology, the netherlands', 'center for language and speech processing, johns hopkins university, usa', 'human language technology center of excellence,']	10	Speech Recognition: Technologies and Systems for New Applications
kamper21_interspeech	['∗', 'department of e&e engineering, stellenbosch university, south africa']	10	Speech Recognition: Technologies and Systems for New Applications
jiang21_interspeech	['ai labs, yuanfudao, beijing, china', 'ai labs, didi chuxing, beijing, china']	10	Speech Recognition: Technologies and Systems for New Applications
jacobs21_interspeech		10	Speech Recognition: Technologies and Systems for New Applications
niekerk21_interspeech	['e&e engineering, stellenbosch university, south africa']	10	Speech Recognition: Technologies and Systems for New Applications
takahashi21_interspeech	['nara institute of science and technology, japan', 'riken, center for advanced intelligence project (aip), japan']	10	Speech Recognition: Technologies and Systems for New Applications
maekaku21_interspeech	['yahoo japan corporation, tokyo, japan', 'carnegie mellon university, pa, usa']	10	Speech Recognition: Technologies and Systems for New Applications
cui21_interspeech	['the university of manchester, united kingdom', 'voiceiq ltd., united kingdom']	10	Speech Recognition: Technologies and Systems for New Applications
dunbar21_interspeech	['university of toronto, canada', 'cognitive machine learning (ens–cnrs–ehess–inria–psl research university), france', 'facebook ai research, france']		
gudur21_interspeech	['global ai accelerator, ericsson, chennai, india', 'ericsson research, chennai, india']	10	Speech Recognition: Technologies and Systems for New Applications
rouditchenko21_interspeech	['mit csail, usa', 'ut austin, usa', 'columbia university, usa', 'ibm research ai, usa', 'google, usa', 'nyu, usa']	10	Speech Recognition: Technologies and Systems for New Applications
lee21b_interspeech	['speech ai lab., ai center, ncsoft, republic of korea']		
maniati21_interspeech	['innoetics, samsung electronics, greece', 'mobile communications business, samsung electronics, republic of korea']	7	Speech Synthesis and Spoken Language Generation
zhan21_interspeech	['netease games ai lab, china']	7	Speech Synthesis and Spoken Language Generation
yang21d_interspeech	['south china university of technology, china', 'voiceai technologies co. ltd., china']	7	Speech Synthesis and Spoken Language Generation
liu21e_interspeech	['ping an technology, shanghai, p.r.china']	7	Speech Synthesis and Spoken Language Generation
xin21_interspeech	['graduate school of information science and technology, the university of tokyo, japan.']	7	Speech Synthesis and Spoken Language Generation
shang21_interspeech	['key laboratory of speech acoustics content understanding, institute of acoustics, cas, china', 'university of chinese academy of sciences, beijing, china', 'the xinjiang technical institute of physics & chemistry, chinese academy of sciences, china']	7	Speech Synthesis and Spoken Language Generation
kesim21_interspeech	['kuis-ai lab, koc university, istanbul, turkey']	7	Speech Synthesis and Spoken Language Generation
si21b_interspeech	['ping an technology (shenzhen) co., ltd., china']	7	Speech Synthesis and Spoken Language Generation
lee21c_interspeech	['minds lab inc., republic of korea', 'seoul national university, republic of korea']	6	Speech Coding and Enhancement
lin21c_interspeech	['research center for information technology innovation, academia sinica, taipei, taiwan', 'institute of information science, academia sinica, taipei, taiwan']		
wen21_interspeech	['samsung research china-beijing (src-b), samsung electronics, china', 'samsung research, samsung electronics, south korea']	6	Speech Coding and Enhancement
zhang21k_interspeech	['zhejiang university, china', 'state key laboratory of media convergence production technology and systems, china']	6	Speech Coding and Enhancement
yi21_interspeech	['national laboratory of pattern recognition, institute of automation,', 'chinese academy of sciences, china', 'university of chinese academy of sciences, beijing, china']	6	Speech Coding and Enhancement
chettri21_interspeech	['school of computing, university of eastern finland, finland', 'school of eecs, queen mary university of london, united kingdom', 'universite de lorraine, cnrs, inria, loria, f-54000, nancy, france', 'department of electrical and computer engineering, national university of singapore, singapore']	6	Speech Coding and Enhancement
cheon21_interspeech	['gwangju institute of science and technology, gwangju, korea', 'electronics and telecommunications research institute, daejeon, korea']	6	Speech Coding and Enhancement
drude21_interspeech	['amazon alexa, aachen, germany,', 'amazon web services, palo alto, ca, usa']	6	Speech Coding and Enhancement
siegert21_interspeech	['mobile dialog systems, institute for information technology and communications,', 'otto von guericke university magdeburg, germany']	6	Speech Coding and Enhancement
gabrys21_interspeech	['⋆alexa ai, gdansk, poland', '†alexa ai, cambridge, united kingdom', '‡alexa ai, berlin, germany']	6	Speech Coding and Enhancement
prajapati21_interspeech	['dhirubhai ambani institute of information and communication technology (da-iict),', 'gandhinagar, gujarat, india.']	6	Speech Coding and Enhancement
lin21d_interspeech	['clemson university, usa', 'facebook ai, usa']	6	Speech Coding and Enhancement
byun21_interspeech	['intelligent signal processing lab., yonsei university, wonju, korea', 'electronics and telecommunications research institute (etri), daejeon, korea']	6	Speech Coding and Enhancement
stoidis21_interspeech	['centre for intelligent sensing, queen mary university of london, uk']	6	Speech Coding and Enhancement
aldholmi21_interspeech	['department of linguistics and translation studies, king saud university, riyadh, saudi arabia']	1	Speech Perception, Production and Acquisition  by Human Listeners
kishiyama21_interspeech	['language and information sciences, the university of tokyo, japan']	1	Speech Perception, Production and Acquisition  by Human Listeners
chingacham21_interspeech	['saarland informatics campus, saarland university, germany']	1	Speech Perception, Production and Acquisition  by Human Listeners
simantiraki21_interspeech	['language and speech laboratory, university of the basque country, vitoria-gasteiz, spain', 'ikerbasque (basque science foundation), vitoria-gasteiz, spain']		
saito21_interspeech	['waseda university, japan', 'intelligent framework lab, japan']	1	Speech Perception, Production and Acquisition  by Human Listeners
xu21e_interspeech	['shenzhen institute of advanced technology, chinese academy of sciences, shenzhen, china', 'department of english language and literature, hong kong baptist university, hong kong sar,', 'china']	1	Speech Perception, Production and Acquisition  by Human Listeners
zhang21l_interspeech	['beijing language and culture university, china', 'nara institute of science and technology, japan', 'smart platform product department, tencent technology co., ltd, china']	1	Speech Perception, Production and Acquisition  by Human Listeners
terblanche21_interspeech	['department of speech and language pathology, university of cape town, south africa', 'department of language and linguistic science, university of york, uk', 'j. p french associates, york, uk']	1	Speech Perception, Production and Acquisition  by Human Listeners
einfeldt21_interspeech	['university of konstanz, department of linguistics, germany', 'university of konstanz, department of computer and information science, germany', 'university of trier, department ii, phonetics, germany', 'university of manchester, economics/school of social sciences, united kingdom']	1	Speech Perception, Production and Acquisition  by Human Listeners
kumar21d_interspeech	['†computer science and engg. dept., indian institute of technology, roorkee, india', '‡mechanical engg. dept., indian institute of technology, kanpur, india']	1	Speech Perception, Production and Acquisition  by Human Listeners
zeng21_interspeech	['school of psychology and therapeutic, university of south wales, uk', 'school of foreign languages, guangdong pharmaceutical university, china', 'school of education, university of bristol, uk', 'otto creutzfeldt center for cognitive and behavioral neuroscience, friedrich-schiller-universitat', 'jena, germany']	1	Speech Perception, Production and Acquisition  by Human Listeners
ashihara21_interspeech	['ntt corporation, japan']	1	Speech Perception, Production and Acquisition  by Human Listeners
nguyen21c_interspeech	['institute for anthropomatics and robotics, karlsruhe institute of technology, germany', 'karlsruhe information technology solutions — kites gmbh, germany']	8	Speech Recognition: Signal Processing, Acoustic Modeling, Robustness, Adaptation
joshi21_interspeech		8	Speech Recognition: Signal Processing, Acoustic Modeling, Robustness, Adaptation
le21_interspeech	['facebook ai, usa']	8	Speech Recognition: Signal Processing, Acoustic Modeling, Robustness, Adaptation
sainath21_interspeech	['google inc., u.s.a']	8	Speech Recognition: Signal Processing, Acoustic Modeling, Robustness, Adaptation
lu21_interspeech	['microsoft corp., usa']	8	Speech Recognition: Signal Processing, Acoustic Modeling, Robustness, Adaptation
moriya21_interspeech	['ntt corporation, japan']	8	Speech Recognition: Signal Processing, Acoustic Modeling, Robustness, Adaptation
schwarz21_interspeech	['amazon alexa, aachen, germany']	8	Speech Recognition: Signal Processing, Acoustic Modeling, Robustness, Adaptation
huang21e_interspeech	['speech & audio team, ai lab, bytedance inc., beijing, china']	8	Speech Recognition: Signal Processing, Acoustic Modeling, Robustness, Adaptation
cui21b_interspeech	['ibm research ai', 'ibm t j. watson research center, yorktown heights, new york, usa']	8	Speech Recognition: Signal Processing, Acoustic Modeling, Robustness, Adaptation
doutre21_interspeech	['google inc., usa']	8	Speech Recognition: Signal Processing, Acoustic Modeling, Robustness, Adaptation
audhkhasi21_interspeech	['google, usa']	8	Speech Recognition: Signal Processing, Acoustic Modeling, Robustness, Adaptation
inaguma21_interspeech	['graduate school of informatics, kyoto university, kyoto, japan']	8	Speech Recognition: Signal Processing, Acoustic Modeling, Robustness, Adaptation
moritz21_interspeech	['mitsubishi electric research laboratories (merl), cambridge, ma, usa']	8	Speech Recognition: Signal Processing, Acoustic Modeling, Robustness, Adaptation
kim21d_interspeech	['asapp, usa', 'carnegie mellon university, usa']	8	Speech Recognition: Signal Processing, Acoustic Modeling, Robustness, Adaptation
ren21_interspeech	['kuai shou technology co. beijing, china']	6	Speech Coding and Enhancement
zhu21d_interspeech	['tencent ethereal audio lab, tencent corporation, beijing, china', 'institute of acoustics, chinese academy of sciences, beijing, china']	6	Speech Coding and Enhancement
wang21p_interspeech	['institute of acoustics, chinese academy of sciences, beijing, china', 'university of chinese academy of sciences, beijing, china', 'tencent ethereal audio lab, tencent corporation, beijing, china']	6	Speech Coding and Enhancement
han21b_interspeech	['shanghai engineering research center of intelligent education and bigdata,', 'shanghai normal university, shanghai, china', 'tencent ethereal audio lab, tencent corporation, shenzhen, china']	6	Speech Coding and Enhancement
liu21f_interspeech	['college of computer science, inner mongolia university, china']	6	Speech Coding and Enhancement
raj21_interspeech	['samsung research & development institute india, bangalore', 'leap lab, electrical engineering, indian institute of science, bangalore, india.']		
xue21_interspeech		6	Speech Coding and Enhancement
fohr21_interspeech	['universite de lorraine, cnrs, inria, loria, f-54000 nancy, france']	9	Speech Recognition: Architecture, Search, and Linguistic Components
benes21_interspeech	['brno university of technology, czechia']	9	Speech Recognition: Architecture, Search, and Linguistic Components
gao21b_interspeech	['human language technology and pattern recognition group, computer science department,', 'rwth aachen university', ' aachen, germany', 'apptek gmbh', ' aachen, germany']	9	Speech Recognition: Architecture, Search, and Linguistic Components
pylkkonen21_interspeech	['speechly, finland', 'department of computer science, university of helsinki, finland']	9	Speech Recognition: Architecture, Search, and Linguistic Components
cieri21_interspeech	['university of pennsylvania, linguistic data consortium, usa']	4	Speaker and Language Identification
fenu21_interspeech	['university of cagliari, italy', 'epfl, switzerland']	4	Speaker and Language Identification
zhang21m_interspeech	['moe key lab of artificial intelligence, ai institute x-lance lab,', 'department of computer science and engineering', 'shanghai jiao tong university, shanghai, china']	4	Speaker and Language Identification
noe21_interspeech	"[""laboratoire informatique d'avignon (lia), avignon universite, france"", 'university of cambridge, united-kingdom', 'digital security department, eurecom, france']"	6	Speech Coding and Enhancement
romana21_interspeech	['computer science and engineering, university of michigan, ann arbor, michigan, usa', 'communication sciences and disorders, northwestern university, evanston, illinois, usa']	13	Speech, Voice, and Hearing Disorders
vaysse21_interspeech	['irit, universite paul sabatier, cnrs, toulouse, france', 'octogone-lordat, universite de toulouse, ut2j, toulouse, france']	13	Speech, Voice, and Hearing Disorders
qi21b_interspeech	['department electrical engineering-esat-psi, kuleuven', 'kasteelpark arenberg 10, leuven, belgium']	13	Speech, Voice, and Hearing Disorders
mathad21_interspeech		13	Speech, Voice, and Hearing Disorders
villatorotello21_interspeech	['universidad autonoma metropolitana unidad cuajimalpa, mexico city, mexico', 'idiap research institute, martigny, switzerland', 'ecole polytechnique federale de lausanne (epfl), switzerland']	13	Speech, Voice, and Hearing Disorders
shandiz21_interspeech	['institute of informatics, university of szeged, hungary', 'mta-szte research group on artificial intelligence, szeged, hungary', 'department of applied linguistics and phonetics, e¨otv¨os lorand university, budapest, hungary', 'mta-elte lendulet lingual articulation research group, budapest, hungary', 'department of telecommunications and media informatics,', 'budapest university of technology and economics, budapest, hungary']	13	Speech, Voice, and Hearing Disorders
lamba21_interspeech	['indian institute of techonology, bombay, india']	12	Spoken Language Processing: Translation, Information Retrieval, Summarization, Resources and Evaluation
cook21_interspeech	['university of liverpool, uk', 'university of sussex, uk']	11	Spoken Dialog Systems and Conversational Analysis
santoso21_interspeech	['university of tsukuba, japan', 'waseda university, japan', 'revcomm, inc., japan']	11	Spoken Dialog Systems and Conversational Analysis
silpachai21_interspeech	['hudilainen1, guanlong zhao2, ricardo gutierrez-osuna2']	11	Spoken Dialog Systems and Conversational Analysis
menshikova21_interspeech		11	Spoken Dialog Systems and Conversational Analysis
nasreen21_interspeech	['cognitive science group / computational linguistics lab', 'school of electronic engineering and computer science', 'queen mary university of london, uk', 'department of software engineering, mirpur university of science and technology, pakistan', 'department of knowledge technologies, jozef stefan institute, ljubljana, slovenia']	11	Spoken Dialog Systems and Conversational Analysis
kothare21_interspeech	['modality.ai, inc., usa', 'university of california, san francisco, usa', 'palo alto university, usa', 'university of california, berkeley, usa']		
ishi21_interspeech	['riken guardian robot project, japan', 'atr hiroshi ishiguro labs, japan']	11	Spoken Dialog Systems and Conversational Analysis
kim21e_interspeech	['facebook ai, usa']	9	Speech Recognition: Architecture, Search, and Linguistic Components
wang21q_interspeech		9	Speech Recognition: Architecture, Search, and Linguistic Components
shi21_interspeech	['alibaba group, china', 'university of illinois at urbana-champaign, usa', 'shanghai jiao tong university, china']	9	Speech Recognition: Architecture, Search, and Linguistic Components
papadourakis21_interspeech	['alexa machine learning, amazon, usa']	9	Speech Recognition: Architecture, Search, and Linguistic Components
mansfield21_interspeech	['linguistics department, university of washington, seattle, wa, usa', 'electrical & computer engineering department, university of washington, seattle, wa, usa']	9	Speech Recognition: Architecture, Search, and Linguistic Components
huang21f_interspeech	['google research, usa']	9	Speech Recognition: Architecture, Search, and Linguistic Components
andresferrer21_interspeech		9	Speech Recognition: Architecture, Search, and Linguistic Components
huang21g_interspeech	['department of computer science and engineering', 'southern university of science and technology, shenzhen, china', 'school of computer science and electronic engineering, university of surrey, uk', 'mit-ibm watson ai lab, cambridge, usa']	9	Speech Recognition: Architecture, Search, and Linguistic Components
zhao21_interspeech	['cloudwalk technology, shanghai, china']	9	Speech Recognition: Architecture, Search, and Linguistic Components
dai21b_interspeech	['moe key lab of artificial intelligence', 'x-lance lab, department of computer science and engineering', 'ai institute, shanghai jiao tong university, shanghai, china']	9	Speech Recognition: Architecture, Search, and Linguistic Components
kurata21_interspeech	['ibm research - tokyo, japan', 'ibm t j. watson research center, usa']	9	Speech Recognition: Architecture, Search, and Linguistic Components
saebi21_interspeech		9	Speech Recognition: Architecture, Search, and Linguistic Components
namazifar21_interspeech	['amazon alexa ai, usa']	9	Speech Recognition: Architecture, Search, and Linguistic Components
shi21b_interspeech	['facebook ai, usa']	8	Speech Recognition: Signal Processing, Acoustic Modeling, Robustness, Adaptation
zhang21n_interspeech	['alibaba group inc, china', 'college of intelligence and computing, tianjin university, china']	8	Speech Recognition: Signal Processing, Acoustic Modeling, Robustness, Adaptation
zeyer21_interspeech	['human language technology and pattern recognition, computer science department,', 'rwth aachen university', ' aachen, germany', 'apptek gmbh', ' aachen, germany']	8	Speech Recognition: Signal Processing, Acoustic Modeling, Robustness, Adaptation
mavandadi21_interspeech	['google inc., u.s.a']	8	Speech Recognition: Signal Processing, Acoustic Modeling, Robustness, Adaptation
tuske21_interspeech	['ibm research ai, yorktown heights, usa']	8	Speech Recognition: Signal Processing, Acoustic Modeling, Robustness, Adaptation
an21_interspeech	['speech processing and machine intelligence (spmi) lab, tsinghua university, china']	8	Speech Recognition: Signal Processing, Acoustic Modeling, Robustness, Adaptation
you21_interspeech	['tencent ai lab, shenzhen, china', 'tencent ai lab, bellevue, wa, usa']	8	Speech Recognition: Signal Processing, Acoustic Modeling, Robustness, Adaptation
leong21_interspeech	['dept of electrical and computer engineering, national yang ming chiao tung university, taiwan']	8	Speech Recognition: Signal Processing, Acoustic Modeling, Robustness, Adaptation
lin21e_interspeech	['⋆', 'smart platform product department, tencent technology co., ltd, china']	8	Speech Recognition: Signal Processing, Acoustic Modeling, Robustness, Adaptation
karita21_interspeech	['google, japan']	8	Speech Recognition: Signal Processing, Acoustic Modeling, Robustness, Adaptation
hori21b_interspeech	['mitsubishi electric research laboratories (merl), cambridge, ma, usa']	8	Speech Recognition: Signal Processing, Acoustic Modeling, Robustness, Adaptation
haidar21_interspeech	"[""huawei noah's ark lab, montreal research centre, canada""]"	8	Speech Recognition: Signal Processing, Acoustic Modeling, Robustness, Adaptation
mahadeokar21_interspeech	['facebook ai, usa']	8	Speech Recognition: Signal Processing, Acoustic Modeling, Robustness, Adaptation
falkowskigilski21_interspeech	['gdansk university of technology, faculty of electronics, telecommunications and informatics,', 'gdansk, poland']	5	Analysis of Speech and Audio Signals
schymura21_interspeech	['cognitive signal processing group, ruhr university bochum, bochum, germany', 'ntt communications science laboratories, ntt corporation, kyoto, japan']	5	Analysis of Speech and Audio Signals
togami21_interspeech	['line corporation, tokyo, japan']	5	Analysis of Speech and Audio Signals
mittag21_interspeech	['quality and usability lab, technische universitat berlin, berlin, germany', 'deutsches forschungszentrum fur kunstliche intelligenz (dfki), berlin, germany']	5	Analysis of Speech and Audio Signals
naderi21_interspeech	['quality and usability lab, technische universitat berlin, berlin, germany', 'microsoft corp., wa, usa']	5	Analysis of Speech and Audio Signals
geng21_interspeech	['school of information science and technology, shanghaitech university, china']	5	Analysis of Speech and Audio Signals
yu21_interspeech	['tencent ai lab, bellevue, wa, usa']	5	Analysis of Speech and Audio Signals
toma21_interspeech	['dept. of mathematics, computer science and physics', 'university of udine', 'udine, italy']	5	Analysis of Speech and Audio Signals
itoyama21_interspeech	['tokyo institute of technology, japan', 'kyoto university, japan', 'honda research institute japan, co., ltd., japan']	5	Analysis of Speech and Audio Signals
liu21g_interspeech	['the guangdong key laboratory of intelligent information processing, college of electronic and', 'information engineering, shenzhen university, china', 'peng cheng laboratory, shenzhen, china']	5	Analysis of Speech and Audio Signals
lin21f_interspeech	['schoolof electrical engineering, computing &mathematical sciences, curtin university, australia', 'graduate school of engineer science, osaka university, japan']	5	Analysis of Speech and Audio Signals
narayanaswamy21_interspeech	['arizona state university, usa', 'lawrence livermore national laboratory, usa']	5	Analysis of Speech and Audio Signals
chen21h_interspeech	['college of computer science and electronic engineering, hunan university, china']		
you21b_interspeech	['moneybrain inc., seoul, korea']	7	Speech Synthesis and Spoken Language Generation
cong21_interspeech	"[""northwestern polytechnical university, xi'an, china"", 'tencent ai lab, china']"	7	Speech Synthesis and Spoken Language Generation
yoneyama21_interspeech	['nagoya university, japan', 'information technology center, nagoya university, japan']	7	Speech Synthesis and Spoken Language Generation
mizuta21_interspeech	['faculty of engineering, the university of tokyo, japan', 'graduate school of information science and technology, the university of tokyo, japan']	7	Speech Synthesis and Spoken Language Generation
kim21f_interspeech	['department of artificial intelligence, korea university, seoul, korea', 'department of brain and cognitive engineering, korea university, seoul, korea']	7	Speech Synthesis and Spoken Language Generation
yang21e_interspeech	['speech ai lab, ncsoft, republic of korea']	7	Speech Synthesis and Spoken Language Generation
jang21_interspeech	['kakao enterprise corporation, seongnam, republic of korea', 'kakao corporation, seongnam, republic of korea']	7	Speech Synthesis and Spoken Language Generation
alradhi21_interspeech	['department of telecommunications and media informatics', 'budapest university of technology and economics, budapest, hungary', 'mta-elte lendulet lingual articulation research group, budapest, hungary']	7	Speech Synthesis and Spoken Language Generation
tobing21_interspeech	['nagoya university, japan']	7	Speech Synthesis and Spoken Language Generation
liu21h_interspeech	['sun yat-sen university, china', 'moe key lab of artificial intelligence, ai institute', 'x-lance lab, department of computer science and engineering', 'shanghai jiao tong university, china']	7	Speech Synthesis and Spoken Language Generation
hwang21_interspeech	['search solutions inc., seongnam, korea', 'line corp.,tokyo, japan', 'naver corp., seongnam, korea']	7	Speech Synthesis and Spoken Language Generation
chen21i_interspeech	['†baidu research, sunnyvale, ca, usa', '‡oregon state university, corvallis, or, usa']	12	Spoken Language Processing: Translation, Information Retrieval, Summarization, Resources and Evaluation
cherry21_interspeech	['google research, usa']	12	Spoken Language Processing: Translation, Information Retrieval, Summarization, Resources and Evaluation
wang21r_interspeech	['facebook ai, usa']	12	Spoken Language Processing: Translation, Information Retrieval, Summarization, Resources and Evaluation
wang21s_interspeech		12	Spoken Language Processing: Translation, Information Retrieval, Summarization, Resources and Evaluation
cheng21_interspeech	['institute of information science, academia sinica, taiwan']	12	Spoken Language Processing: Translation, Information Retrieval, Summarization, Resources and Evaluation
effendi21_interspeech	['nara institute of science and technology, japan', 'riken, center for advance intelligence project (aip), japan']	12	Spoken Language Processing: Translation, Information Retrieval, Summarization, Resources and Evaluation
tokuyama21_interspeech	['nara institute of science and technology, japan', 'riken, center for advanced intelligence project (aip), japan']	12	Spoken Language Processing: Translation, Information Retrieval, Summarization, Resources and Evaluation
ye21_interspeech	['bytedance ai lab, shanghai, china']	12	Spoken Language Processing: Translation, Information Retrieval, Summarization, Resources and Evaluation
ko21_interspeech	['nara institute of science and technology, japan', 'riken center for advanced intelligence project (aip), japan']	12	Spoken Language Processing: Translation, Information Retrieval, Summarization, Resources and Evaluation
perezgonzalezdemartos21_interspeech	['machine learning and language processing (mllp) research group', 'valencian research institute for artificial intelligence (vrain)', 'universitat politecnica de valencia, spain']	12	Spoken Language Processing: Translation, Information Retrieval, Summarization, Resources and Evaluation
martucci21_interspeech	['university of trento, italy', 'fondazione bruno kessler, trento, italy']	12	Spoken Language Processing: Translation, Information Retrieval, Summarization, Resources and Evaluation
vyas21_interspeech	['department of computer science, indiana university bloomington, usa', 'department of linguistics, indiana university bloomington, usa']	12	Spoken Language Processing: Translation, Information Retrieval, Summarization, Resources and Evaluation
ananthanarayana21_interspeech	['rochester institute of technology, usa']	12	Spoken Language Processing: Translation, Information Retrieval, Summarization, Resources and Evaluation
alenin21_interspeech	['id r&d inc., new york, usa', 'spbu, saint petersburg state university, saint petersburg, russia']		
thienpondt21_interspeech	['idlab, department of electronics and information systems, ghent university - imec, belgium']	4	Speaker and Language Identification
gusev21_interspeech	['itmo university, st. petersburg, russia', 'stc-innovations ltd., st. petersburg, russia']	4	Speaker and Language Identification
kang21_interspeech	['computer research institute of montreal, canada', 'department of electrical and computer engineering and inmc,', 'seoul national university, korea']	4	Speaker and Language Identification
qin21_interspeech	['school of computer science, wuhan university, wuhan, china', 'china mobile research institute, beijing, china', 'data science research center, duke kunshan university, kunshan, china']	4	Speaker and Language Identification
zhang21o_interspeech			
yan21_interspeech	['sogou-inc. , beijing, china']	4	Speaker and Language Identification
han21c_interspeech	['moe key lab of artificial intelligence, ai institute', 'x-lance lab, department of computer science and engineering', 'shanghai jiao tong university, shanghai, china']	4	Speaker and Language Identification
cho21_interspeech	['korea institute of science and technology, republic of korea', 'korea advanced institute of science and technology, republic of korea']		
prazak21_interspeech	['department of cybernetics, university of west bohemia, pilsen, czech republic', 'speechtech, s.r.o., pilsen, czech republic']		
fragner21_interspeech	['signal processing and speech communication laboratory, graz university of technology, austria', 'evolve, graz, austria']		
beskow21_interspeech	['furhat robotics, sweden', 'kth royal institute of technology, sweden']		
dominguez21_interspeech	['universitat pompeu fabra, spain', 'institute for catalan advanced research (icrea), spain']		
guruju21_interspeech	['observe.ai, india']		
gogineni21_interspeech	['observe.ai, india']		
raj21b_interspeech		4	Speaker and Language Identification
tak21_interspeech	['eurecom, sophia antipolis, france', 'naver corporation, south korea']	4	Speaker and Language Identification
mingote21_interspeech	['vivolab, aragon institute for engineering research (i3a), university of zaragoza, spain']	4	Speaker and Language Identification
peng21c_interspeech	['ping an technology (shenzhen) co., ltd., china', 'peking university, shenzhen graduate school, china']	4	Speaker and Language Identification
nguyen21d_interspeech	['lig - universite grenoble alpes, france', 'lia - avignon universite, france', 'naver labs europe, france']	12	Spoken Language Processing: Translation, Information Retrieval, Summarization, Resources and Evaluation
machacek21_interspeech	['charles university, faculty of mathematics and physics', 'czech republic']	12	Spoken Language Processing: Translation, Information Retrieval, Summarization, Resources and Evaluation
pouthier21_interspeech	"['nxp semiconductors, france', ""universite cote d'azur, inria, cnrs, ljad, i3s, maasai, france""]"	11	Spoken Dialog Systems and Conversational Analysis
wallbridge21_interspeech	['centre for speech technology research, university of edinburgh, united kingdom']	11	Spoken Dialog Systems and Conversational Analysis
michael21_interspeech	['quality and usability lab, technische universitat berlin, germany', 'speech and language technology,', 'german research center for artificial intelligence (dfki)']	5	Analysis of Speech and Audio Signals
bergler21_interspeech	['friedrich-alexander-university erlangen-nuremberg, pattern recognition lab, erlangen, germany', 'orcalab, alert bay, british columbia, canada', 'university of victoria, victoria, british columbia, canada']	5	Analysis of Speech and Audio Signals
boes21_interspeech	['esat, ku leuven, belgium']	5	Analysis of Speech and Audio Signals
nessler21_interspeech	['ecole polytechnique federale de lausanne, lausanne, switzerland', 'logitech europe s.a., lausanne, switzerland']	5	Analysis of Speech and Audio Signals
oncescu21_interspeech	['vgg, university of oxford, uk', 'eml, university of tubingen, germany']	5	Analysis of Speech and Audio Signals
giollo21_interspeech	['alexa speech, amazon development centre, turin, italy', 'alexa speech, amazon development center gmbh, aachen, germany', 'alexa speech, amazon development center, cambridge, uk']	9	Speech Recognition: Architecture, Search, and Linguistic Components
pham21_interspeech		9	Speech Recognition: Architecture, Search, and Linguistic Components
conneau21_interspeech	['facebook ai, usa']	9	Speech Recognition: Architecture, Search, and Linguistic Components
hayakawa21_interspeech	['graduate school of medicine, engineering, and agricultural sciences,', 'university of yamanashi, japan', 'faculty of industrial technology, tsukuba university of technology, japan', 'faculty of engineering, information and systems, university of tsukuba, japan']	9	Speech Recognition: Architecture, Search, and Linguistic Components
n21_interspeech	['freshworks inc, india']	9	Speech Recognition: Architecture, Search, and Linguistic Components
kumar21e_interspeech	['indian institute of technology madras, india', '* equal contribution', 'copyright © 2021 isca', 'interspeech 2021', 'august – 3 september', ', brno, czechia', 'http://dx.doi.org/10.21437/interspeech.2021-978']	9	Speech Recognition: Architecture, Search, and Linguistic Components
diwan21_interspeech	['computer science and engineering, indian institute of technology (iit), bombay, india', 'electrical engineering, indian institute of science (iisc), bangalore 560012, india', 'microsoft research india, hyderabad, india', 'navana tech india private limited, bangalore, india', 'ibm research india, bangalore, india', 'language technologies research center (ltrc), iiit hyderabad', ', india']		
winata21_interspeech	['the hong kong university of science and technology, hong kong sar, china', 'salesforce research, singapore', 'salesforce research, usa']	9	Speech Recognition: Architecture, Search, and Linguistic Components
sailor21_interspeech	['samsung r&d institute, bangalore (sri-b), india']		
li21f_interspeech	['carnegie mellon university, usa']	9	Speech Recognition: Architecture, Search, and Linguistic Components
chowdhury21_interspeech	['qatar computing research institute, qatar', 'kanari ai , california, usa']	9	Speech Recognition: Architecture, Search, and Linguistic Components
yan21b_interspeech	['language technologies institute, carnegie mellon university, usa']	9	Speech Recognition: Architecture, Search, and Linguistic Components
martin21_interspeech	['labri, univ. de bordeaux, cnrs – umr 5800, bordeaux inp, talence (france)', 'speech lab, airudit, pessac (france)', 'sanpsy, univ. de bordeaux, cnrs – usr 3413, chu bordeaux, bordeaux (france)']	3	Paralinguistics in Speech and Language: Human and Automatic Analysis and Processing
gillick21_interspeech		3	Paralinguistics in Speech and Language: Human and Automatic Analysis and Processing
nagano21_interspeech	['ntt media intelligence laboratories, japan', 'ntt communication science laboratories, japan']	3	Paralinguistics in Speech and Language: Human and Automatic Analysis and Processing
alsofyani21_interspeech	['university of glasgow, uk']	3	Paralinguistics in Speech and Language: Human and Automatic Analysis and Processing
aloshban21_interspeech	['university of glasgow, glasgow, uk', 'imam muhammad ibn saud islamic university in riyadh, riyadh, saudi arabia', 'universita degli studi della campania “luigi vanvitelli”, caserta, italy']	3	Paralinguistics in Speech and Language: Human and Automatic Analysis and Processing
tammewar21_interspeech	['signals and interactive systems lab, university of trento, italy']	3	Paralinguistics in Speech and Language: Human and Automatic Analysis and Processing
condron21_interspeech	['speech graphics ltd, edinburgh, united kingdom']	3	Paralinguistics in Speech and Language: Human and Automatic Analysis and Processing
cai21_interspeech	['national laboratory of pattern recognition, institute of automation, cas, beijing, china', 'school of artificial intelligence, university of chinese academy of sciences, beijing, china', 'cas center for excellence in brain science and intelligence technology, beijing, china']	3	Paralinguistics in Speech and Language: Human and Automatic Analysis and Processing
botelho21_interspeech	['inesc-id/instituto superior tecnico, university of lisbon, portugal', 'cognitive systems lab (csl), university of bremen, germany']	3	Paralinguistics in Speech and Language: Human and Automatic Analysis and Processing
maruri21_interspeech		3	Paralinguistics in Speech and Language: Human and Automatic Analysis and Processing
seneviratne21_interspeech		3	Paralinguistics in Speech and Language: Human and Automatic Analysis and Processing
kim21g_interspeech		8	Speech Recognition: Signal Processing, Acoustic Modeling, Robustness, Adaptation
macoskey21_interspeech		8	Speech Recognition: Signal Processing, Acoustic Modeling, Robustness, Adaptation
zhang21p_interspeech	['centre for speech technology research, university of edinburgh, edinburgh, uk']	8	Speech Recognition: Signal Processing, Acoustic Modeling, Robustness, Adaptation
xue21b_interspeech	['school of computer science and technology, harbin institute of technology, harbin, china']	8	Speech Recognition: Signal Processing, Acoustic Modeling, Robustness, Adaptation
chang21b_interspeech	['school of electrical engineering and computer science, national taiwan university, taiwan']	8	Speech Recognition: Signal Processing, Acoustic Modeling, Robustness, Adaptation
leal21_interspeech	['google, usa']	8	Speech Recognition: Signal Processing, Acoustic Modeling, Robustness, Adaptation
xu21f_interspeech	['google inc, new york, ny, u.s.a.']	8	Speech Recognition: Signal Processing, Acoustic Modeling, Robustness, Adaptation
wang21t_interspeech	['google, new york, ny, usa', 'the ohio state university, columbus, oh, usa']	8	Speech Recognition: Signal Processing, Acoustic Modeling, Robustness, Adaptation
chen21j_interspeech	['college of intelligence and computing, tianjin university, china', 'bytedance ai lab, china']	8	Speech Recognition: Signal Processing, Acoustic Modeling, Robustness, Adaptation
droppo21_interspeech	['amazon alexa, usa']	8	Speech Recognition: Signal Processing, Acoustic Modeling, Robustness, Adaptation
billa21_interspeech	['information sciences institute,', 'university of southern california, marina del rey, ca 90292, usa']	8	Speech Recognition: Signal Processing, Acoustic Modeling, Robustness, Adaptation
fasoli21_interspeech		8	Speech Recognition: Signal Processing, Acoustic Modeling, Robustness, Adaptation
masumura21_interspeech	['† ntt media intelligence laboratories, ntt corporation, japan', '‡ nagaoka university of technology, japan']	8	Speech Recognition: Signal Processing, Acoustic Modeling, Robustness, Adaptation
meng21_interspeech		8	Speech Recognition: Signal Processing, Acoustic Modeling, Robustness, Adaptation
jiang21b_interspeech	['department of engineering, university of cambridge, uk']	8	Speech Recognition: Signal Processing, Acoustic Modeling, Robustness, Adaptation
kaland21_interspeech	['institute of linguistics, university of cologne, germany', 'department of linguistics, university of california, santa barbara, usa']	2	Phonetics, Phonology, and Prosody
jespersen21_interspeech	['aarhus university, denmark', 'charles university, czech republic']		
meli21_interspeech	"['universite de paris, clillac-arp, f-75013 paris, france', 'universite de paris, llf, f-75013 paris, france', 'uga, lidilem', "" saint-martin-d'heres, france""]"	2	Phonetics, Phonology, and Prosody
gerazov21_interspeech	['faculty of electrical engineering and information technologies', 'ss cyril and methodius university in skopje, rn macedonia', 'mcgill university, canada']	2	Phonetics, Phonology, and Prosody
tran21_interspeech	['university of southern california, institute for creative technologies, usa', 'university of washington, electrical and computer engineering, usa']	2	Phonetics, Phonology, and Prosody
liu21i_interspeech	['institute of linguistics, national tsing hua university, hsinchu, taiwan']	2	Phonetics, Phonology, and Prosody
gosy21_interspeech		2	Phonetics, Phonology, and Prosody
pan21b_interspeech		2	Phonetics, Phonology, and Prosody
jakob21_interspeech	['university of konstanz, department of linguistics, germany', 'university of trier, department ii, phonetics, germany']	2	Phonetics, Phonology, and Prosody
gobl21_interspeech	['phonetics and speech laboratory, school of linguistic, speech and communication sciences', 'trinity college dublin, ireland']	2	Phonetics, Phonology, and Prosody
wagner21_interspeech	['mcgill university, canada']	2	Phonetics, Phonology, and Prosody
mumtaz21_interspeech	['university of konstanz, germany']	2	Phonetics, Phonology, and Prosody
stefansdottir21_interspeech	['cornell university, usa']	2	Phonetics, Phonology, and Prosody
johnson21_interspeech	['department of linguistics, university of british columbia, canada']	2	Phonetics, Phonology, and Prosody
sivaraman21_interspeech	['indiana university, department of intelligent systems engineering, usa']	6	Speech Coding and Enhancement
saddler21_interspeech	[', jenelle feather1,2,3,', 'kaizhi qian4, yang zhang4, josh h mcdermott1,2,3', '†', 'department of brain and cognitive sciences, mit, usa', 'mcgovern institute for brain research, mit, usa', 'center for brains, minds and machines, mit, usa', 'mit-ibm watson ai lab, ibm research, usa']	6	Speech Coding and Enhancement
eskimez21b_interspeech	['microsoft, one microsoft way, redmond, wa, usa']	6	Speech Coding and Enhancement
xu21g_interspeech	['vivo ai lab, p.r. china', 'e.e. engineering, trinity college dublin, ireland']	6	Speech Coding and Enhancement
chang21c_interspeech	['columbia university, usa', 'microsoft corporation, usa']	6	Speech Coding and Enhancement
zhang21q_interspeech	['university of science and technology of china, hefei, anhui, p.r.china', 'georgia institute of technology, atlanta, ga, usa']	6	Speech Coding and Enhancement
agrawal21_interspeech		6	Speech Coding and Enhancement
lee21d_interspeech	['naver coporation, south korea']	6	Speech Coding and Enhancement
kashyap21_interspeech	['department of computer science and engineering, pes university, india']	6	Speech Coding and Enhancement
dang21_interspeech	['key laboratory of speech acoustics & content understanding, institute of acoustics, cas, china', 'university of chinese academy of sciences, beijing, china']	6	Speech Coding and Enhancement
zhang21r_interspeech	['the graduate center, cuny, ny, usa', 'lehman college, cuny, ny, usa', 'college of staten island, cuny, ny, usa']	6	Speech Coding and Enhancement
bu21_interspeech	['dept. of electrical engineering and computer science, university of missouri-columbia, usa', 'paii inc. palo alto, ca, usa']	6	Speech Coding and Enhancement
kim21h_interspeech	['ai r&d lab, kakao enterprise', ', pangyoyeok-ro, bundang-gu, seongnam-si, gyeonggi-do 13494, korea']	6	Speech Coding and Enhancement
kongthaworn21_interspeech		7	Speech Synthesis and Spoken Language Generation
valentinibotinhao21_interspeech	['the centre for speech technology research, the university of edinburgh, uk']	7	Speech Synthesis and Spoken Language Generation
zandie21_interspeech	['department of electrical and computer engineering, university of denver', 'dreamface technologies, llc']	7	Speech Synthesis and Spoken Language Generation
shi21c_interspeech	['school of computer science, wuhan university, wuhan, china', 'data science research center, duke kunshan university, kunshan, china', 'beijing shell shell technology co., ltd, beijing, china']	7	Speech Synthesis and Spoken Language Generation
eng21_interspeech	['acoustics research centre, department of mechanical engineering, university of auckland,', 'new zealand', 'department of electrical, computer and software engineering, university of auckland,', 'new zealand']	7	Speech Synthesis and Spoken Language Generation
cui21c_interspeech	['zhejiang university, china', 'alibaba group, china']	7	Speech Synthesis and Spoken Language Generation
rallabandi21_interspeech	['quality and usability lab, technische universitat berlin, germany,', 'speech and language technology, deutsches forschungszentrum fur kunstliche intelligenz', '(dfki), berlin, germany']	7	Speech Synthesis and Spoken Language Generation
bakhturina21_interspeech	['nvidia, santa clara, usa']	7	Speech Synthesis and Spoken Language Generation
tseng21b_interspeech	['college of electrical engineering and computer science, national taiwan university, taiwan']	7	Speech Synthesis and Spoken Language Generation
mussakhojayeva21_interspeech	['institute of smart systems and artificial intelligence (issai),', 'nazarbayev university, nur-sultan, kazakhstan']	7	Speech Synthesis and Spoken Language Generation
taylor21_interspeech	['the centre for speech technology research, the university of edinburgh, uk']		
reddy21_interspeech	['microsoft corporation, redmond usa', 'johns hopkins university, usa']	6	Speech Coding and Enhancement
li21g_interspeech	['key laboratory of noise and vibration research, institute of acoustics, chinese academy of', 'sciences, beijing, china', 'university of chinese academy of sciences, beijing, china', 'communication university of china, beijing, china']	6	Speech Coding and Enhancement
xu21h_interspeech	['institute for communications technology, technische universitat braunschweig, germany']	6	Speech Coding and Enhancement
le21b_interspeech	['key laboratory of modern acoustics, nanjing university, nanjing 210093, china', 'nju-horizon intelligent audio lab, horizon robotics, beijing 100094, china', 'nanjing institute of advanced artificial intelligence, nanjing 210014, china']	6	Speech Coding and Enhancement
lv21_interspeech	"[""northwestern polytechnical university, xi'an, china""]"	6	Speech Coding and Enhancement
zhang21s_interspeech	['college of computer science, inner mongolia university, china']	6	Speech Coding and Enhancement
zhang21t_interspeech	['kuaishou technology co., beijing, p.r. china']	6	Speech Coding and Enhancement
oostermeijer21_interspeech	['university of science and technology of china, hefei, china']	6	Speech Coding and Enhancement
ristea21_interspeech	['university politehnica of bucharest, romania', 'university of bucharest, romania']	8	Speech Recognition: Signal Processing, Acoustic Modeling, Robustness, Adaptation
kojima21_interspeech	['advanced media, japan']	8	Speech Recognition: Signal Processing, Acoustic Modeling, Robustness, Adaptation
lohrenz21_interspeech	['technische universitat braunschweig', 'institute for communications technology', 'schleinitzstr. 22', ' braunschweig, germany']	8	Speech Recognition: Signal Processing, Acoustic Modeling, Robustness, Adaptation
zaiem21_interspeech	['ltci, telecom paris, institut polytechnique de paris, palaiseau, france', 'avignon universite, lia, avignon, france']	8	Speech Recognition: Signal Processing, Acoustic Modeling, Robustness, Adaptation
zeineldeen21_interspeech	['human language technology and pattern recognition, computer science department, rwth', 'aachen university', ' aachen, germany', 'apptek gmbh', ' aachen, germany']	8	Speech Recognition: Signal Processing, Acoustic Modeling, Robustness, Adaptation
vyas21b_interspeech	['idiap research institute, martigny, switzerland', 'ecole polytechnique federale de lausanne, switzerland']	8	Speech Recognition: Signal Processing, Acoustic Modeling, Robustness, Adaptation
moine21_interspeech	['stms lab', 'ircam, cnrs, sorbonne universite,', 'paris, france']	3	Paralinguistics in Speech and Language: Human and Automatic Analysis and Processing
leem21_interspeech		3	Paralinguistics in Speech and Language: Human and Automatic Analysis and Processing
georgiou21_interspeech	['school of ece, national technical university of athens, athens, greece', 'institute for language and speech processing, athena research center, athens, greece', 'signal analysis and interpretation laboratory (sail), usc, los angeles, ca, usa', 'behavioral signal technologies, los angeles, ca, usa']		
klejch21_interspeech	['centre for speech technology research, university of edinburgh, united kingdom']	9	Speech Recognition: Architecture, Search, and Linguistic Components
zhou21d_interspeech	['human language technology and pattern recognition, computer science department,', 'rwth aachen university', ' aachen, germany', 'apptek gmbh', ' aachen, germany']	9	Speech Recognition: Architecture, Search, and Linguistic Components
zhou21e_interspeech	['human language technology and pattern recognition, computer science department,', 'rwth aachen university', ' aachen, germany', 'apptek gmbh', ' aachen, germany']	9	Speech Recognition: Architecture, Search, and Linguistic Components
khosravani21_interspeech	['idiap research institute, switzerland', 'data, analytics & ai group — swisscom ag, switzerland']	9	Speech Recognition: Architecture, Search, and Linguistic Components
egorova21_interspeech		9	Speech Recognition: Architecture, Search, and Linguistic Components
wiesner21_interspeech	['go-vivace inc., usa']	9	Speech Recognition: Architecture, Search, and Linguistic Components
xue21c_interspeech	['centre for language and speech technology (clst), radboud university, the netherlands', 'centre for language studies (cls), radboud university, the netherlands']	13	Speech, Voice, and Hearing Disorders
kim21i_interspeech	['signal analysis and interpretation laboratory, university of southern california, usa', 'microsoft ai for good research lab, redmond, washington, usa', 'center for autism and the developing brain, weill cornell medicine, usa', 'department of psychiatry, university of california, san francisco, usa', 'semel institute of neuroscience and human behavior, university of california, los angeles, usa']	13	Speech, Voice, and Hearing Disorders
jesko21_interspeech	['poznan supercomputing and networking center, poznan, poland']	13	Speech, Voice, and Hearing Disorders
fivela21_interspeech	['university of salento & cril-dream, lecce, italy', 'phoniatrics and communicative disorders rehabilitation center, dept. rehabilitation, asl lecce, italy', 'universita cattolica del sacro cuore, rome, italy']	13	Speech, Voice, and Hearing Disorders
ng21_interspeech		13	Speech, Voice, and Hearing Disorders
hair21_interspeech	['department of computer science & engineering, texas a&m university, usa', 'school of electrical engineering & telecommunications, university of new south wales, australia', 'sydney school of health sciences, the university of sydney, australia']	13	Speech, Voice, and Hearing Disorders
mirheidari21_interspeech	['department of computer science, university of sheffield, sheffield, uk', 'sheffield institute for translational neuroscience (sitran), university of sheffield, sheffield, uk']	13	Speech, Voice, and Hearing Disorders
yue21b_interspeech	['department of computer science, university of sheffield, uk', 'education, communication and language sciences, newcastle university, uk', 'north bristol nhs trust, uk', 'therapy box, london, uk']	13	Speech, Voice, and Hearing Disorders
xia21_interspeech	['department of computer science and technology, university of cambridge, uk']	13	Speech, Voice, and Hearing Disorders
wang21u_interspeech	"['the chinese university of hong kong, hong kong sar, china', ""huawei noah's ark lab, china""]"	13	Speech, Voice, and Hearing Disorders
bhattacharjee21_interspeech	['indian institute of science, india', 'national institute of mental health and neurosciences, india']	13	Speech, Voice, and Hearing Disorders
haulcy21_interspeech	['computer science and artificial intelligence laboratory', 'massachussetts institute of technology', 'cambridge, ma 02139, usa']	13	Speech, Voice, and Hearing Disorders
nortje21_interspeech	['department of e&e engineering, stellenbosch university, south africa']	10	Speech Recognition: Technologies and Systems for New Applications
sanabria21_interspeech	['the university of edinburgh, uk', 'google research, usa']	10	Speech Recognition: Technologies and Systems for New Applications
zhao21b_interspeech	['college of computer science and electronic engineering, hunan university, china']	10	Speech Recognition: Technologies and Systems for New Applications
wang21v_interspeech	['college of intelligence and computing, tianjin university, tianjin, china', 'tianjin international engineering institute, tianjin university, tianjin, china', 'institute of linguistics, chinese academy of social science, beijing, china', 'shenzhen research institute of big data, the chinese university of hong kong, shenzhen, china']	10	Speech Recognition: Technologies and Systems for New Applications
olaleye21_interspeech		10	Speech Recognition: Technologies and Systems for New Applications
khorrami21_interspeech	['unit of computing sciences, tampere university, finland', 'department of signal processing and acoustics, aalto university, finland']	10	Speech Recognition: Technologies and Systems for New Applications
chen21k_interspeech	['university of science and technology of china, hefei 230027, china', 'iflytek, hefei 230088, china', 'georgia institute of technology, atlanta, ga. 30332-0250, usa']	10	Speech Recognition: Technologies and Systems for New Applications
rouditchenko21b_interspeech	['mit csail, usa', 'ut austin, usa', 'ibm research ai, usa', 'columbia university, usa', 'nyu, usa']	10	Speech Recognition: Technologies and Systems for New Applications
ma21c_interspeech	['ibug group, imperial college london, uk', 'facebook london, uk', 'chair of embedded intelligence for health care and wellbeing, university of augsburg, germany']	10	Speech Recognition: Technologies and Systems for New Applications
rose21_interspeech	['google inc., new york, usa']	10	Speech Recognition: Technologies and Systems for New Applications
wu21e_interspeech	['moe key lab of artificial intelligence, ai institute', 'x-lance lab, department of computer science and engineering', 'shanghai jiao tong university, shanghai, china', 'tal education group, china']	10	Speech Recognition: Technologies and Systems for New Applications
chen21l_interspeech		5	Analysis of Speech and Audio Signals
ali21_interspeech	['iit jammu, india']	5	Analysis of Speech and Audio Signals
han21d_interspeech	['columbia university, usa', 'shanghai jiao tong university, china', 'microsoft corporation, usa', 'ntt corporation, japan', 'johns hopkins university, usa', 'google research, usa']	5	Analysis of Speech and Audio Signals
yuan21_interspeech	['tianjin key laboratory of autonomous intelligence technology and systems, tiangong', 'university, china', 'japan advanced institute of science and technology, nomi, ishikawa, japan', 'centre for vision, speech and signal processing, university of surrey, guildford, uk']	5	Analysis of Speech and Audio Signals
wang21w_interspeech	['school of information science and engineering, xinjiang university, urumqi, china', 'national institute of information and communications technology (nict), kyoto, japan']	5	Analysis of Speech and Audio Signals
nakagome21_interspeech	['department of communications and computer engineering, waseda university, tokyo, japan', 'line corporation, tokyo, japan']	5	Analysis of Speech and Audio Signals
huang21h_interspeech	['national taiwan university, taiwan', 'university of edinburgh, uk']	5	Analysis of Speech and Audio Signals
wang21x_interspeech	['institute of information science, academia sinica, taiwan', 'department of electrical engineering, national taiwan university, taiwan']	5	Analysis of Speech and Audio Signals
wu21f_interspeech		5	Analysis of Speech and Audio Signals
luo21c_interspeech	['department of electrical engineering, columbia university, usa']	5	Analysis of Speech and Audio Signals
xu21i_interspeech		6	Speech Coding and Enhancement
liu21j_interspeech	['georgia institute of technology, ga, usa', 'amazon alexa speech, ca, usa']	4	Speaker and Language Identification
jung21_interspeech	['naver corporation, south korea']	4	Speaker and Language Identification
wan21_interspeech	['artificial intelligence application research center, huawei technologies', 'shenzhen, prc']	4	Speaker and Language Identification
takashima21_interspeech	['hitachi, ltd. research & development group, japan', 'language technologies institute, carnegie mellon university, usa', 'center for language and speech processing, johns hopkins university, usa']	4	Speaker and Language Identification
kwon21b_interspeech	['naver corporation, south korea']		
wang21y_interspeech	['university of science and technology of china, hefei, anhui, p.r.china', 'iflytek research, hefei, anhui, china', 'georgia institute of technology, atlanta, ga, usa']	4	Speaker and Language Identification
bredin21_interspeech	['irit, universite de toulouse, cnrs, toulouse, france', 'lium , universite du mans, france']	4	Speaker and Language Identification
xue21d_interspeech	['hitachi, ltd. research & development group, japan', 'language technologies institute, carnegie mellon university, usa', 'center for language and speech processing, johns hopkins university, usa']	4	Speaker and Language Identification
anidjar21_interspeech	['department of computer science, ariel university, israel', 'afeka tel-aviv academic college of engineering, aclp, israel', 'avignon university, lia, france', 'department of industrial engineering and management, ariel university, israel']		
futamata21_interspeech	['line corp., tokyo, japan']	7	Speech Synthesis and Spoken Language Generation
vallesperez21_interspeech		7	Speech Synthesis and Spoken Language Generation
du21b_interspeech	['moe key lab of artificial intelligence, ai institute', 'x-lance lab, department of computer science and engineering', 'shanghai jiao tong university, shanghai, china']	7	Speech Synthesis and Spoken Language Generation
fujita21_interspeech		7	Speech Synthesis and Spoken Language Generation
zou21_interspeech	['bytedance ai-lab, china']	7	Speech Synthesis and Spoken Language Generation
sharma21b_interspeech	['amazon prime video international expansion, bangalore, india', 'amazon ai labs, east palo alto, usa', 'amazon alexa tts, cambridge, uk']	7	Speech Synthesis and Spoken Language Generation
zhang21u_interspeech	['department of electronic engineering, the chinese university of hong kong, china', 'institute of information science, beijing jiaotong university, china']	7	Speech Synthesis and Spoken Language Generation
baird21_interspeech	['chair of embedded intelligence for health care & wellbeing, university of augsburg, germany', 'chair of human-centered artificial intelligence, university of augsburg, germany', 'glam – group on language, audio, & music, imperial college london, uk']	7	Speech Synthesis and Spoken Language Generation
yoshinaga21_interspeech	['toyohashi university of technology, japan', 'osaka university dental hospital, japan']	1	Speech Perception, Production and Acquisition  by Human Listeners
arai21b_interspeech	['sophia university, tokyo, japan']	1	Speech Perception, Production and Acquisition  by Human Listeners
tanji21_interspeech	['department of information sciences, tokyo university of science, tokyo, japan']	1	Speech Perception, Production and Acquisition  by Human Listeners
inaam21_interspeech	['department of mechanical engineering, toyohashi university of technology, japan', 'department of information and communication sciences, sophia university, japan']	1	Speech Perception, Production and Acquisition  by Human Listeners
werner21_interspeech	['language science and technology, saarland university, saarbrucken, germany', '¨', 'laborphonologie, leibniz centre general linguistics (zas), berlin, germany']	1	Speech Perception, Production and Acquisition  by Human Listeners
xu21j_interspeech		1	Speech Perception, Production and Acquisition  by Human Listeners
elmers21_interspeech	['language science and technology, saarland university, saarbrucken, germany', '¨']	1	Speech Perception, Production and Acquisition  by Human Listeners
chen21m_interspeech	['department of computer sciences, university of wisconsin-madison, usa', 'department of biomedical engineering, worcester polytechnic institute, usa', 'department of communication sciences and disorders, university of wisconsin-madison, usa']	1	Speech Perception, Production and Acquisition  by Human Listeners
kawahara21_interspeech		1	Speech Perception, Production and Acquisition  by Human Listeners
you21c_interspeech	['department of electrical engineering, yale university, ct, usa', 'adsplab, school of ece, peking university, shenzhen, china', 'peng cheng laboratory, shenzhen, china']	11	Spoken Dialog Systems and Conversational Analysis
duan21_interspeech	['nanchang university, china', 'eth zurich, switzerland', 'singapore management university, singapore']	11	Spoken Dialog Systems and Conversational Analysis
rohmatillah21_interspeech	['dept of electrical and computer engineering, national yang ming chiao tung university, taiwan']	11	Spoken Dialog Systems and Conversational Analysis
fujie21_interspeech	['chiba institute of technology, japan', 'waseda university, japan']	11	Spoken Dialog Systems and Conversational Analysis
chen21n_interspeech	['alibaba group, china']	11	Spoken Dialog Systems and Conversational Analysis
sundararaman21_interspeech	['observe.ai, india']	11	Spoken Dialog Systems and Conversational Analysis
luo21d_interspeech	['mit csail, usa', 'amazon ai, usa']	11	Spoken Dialog Systems and Conversational Analysis
shenoy21_interspeech	['amazon aws ai, usa']	11	Spoken Dialog Systems and Conversational Analysis
li21h_interspeech	['school of informatics, xiamen university, china', 'school of electronic science and engineering, xiamen university, china', 'center for speech and language technologies, tsinghua university, china']	4	Speaker and Language Identification
duroselle21b_interspeech	['universite de lorraine, cnrs, inria, loria, f-54000 nancy, france']	4	Speaker and Language Identification
kong21b_interspeech	['institute of microelectronics, tsinghua university', 'kwai, beijing, p.r. china']	4	Speaker and Language Identification
wang21z_interspeech	['hithink royalflush ai research institute, zhejiang, china', 'national institute of information and communications technology (nict), kyoto, japan']	4	Speaker and Language Identification
yu21b_interspeech	['beijing national research center for information science and technology,', 'department of electronic engineering, tsinghua university, beijing 100084, china', 'tal education', ' zhongguancun avenue, beijing 100080, china']	4	Speaker and Language Identification
li21i_interspeech	['school of electronic science and engineering, xiamen university, china', 'school of informatics, xiamen university, china']	4	Speaker and Language Identification
jahchan21_interspeech	['apsys-airbus, france', 'airbus, france']	10	Speech Recognition: Technologies and Systems for New Applications
szoke21_interspeech		10	Speech Recognition: Technologies and Systems for New Applications
ohneiser21_interspeech	['german aerospace center (dlr), institute of flight guidance, braunschweig, germany', 'idiap research institute, martigny, switzerland', 'state enterprise ”oro navigacija“ (on), air navigation service provider of lithuania']	10	Speech Recognition: Technologies and Systems for New Applications
zuluagagomez21_interspeech	['idiap research institute, martigny, switzerland', 'ecole polytechnique federale de lausanne (epfl), switzerland', 'replaywell, brno, czech republic']	10	Speech Recognition: Technologies and Systems for New Applications
kocour21_interspeech	['saarland university, saarbrucken, germany', 'idiap research institute, martigny, switzerland', 'ecole polytechnique federale de lausanne (epfl), switzerland']	10	Speech Recognition: Technologies and Systems for New Applications
elie21_interspeech	['universite paris-saclay, cnrs, laboratoire interdisciplinaire des sciences du numerique', ',', 'orsay, france', 'vocapia research, orsay, france']	5	Analysis of Speech and Audio Signals
milde21_interspeech	['language technology group, dept. of informatics, universitat hamburg, germany', '¨', 'hamburger informatik technologie-center e.v. (hitec e.v.), germany']		
wilbrandt21_interspeech	['institute of acoustics and speech communication, technische universitat dresden, germany', '¨']		
codinafilba21_interspeech	['universitat pompeu fabra, barcelona, spain', 'universitat de barcelona, barcelona, spain']		
rownicka21_interspeech	['aflorithmic labs ltd., united kingdom']		
geislinger21_interspeech	['hamburger informatik technologie-center e.v., germany', 'language technology group, universitat hamburg, germany', '¨']		
nicmanis21_interspeech	['tilde sia', 'vienibas gatve 75a, riga, latvia', 'faculty of computing, university of latvia', 'raina bulvaris 19, riga, latvia']		
kachare21_interspeech			
ribeiro21b_interspeech	['universite de lorraine, cnrs, inria, loria, nancy, france', 'universite de lorraine, inserm, u1254, iadi, nancy, france', 'service de medecine bucco-dentaire, hopital maison blanche, reims, france']	1	Speech Perception, Production and Acquisition  by Human Listeners
blandin21_interspeech	"['institute of acoustics and speech communication, tu dresden, dresden 01062, germany', 'gtm - grup de recerca en tecnologies media, la salle, universitat ramon llull c/quatre', 'camins 30', ' barcelona, catalonia spain', ""laboratoire d'acoustique de l'universite du mans (laum), umr 6613, institut d'acoustique"", 'graduate school (ia-gs), cnrs, le mans universite, le mans 72085, france', 'laboratoire de mecanique des structures et des systemes couples, conservatoire national des', 'arts et metiers, paris 75003, france']"	1	Speech Perception, Production and Acquisition  by Human Listeners
wagner21b_interspeech	['faculty of linguistics and literary studies, bielefeld university, germany', 'center for cognitive interaction technology (citec), bielefeld university, germany']	1	Speech Perception, Production and Acquisition  by Human Listeners
medina21_interspeech	['carnegie mellon university, usa', 'university of east anglia, uk', 'haskins laboratories, usa', 'epic games, usa']	1	Speech Perception, Production and Acquisition  by Human Listeners
georges21_interspeech	['univ. grenoble alpes, cnrs, gipsa-lab', ' grenoble, france', 'univ. grenoble alpes, cnrs, lpnc', ' grenoble, france']	1	Speech Perception, Production and Acquisition  by Human Listeners
weston21_interspeech	['leibniz-zentrum allgemeine sprachwissenschaft, germany', 'adelphi university, usa']	2	Phonetics, Phonology, and Prosody
vali21_interspeech	['department of signal processing and acoustics, aalto university, finland']	6	Speech Coding and Enhancement
nareddula21_interspeech	['department of electrical engineering, indian institute of technology, tirupati, india']	6	Speech Coding and Enhancement
marcinek21_interspeech	['department of electrical and electronic engineering, university of manchester, uk', 'manchester centre for audiology and deafness, university of manchester, uk']	6	Speech Coding and Enhancement
xia21b_interspeech	['department of electrical and computer engineering, carnegie mellon university, usa', 'language technologies institute, carnegie mellon university, usa']	3	Paralinguistics in Speech and Language: Human and Automatic Analysis and Processing
li21j_interspeech	['tal education group, beijing, china']	3	Paralinguistics in Speech and Language: Human and Automatic Analysis and Processing
vaaras21_interspeech	['unit of computing sciences, tampere university, finland', 'department of clinical medicine, university of turku, finland', 'department of signal processing and acoustics, aalto university, finland']	3	Paralinguistics in Speech and Language: Human and Automatic Analysis and Processing
qian21_interspeech	['school of computer science and technology, harbin institute of technology, harbin, china']	3	Paralinguistics in Speech and Language: Human and Automatic Analysis and Processing
t21_interspeech	['university of nottingham, nottingham, uk', 'queen mary university london, london, uk', 'unilever r&d port sunlight, uk']	3	Paralinguistics in Speech and Language: Human and Automatic Analysis and Processing
li21k_interspeech	['amazon aws ai, usa', 'dept. of electrical and computer engineering, university of southern california, usa', 'amazon lab126, usa']	3	Paralinguistics in Speech and Language: Human and Automatic Analysis and Processing
pepino21_interspeech	['instituto de investigacion en ciencias de la computacion (icc), conicet-uba, argentina', 'departamento de computacion, fceyn, universidad de buenos aires (uba), argentina']	3	Paralinguistics in Speech and Language: Human and Automatic Analysis and Processing
liu21k_interspeech	['school of computer science and engineering, south china university of technology, china']	3	Paralinguistics in Speech and Language: Human and Automatic Analysis and Processing
kumawat21_interspeech	['indian institute of technology kharagpur, india']	3	Paralinguistics in Speech and Language: Human and Automatic Analysis and Processing
keesing21_interspeech	['school of computer science, university of auckland, new zealand']	3	Paralinguistics in Speech and Language: Human and Automatic Analysis and Processing
shon21_interspeech	['asapp, usa', 'carnegie mellon university, usa']	3	Paralinguistics in Speech and Language: Human and Automatic Analysis and Processing
hou21b_interspeech	['tokyo institute of technology, japan', 'microsoft research asia, china']	8	Speech Recognition: Signal Processing, Acoustic Modeling, Robustness, Adaptation
kanda21_interspeech		8	Speech Recognition: Signal Processing, Acoustic Modeling, Robustness, Adaptation
lu21b_interspeech	['microsoft corp., usa']	8	Speech Recognition: Signal Processing, Acoustic Modeling, Robustness, Adaptation
kim21j_interspeech	['google inc., usa']	8	Speech Recognition: Signal Processing, Acoustic Modeling, Robustness, Adaptation
diwan21b_interspeech	['department of computer science and engineering, indian institute of technology bombay, india']	8	Speech Recognition: Signal Processing, Acoustic Modeling, Robustness, Adaptation
fukuda21_interspeech		8	Speech Recognition: Signal Processing, Acoustic Modeling, Robustness, Adaptation
ray21_interspeech		8	Speech Recognition: Signal Processing, Acoustic Modeling, Robustness, Adaptation
lu21c_interspeech	['google inc., usa']	8	Speech Recognition: Signal Processing, Acoustic Modeling, Robustness, Adaptation
delrio21_interspeech	['rev.com, usa']	8	Speech Recognition: Signal Processing, Acoustic Modeling, Robustness, Adaptation
sun21c_interspeech	['microsoft speech and language group, redmond, wa, usa', 'microsoft research asian, beijing, china']	8	Speech Recognition: Signal Processing, Acoustic Modeling, Robustness, Adaptation
ali21b_interspeech	['qatar computing research institute, hbku, doha, qatar', 'kanari ai, california, usa', 'university of helwan, egypt']	8	Speech Recognition: Signal Processing, Acoustic Modeling, Robustness, Adaptation
eisenberg21_interspeech	['faculty of engineering, bar-ilan university, ramt-gan, israel']	5	Analysis of Speech and Audio Signals
luo21e_interspeech	['department of electrical engineering, columbia university, usa']	5	Analysis of Speech and Audio Signals
neumann21_interspeech	['paderborn university, germany', 'ntt corporation, japan']	5	Analysis of Speech and Audio Signals
zhang21v_interspeech	['university of sheffield, department of computer science, sheffield, uk', 'toshiba cambridge research laboratory, cambridge, uk']	5	Analysis of Speech and Audio Signals
delcroix21_interspeech	['ntt corporation, japan']	5	Analysis of Speech and Audio Signals
han21e_interspeech	['department of electrical engineering, columbia university, usa']	5	Analysis of Speech and Audio Signals
hu21_interspeech	['upload ai llc, usa', 'university of tubingen, germany', 'rice university, usa', 'baylor college of medicine, usa']	5	Analysis of Speech and Audio Signals
sarkar21_interspeech	['centre for digital music, queen mary university of london, united kingdom']	5	Analysis of Speech and Audio Signals
maciejewski21_interspeech	['center for language and speech processing, the johns hopkins university, usa', 'human language technology center of excellence, the johns hopkins university, usa', 'language technologies institute, carnegie mellon university, usa']	5	Analysis of Speech and Audio Signals
lan21_interspeech	['school of information and software engineering,', 'university of electronic science and technology of china, chengdu, sichuan, china']	5	Analysis of Speech and Audio Signals
deng21c_interspeech	['didi chuxing, beijing, china', 'baidu, inc., beijing, china']	5	Analysis of Speech and Audio Signals
wang21aa_interspeech	['department of electrical and computer engineering, national university of singapore, singapore']	5	Analysis of Speech and Audio Signals
rigal21_interspeech	['orange labs, lannion, france', 'ensta bretagne, lab-sticc, brest, france']	5	Analysis of Speech and Audio Signals
singh21_interspeech	['learning and extraction of acoustic patterns (leap) lab,', 'electrical engineering, indian institute of science, bangalore, india.']	4	Speaker and Language Identification
zhang21w_interspeech		4	Speaker and Language Identification
he21c_interspeech	['university of science and technology of china, hefei, china', 'center for language and speech processing, the johns hopkins university, baltimore, md', 'microsoft corp, redmond, wa']	4	Speaker and Language Identification
dawalatabad21_interspeech	['indian institute of technology madras, india', 'mila - quebec artificial intelligence institute, canada', 'universite de sherbrooke, canada', 'idlab, ghent university - imec, belgium', 'samsung advanced institute of technology, suwon, south korea']	4	Speaker and Language Identification
kinoshita21_interspeech	['ntt corporation, japan']	4	Speaker and Language Identification
ryant21_interspeech	['linguistic data consortium, university of pennsylvania, philadelphia, pa, usa', 'leap lab, electrical engineering, indian institute of science, bangalore, india', 'baidu research, sunnyvale, ca, usa', 'university of science and technology of china, hefei, china']	4	Speaker and Language Identification
leung21_interspeech	['fano labs, hong kong, china']	4	Speaker and Language Identification
obrien21_interspeech	"['aix-marseille univ, cnrs, lpl, umr 7309, france', ""laboratoire informatique d'avignon, universite d'avignon, avignon, france""]"	4	Speaker and Language Identification
karra21_interspeech			
hong21_interspeech	['ping an technology (shenzhen) co., ltd., china']		
nguyen21e_interspeech	['yonsei university, seoul, korea,', 'search solutions inc., seongnam, korea,', 'naver corp., seongnam, korea']		
tang21b_interspeech	['microsoft research asia, beijing, china', 'university of science and technology of china, hefei, china']	7	Speech Synthesis and Spoken Language Generation
jeong21_interspeech	['department of electrical and computer engineering and inmc, seoul national university, seoul,', 'south korea', 'neosapience, inc., seoul, south korea']	7	Speech Synthesis and Spoken Language Generation
bae21_interspeech	['speech ai lab, ncsoft, seongnam, republic of korea']	7	Speech Synthesis and Spoken Language Generation
polyak21_interspeech		7	Speech Synthesis and Spoken Language Generation
karanasou21_interspeech	['amazon research, cambridge, united kingdom']	7	Speech Synthesis and Spoken Language Generation
paul21_interspeech	['computer science department, university of crete, greece', 'istituto italiano di tecnologia, italy', 'iacm, foundation for research and technology - hellas, greece']	7	Speech Synthesis and Spoken Language Generation
wu21g_interspeech	['nagoya university, japan', 'academia sinica, taiwan']	7	Speech Synthesis and Spoken Language Generation
chung21_interspeech	['department of artificial intelligence, korea university, seoul, korea', 'department of brain and cognitive engineering, korea university, seoul, korea']	7	Speech Synthesis and Spoken Language Generation
lin21g_interspeech	['tencent, beijing, china']	7	Speech Synthesis and Spoken Language Generation
casanova21b_interspeech	['instituto de ciencias matematicas e de computacao, university of sao paulo, brazil', 'definedcrowd corp., united states of america', 'coqui, germany', 'fraunhofer aisec, germany', 'federal university of goias, brazil', 'federal university of technology – parana, brazil']	7	Speech Synthesis and Spoken Language Generation
palmer21_interspeech	['mit csail, usa']	10	Speech Recognition: Technologies and Systems for New Applications
salesky21_interspeech		12	Spoken Language Processing: Translation, Information Retrieval, Summarization, Resources and Evaluation
mortensen21_interspeech		12	Spoken Language Processing: Translation, Information Retrieval, Summarization, Resources and Evaluation
fu21b_interspeech	"[""northwestern polytechnical university, xi'an, china"", 'microsoft corporation, usa', 'microsoft corporation, china', 'beijing shell shell technology co., ltd., beijing, china', 'university of science and technology of china, hefei, china']"	12	Spoken Language Processing: Translation, Information Retrieval, Summarization, Resources and Evaluation
chen21o_interspeech	['speechcolab, china', 'seasalt ai inc, usa', 'department of electronic engineering, tsinghua university, china', 'clsp & hltcoe, the johns hopkins university, usa', 'tencent ai lab, china', 'xiaomi corporation, china', 'carnegie mellon university, usa', 'ke holdings inc, china']	12	Spoken Language Processing: Translation, Information Retrieval, Summarization, Resources and Evaluation
kim21k_interspeech	['naver corporation, south korea']	12	Spoken Language Processing: Translation, Information Retrieval, Summarization, Resources and Evaluation
ahmed21_interspeech		12	Spoken Language Processing: Translation, Information Retrieval, Summarization, Resources and Evaluation
fallgren21_interspeech	['kth royal institute of technology, sweden']	12	Spoken Language Processing: Translation, Information Retrieval, Summarization, Resources and Evaluation
ryumina21_interspeech	['st. petersburg institute for informatics and automation of the russian academy of sciences,', 'st. petersburg federal research center of the russian academy of sciences (spc ras), russia']	12	Spoken Language Processing: Translation, Information Retrieval, Summarization, Resources and Evaluation
garcesdiazmunio21_interspeech	"['adria gimenez, javier iranzo-sanchez, pau baquero-arnal, nahuel rosello,', 'alejandro perez-gonzalez-de-martos, jorge civera, albert sanchis and alfons juan', 'machine learning and language processing (mllp) research group', ""institut valencia d'investigacio en intel·ligencia artificial (vrain)"", 'universitat politecnica de valencia', 'cami de vera s/n', ', valencia, spain']"	12	Spoken Language Processing: Translation, Information Retrieval, Summarization, Resources and Evaluation
kapoor21_interspeech		12	Spoken Language Processing: Translation, Information Retrieval, Summarization, Resources and Evaluation
cho21b_interspeech	['dept. of ece and inmc, seoul national university, seoul, korea', 'papago, naver, seongnam, korea']	12	Spoken Language Processing: Translation, Information Retrieval, Summarization, Resources and Evaluation
zhang21x_interspeech	['xiaomi corporation, beijing, china', 'speechocean ltd., beijing, china']	12	Spoken Language Processing: Translation, Information Retrieval, Summarization, Resources and Evaluation
fan21b_interspeech	['dept. of electrical and computer engineering, university of california, los angeles, usa', 'paii inc., usa']	9	Speech Recognition: Architecture, Search, and Linguistic Components
guo21_interspeech	['carnegie mellon university, usa']	9	Speech Recognition: Architecture, Search, and Linguistic Components
ng21b_interspeech	['google research, brain team, usa', 'google research, brain team, canada']	9	Speech Recognition: Architecture, Search, and Linguistic Components
liu21l_interspeech	['computer science and artificial intelligence laboratory', 'massachusetts institute of technology, usa']	9	Speech Recognition: Architecture, Search, and Linguistic Components
nozaki21_interspeech	['line corporation, japan', 'kyoto university, japan']	9	Speech Recognition: Architecture, Search, and Linguistic Components
fujita21b_interspeech		9	Speech Recognition: Architecture, Search, and Linguistic Components
lee21e_interspeech	['naver corporation, korea', 'carnegie mellon university, usa']	9	Speech Recognition: Architecture, Search, and Linguistic Components
li21l_interspeech	[', fuchuan tong1, dexin liao , lin li', ', qingyang hong2', 'school of electronic science and engineering, xiamen university, china', 'school of informatics, xiamen university, china']	8	Speech Recognition: Signal Processing, Acoustic Modeling, Robustness, Adaptation
wang21ba_interspeech		9	Speech Recognition: Architecture, Search, and Linguistic Components
beliaev21_interspeech	['nvidia, santa clara, usa']	7	Speech Synthesis and Spoken Language Generation
chen21p_interspeech	['brain team, google research, usa', 'brain team, google research, japan', 'brain team, google research, canada']	7	Speech Synthesis and Spoken Language Generation
chen21q_interspeech		9	Speech Recognition: Architecture, Search, and Linguistic Components
lu21d_interspeech	['dept. of systems engineering & engineering management, chinese university of hong kong', 'centre for perceptual and interactive intelligence, cuhk', 'tsinghua-cuhk joint research center for media sciences, technologies and systems,', 'shenzhen international graduate school, tsinghua university, shenzhen, china', 'department of engineering, university of cambridge, uk', 'huya inc., guangzhou, china']	9	Speech Recognition: Architecture, Search, and Linguistic Components
luz21_interspeech	['usher institute, edinburgh medical school, the university of edinburgh, uk', 'department of psychology, carnegie mellon university, usa']	10	Speech Recognition: Technologies and Systems for New Applications
pereztoro21_interspeech	['pattern recognition lab. friedrich-alexander universitat, erlangen-nurnberg, erlangen, germany', 'facultad de ingenieria. universidad de antioquia udea, calle 70 no. 52-21, medellin, colombia', 'technische hochschule george simon ohm, nurnberg, germany', 'department of otorhinolaryngology, head and neck surgery. ludwig-maximilians university,', 'munich, germany']	10	Speech Recognition: Technologies and Systems for New Applications
zhu21e_interspeech	['department of computer science, university of massachusetts boston, ma, usa', 'school of medicine, university of north carolina, chapel hill, nc, usa', 'geisel school of medicine at dartmouth, lebanon, nh, usa']	10	Speech Recognition: Technologies and Systems for New Applications
gauder21_interspeech	['instituto de investigacion en ciencias de la computacion (icc),', 'conicet-uba, argentina', 'departamento de computacion, facultad de ciencias exactas y naturales,', 'universidad de buenos aires (uba), argentina']	10	Speech Recognition: Technologies and Systems for New Applications
balagopalan21_interspeech	['winterlight labs, toronto, canada', 'university of toronto, toronto, canada']	10	Speech Recognition: Technologies and Systems for New Applications
qiao21_interspeech	['rwth aachen university, germany', 'university of amsterdam, netherlands']	10	Speech Recognition: Technologies and Systems for New Applications
pan21c_interspeech	['department of computer science, university of sheffield, uk', 'division of neuroscience and experimental psychology, university of manchester, uk', 'department of psychology, university of exeter, uk', 'cerebral function unit, manchester centre for clinical neurosciences, salford royal nhs', 'foundation trust, salford uk', 'department of neuroscience, university of sheffield, uk']		
syed21_interspeech	['mehran university, pakistan', 'rmit university, australia']	10	Speech Recognition: Technologies and Systems for New Applications
rohanian21_interspeech	['cognitive science group', 'school of electronic engineering and computer science', 'queen mary university of london, uk', 'department of knowledge technologies, jozef stefan institute, slovenia']	10	Speech Recognition: Technologies and Systems for New Applications
pappagari21_interspeech		10	Speech Recognition: Technologies and Systems for New Applications
chen21r_interspeech	['department of computational medicine and bioinformatics, university of michigan, usa', 'department of computer science and engineering, michigan state university, usa']	10	Speech Recognition: Technologies and Systems for New Applications
wang21ca_interspeech	['∗', '3 , k.p. subbalakshmi1', 'stevens institute of technology, nj, usa', 'center for advances systems understanding, g¨orlitz, germany', 'helmholtz-zentrum dresden-rossendorf, dresden, germany']	10	Speech Recognition: Technologies and Systems for New Applications
gong21d_interspeech	['nuance communications gmbh, vienna, austria', 'nuance communications inc., burlington, usa', 'nuance communications s.a., madrid, spain']	8	Speech Recognition: Signal Processing, Acoustic Modeling, Robustness, Adaptation
gretter21_interspeech	['fondazione bruno kessler, trento, italy', 'educational testing service, princeton, usa', 'cambridge university, cambridge, uk']	8	Speech Recognition: Signal Processing, Acoustic Modeling, Robustness, Adaptation
rumberg21_interspeech	['institut fur informationsverarbeitung, leibniz university hannover, germany', 'institut fur sonderpadagogik, leibniz university hannover, germany']	8	Speech Recognition: Signal Processing, Acoustic Modeling, Robustness, Adaptation
cornell21_interspeech	['universita politecnica delle marche, italy', 'fondazione bruno kessler, italy']	8	Speech Recognition: Signal Processing, Acoustic Modeling, Robustness, Adaptation
gelin21_interspeech	['irit, paul sabatier university, cnrs, toulouse, france', 'lalilo, france']	8	Speech Recognition: Signal Processing, Acoustic Modeling, Robustness, Adaptation
stephenson21_interspeech	['universite grenoble alpes, cnrs, grenoble inp, gipsa-lab', ' grenoble, france', 'lig, uga, g-inp, cnrs, inria, grenoble, france', 'naver labs europe, france']	7	Speech Synthesis and Spoken Language Generation
rijn21_interspeech	['max-planck-institute for empirical aesthetics, frankfurt, germany', 'human-centered artificial intelligence, augsburg, germany', 'max-planck-nyu, center for language, music, and emotion, new york, usa']	7	Speech Synthesis and Spoken Language Generation
mohan21_interspeech	['papercup technologies ltd., united kingdom', 'university of edinburgh, united kingdom']	7	Speech Synthesis and Spoken Language Generation
torresquintero21_interspeech	['papercup technologies ltd., united kingdom', 'university of edinburgh, united kingdom']	7	Speech Synthesis and Spoken Language Generation
trang21_interspeech	"['hanoi university of science and technology, vietnam', 'universite paris saclay, cnrs, lisn, france', ""institut jean le rond d'alembert, sorbonne universite, umr7190 cnrs, paris france""]"	7	Speech Synthesis and Spoken Language Generation
dovrat21_interspeech	['blavatnik school of computer science, tel aviv university, israel', 'facebook ai research, israel']	5	Analysis of Speech and Audio Signals
fras21_interspeech	['agh university of science and technology, institute of electronics, krakow, poland']	5	Analysis of Speech and Audio Signals
strauss21_interspeech	['international audio laboratories erlangen*, germany', 'fraunhofer institute for integrated circuits iis, erlangen, germany']	5	Analysis of Speech and Audio Signals
borsdorf21b_interspeech	['machine listening lab (mll), university of bremen, germany', 'department of electrical and computer engineering, national university of singapore, singapore', 'cognitive systems lab (csl), university of bremen, germany']	5	Analysis of Speech and Audio Signals
tsukada21_interspeech	['macquarie university, australia', 'inner mongolia university, china', 'konkuk university, korea', 'the university of melbourne, australia']	1	Speech Perception, Production and Acquisition  by Human Listeners
korzekwa21_interspeech	['amazon, poland', 'gdansk university of technology, faculty of eti, poland', 'amazon, uk', 'amazon, usa']	1	Speech Perception, Production and Acquisition  by Human Listeners
braun21_interspeech	['university of konstanz, department of linguistics, germany', 'university of trier, department ii, phonetics, germany']	1	Speech Perception, Production and Acquisition  by Human Listeners
zhang21y_interspeech	['nanjing university of science and technology, nanjing, jiangsu, china']	1	Speech Perception, Production and Acquisition  by Human Listeners
mirzaei21_interspeech	['riken center for advanced intelligence project (aip), tokyo, japan']	1	Speech Perception, Production and Acquisition  by Human Listeners
ding21b_interspeech	['speech-language-hearing center, school of foreign languages', 'shanghai jiao tong university, china', 'smart platform product department, tencent technology co., ltd, china']		
lin21h_interspeech	['smart platform product department, tencent technology co., ltd, china']	1	Speech Perception, Production and Acquisition  by Human Listeners
kudera21_interspeech	['language science and technology, saarland university, saarbrucken, germany', 'spoken language systems (lsv), saarland university, saarbrucken, germany']	1	Speech Perception, Production and Acquisition  by Human Listeners
zhang21z_interspeech	['beijing language and culture university, china', 'smart platform product department, tencent technology co., ltd, china']	1	Speech Perception, Production and Acquisition  by Human Listeners
wu21h_interspeech	['human-computer communications laboratory,', 'department of system engineering and engineering management,', 'the chinese university of hong kong, hksar, china', 'speechx limited, china', 'centre for perceptual and interactive intelligence (cpii) limited, hksar, china']	1	Speech Perception, Production and Acquisition  by Human Listeners
graham21_interspeech	['phonetics laboratory, university of cambridge, uk']	1	Speech Perception, Production and Acquisition  by Human Listeners
oh21b_interspeech	['department of linguistics, university of southern california, usa', 'department of electrical and computer engineering, university of southern california, usa']	2	Phonetics, Phonology, and Prosody
liu21m_interspeech	['university college london, uk']	2	Phonetics, Phonology, and Prosody
hejna21_interspeech	['aarhus university, denmark']	2	Phonetics, Phonology, and Prosody
muhlack21_interspeech	['language science and technology, saarland university, saarbrucken, germany']	2	Phonetics, Phonology, and Prosody
ge21b_interspeech	['the chinese university of hong kong, china']	2	Phonetics, Phonology, and Prosody
huang21i_interspeech	['institute of linguistics, national tsing hua university, taiwan, r.o.c.']		
gibson21_interspeech	['universidad de navarra, spain', 'lmu-munich, germany']	2	Phonetics, Phonology, and Prosody
gully21_interspeech	['department of language and linguistic science, university of york, york, uk']	2	Phonetics, Phonology, and Prosody
guevararukoz21_interspeech	['laboratoire de sciences cognitives et psycholinguistique, ecole normale superieure – psl', 'university / ehess / cnrs, france', 'school of engineering, the university of tokyo, tokyo, japan', 'laboratoire de phonetique et phonologie, universite sorbonne nouvelle / cnrs, france']	2	Phonetics, Phonology, and Prosody
guo21b_interspeech	['department of linguistics, the university of texas at austin, usa']	2	Phonetics, Phonology, and Prosody
meister21_interspeech	['tallinn university of technology, estonia']	2	Phonetics, Phonology, and Prosody
dapolito21_interspeech	['university of salento – cril & dream, lecce, italy']	2	Phonetics, Phonology, and Prosody
heeringa21_interspeech	['fryske akademy, the netherlands', 'utrecht university, the netherlands']	2	Phonetics, Phonology, and Prosody
billington21_interspeech	['the australian national university, australia', 'the university of melbourne, australia', 'arc centre of excellence for the dynamics of language, australia']	2	Phonetics, Phonology, and Prosody
tian21_interspeech	['nlpr, institute of automation, chinese academy of sciences, beijing, china', 'school of artificial intelligence, university of chinese academy of sciences, beijing, china', 'cas center for excellence in brain science and intelligence technology, beijing, china']	8	Speech Recognition: Signal Processing, Acoustic Modeling, Robustness, Adaptation
mitrofanov21_interspeech	['itmo university, st. petersburg, russia', 'stc-innovations ltd, st. petersburg, russia']	9	Speech Recognition: Architecture, Search, and Linguistic Components
allauzen21_interspeech	['google research, united states']	9	Speech Recognition: Architecture, Search, and Linguistic Components
inaguma21b_interspeech	['graduate school of informatics, kyoto university, kyoto, japan']	9	Speech Recognition: Architecture, Search, and Linguistic Components
yao21_interspeech	"[""northwestern polytechnical university, xi'an, china"", 'mobvoi inc., beijing, china']"	9	Speech Recognition: Architecture, Search, and Linguistic Components
tanaka21b_interspeech	['ntt media intelligence laboratories, ntt corporation, japan']	9	Speech Recognition: Architecture, Search, and Linguistic Components
lee21f_interspeech	['department of electronics engineering', 'hanyang university, seoul, republic of korea']	9	Speech Recognition: Architecture, Search, and Linguistic Components
li21m_interspeech	['university of cambridge, uk', 'google llc, usa']	9	Speech Recognition: Architecture, Search, and Linguistic Components
qiu21b_interspeech	['google, llc, usa', 'university of cambridge, uk']	9	Speech Recognition: Architecture, Search, and Linguistic Components
ollerenshaw21_interspeech	['speech and hearing research group, university of sheffield, uk']	9	Speech Recognition: Architecture, Search, and Linguistic Components
afshan21_interspeech	['dept. of electrical and computer engineering, university of california, los angeles, ca, usa', 'microsoft corporation, redmond, wa, usa']	9	Speech Recognition: Architecture, Search, and Linguistic Components
tjandra21_interspeech	['nara institute of science and technology, japan', 'google research, brain team, usa', 'google llc, japan']	7	Speech Synthesis and Spoken Language Generation
choi21_interspeech	['kaist, south korea', 'naver corp., south korea']	7	Speech Synthesis and Spoken Language Generation
zhang21aa_interspeech	['databaker (beijing) technology co., ltd, beijing, china']		
li21n_interspeech	['ping an technology, china', 'national tsing hua university, taiwan']	7	Speech Synthesis and Spoken Language Generation
shi21d_interspeech	['xmov, china']		
chen21s_interspeech	['national engineering laboratory for speech and language information processing,', 'university of science and technology of china, hefei, p r. china', 'iflytek co., ltd., hefei, p r. china']	7	Speech Synthesis and Spoken Language Generation
zhou21f_interspeech	['nelslip, university of science and technology of china, hefei, p.r.china']	7	Speech Synthesis and Spoken Language Generation
novitasari21_interspeech	['nara institute of science and technology, japan', 'riken, center for advanced intelligence project (aip), japan']	7	Speech Synthesis and Spoken Language Generation
zhang21ba_interspeech	['∗', ',2 , yonghong yan1,2', 'key laboratory of speech acoustics & content understanding, institute of acoustics, cas, china', 'university of chinese academy of sciences, beijing, china', 'the xinjiang technical institute of physics & chemistry, cas, urumqi, china']	7	Speech Synthesis and Spoken Language Generation
mansbach21_interspeech	['computer science department, ariel university, israel']	5	Analysis of Speech and Audio Signals
fakhry21_interspeech	['university of alexandria, department of electronics and communication, egypt', 'duke university, department of biomedical engineering, usa', 'university of california san francisco, school of medicine, usa', 'stanford university, school of humanities and sciences, usa']		
ma21d_interspeech	['shanghai institute for advanced communication and data science (sics), shanghai university,', 'shanghai', ', china']	5	Analysis of Speech and Audio Signals
dhamyal21_interspeech	['lahore university of management sciences, pakistan']	5	Analysis of Speech and Audio Signals
yan21c_interspeech	['college of intelligent systems science and engineering, harbin engineering university, harbin,', ', china', 'chair of embedded intelligence for health care and wellbeing, university of augsburg, germany', 'institute of computational perception, johannes kepler university linz, austria', 'glam – group on language, audio, & music, imperial college london, uk']	5	Analysis of Speech and Audio Signals
paul21b_interspeech	['indian institute of technology, kharagpur']	5	Analysis of Speech and Audio Signals
takeda21_interspeech	['the institute of scientific and industrial research (sanken), osaka university, japan']	5	Analysis of Speech and Audio Signals
teh21_interspeech		5	Analysis of Speech and Audio Signals
fukumori21_interspeech	['college of information science and engineering, ritsumeikan university, japan']	5	Analysis of Speech and Audio Signals
baghel21_interspeech	['dept. of eee, indian institute of technology guwahati, guwahati-781039, india', 'dept. of ee, indian institute of technology dharwad, dharwad-580011, india']	5	Analysis of Speech and Audio Signals
gao21c_interspeech	['carnegie mellon university, usa', 'ai foundation, usa']	5	Analysis of Speech and Audio Signals
chen21t_interspeech	['college of computer science and electronic engineering, hunan university, china', 'school of computer engineering, nanyang techonological university, singapore']	5	Analysis of Speech and Audio Signals
abdullah21_interspeech	['spoken language systems (lsv), saarland university, germany', 'language science and technology (lst), saarland university, germany', 'saarland informatics campus, germany']	12	Spoken Language Processing: Translation, Information Retrieval, Summarization, Resources and Evaluation
gao21d_interspeech	['amazon alexa ai, seattle, usa']	12	Spoken Language Processing: Translation, Information Retrieval, Summarization, Resources and Evaluation
rikhye21_interspeech	['google llc, usa']	12	Spoken Language Processing: Translation, Information Retrieval, Summarization, Resources and Evaluation
garg21_interspeech	['†apple, usa', '‡apple, uk']	12	Spoken Language Processing: Translation, Information Retrieval, Summarization, Resources and Evaluation
mazumder21_interspeech	['harvard university, usa', 'coqui, germany', 'google, usa']	12	Spoken Language Processing: Translation, Information Retrieval, Summarization, Resources and Evaluation
wang21da_interspeech	['adsplab, school of ece, peking university, shenzhen, china', 'peng cheng laboratory, shenzhen, china']	12	Spoken Language Processing: Translation, Information Retrieval, Summarization, Resources and Evaluation
chen21u_interspeech	['department of information engineering, the chinese university of hong kong, china', 'department of computer science and engineering,', 'southern university of science and technology, china', 'department of computer science, city university of hong kong, china']	12	Spoken Language Processing: Translation, Information Retrieval, Summarization, Resources and Evaluation
lee21g_interspeech	['kakao corp, south korea', 'kakao enterprise, south korea', 'wisenut inc, south korea', 'hanshin university, south korea']	12	Spoken Language Processing: Translation, Information Retrieval, Summarization, Resources and Evaluation
zhou21g_interspeech	"[""huawei noah's ark lab, china""]"	12	Spoken Language Processing: Translation, Information Retrieval, Summarization, Resources and Evaluation
jia21b_interspeech	['data science research center, duke kunshan university, kunshan, china', 'ai lab of lenovo research, beijing, china', 'school of computer science, wuhan university, wuhan, china', 'school of electronics and information technology, sun yat-sen university,', 'guangzhou, china']	12	Spoken Language Processing: Translation, Information Retrieval, Summarization, Resources and Evaluation
wang21ea_interspeech	['paradigm inc., china', 'chalearn, usa', 'department of computer science and engineering', 'southern university of science and technology, china', 'college of electrical engineering and computer science, national taiwan university']	12	Spoken Language Processing: Translation, Information Retrieval, Summarization, Resources and Evaluation
berg21_interspeech	['arm ml research lab, uk', 'lund university, sweden']	12	Spoken Language Processing: Translation, Information Retrieval, Summarization, Resources and Evaluation
awasthi21_interspeech	['google research, switzerland', 'indian institute of technology bombay, india']	12	Spoken Language Processing: Translation, Information Retrieval, Summarization, Resources and Evaluation
wang21fa_interspeech	['national institute of informatics, chiyoda-ku, tokyo, japan']	4	Speaker and Language Identification
zhang21ca_interspeech	['national institute of informatics, tokyo, japan', 'sokendai (the graduate university for advanced studies), kanagawa, japan', 'digital security department, eurecom, france']	4	Speaker and Language Identification
xie21_interspeech	['zhejiang university, china']	4	Speaker and Language Identification
cheng21b_interspeech	['center for speech and language technologies,', 'beijing national research center for information science and technology,', 'tsinghua university, beijing, china']	4	Speaker and Language Identification
zhang21da_interspeech	['key laboratory of speech acoustics and content understanding, institute of acoustics, china', 'university of chinese academy of sciences, china']	4	Speaker and Language Identification
peng21d_interspeech		4	Speaker and Language Identification
ling21_interspeech	['school of computer science and technology, hust, wuhan, china']	4	Speaker and Language Identification
wu21i_interspeech	['tsinghua-cuhk joint research center for media sciences, technologies and systems,', 'shenzhen international graduate school, tsinghua university, china', 'graduate institute of communication engineering, national taiwan university', 'center for speech and language technologies, tsinghua university, china']	4	Speaker and Language Identification
kinnunen21_interspeech	['university of eastern finland, finland', 'eurecom, france', 'inria, france', 'national institute of informatics, japan', 'nuance communications, spain', 'institute for infocomm research, singapore']	4	Speaker and Language Identification
villalba21_interspeech	['center for language and speech processing, johns hopkins university, usa', 'human language technology center of excellence, johns hopkins university, usa']	4	Speaker and Language Identification
zhang21ea_interspeech	['university of rochester, rochester, ny, usa', 'beijing institute of technology, beijing, china']	4	Speaker and Language Identification
li21o_interspeech	['department of systems engineering and engineering management,', 'the chinese university of hong kong, china', 'department of engineering, university of cambridge, uk']	4	Speaker and Language Identification
ge21c_interspeech	['eurecom, sophia antipolis, france']	4	Speaker and Language Identification
peterson21_interspeech	['national institute of standards and technology, usa', 'dakota consulting inc., usa']	9	Speech Recognition: Architecture, Search, and Linguistic Components
madikeri21_interspeech	['idiap research institute, martigny, switzerland', 'ecole polytechnique federale de lausanne, switzerland']	9	Speech Recognition: Architecture, Search, and Linguistic Components
zhu21f_interspeech	['nel-slip, university of science and technology of china (ustc), hefei, china', 'iflytek research, iflytek co., ltd., hefei, china']	9	Speech Recognition: Architecture, Search, and Linguistic Components
lin21i_interspeech	['national sun yat-sen university, taiwan']	9	Speech Recognition: Architecture, Search, and Linguistic Components
zhao21c_interspeech	['∗department of electronic engineering, tsinghua university, beijing 100084, china', '#teg ai, tencent inc, beijing 100193, china']	9	Speech Recognition: Architecture, Search, and Linguistic Components
alumae21_interspeech	['tallinn university of technology, estonia']	9	Speech Recognition: Architecture, Search, and Linguistic Components
morris21_interspeech	['rochester institute of technology, rochester ny, usa', 'boston college, chestnut hill ma, usa']	9	Speech Recognition: Architecture, Search, and Linguistic Components
gimeno21_interspeech	['vivolab, aragon institute for engineering research (i3a), university of zaragoza, spain']	5	Analysis of Speech and Audio Signals
vuong21_interspeech	['yangyang xia ,', 'richard m stern1,2', 'department of electrical and computer engineering, carnegie mellon university, usa', 'language technologies institute, carnegie mellon university, usa']	5	Analysis of Speech and Audio Signals
sarfjoo21_interspeech	['idiap research institute, martigny, switzerland']	5	Analysis of Speech and Audio Signals
luckenbaugh21_interspeech	['?department of electrical and computer engineering, the university of texas at dallas, usa', '†department of occupational therapy, boston university, usa', '‡department of psychological & brain sciences, boston university, usa', 'psychology department, san francisco state university, usa']	5	Analysis of Speech and Audio Signals
ghahabi21_interspeech	['eml speech technology gmbh, berliner strasse 45', ' heidelberg, germany']		
opatka21_interspeech	['intel corporation, gdansk, poland']	12	Spoken Language Processing: Translation, Information Retrieval, Summarization, Resources and Evaluation
yusuf21_interspeech	['bogazici university, department of electrical and electronics engineering, turkey', 'university of chicago, department of radiology, il, usa']	12	Spoken Language Processing: Translation, Information Retrieval, Summarization, Resources and Evaluation
merkx21_interspeech	['centre for language studies, radboud university, nijmegen, the netherlands']	12	Spoken Language Processing: Translation, Information Retrieval, Summarization, Resources and Evaluation
svec21_interspeech	['department of cybernetics, university of west bohemia, pilsen, czech republic']	12	Spoken Language Processing: Translation, Information Retrieval, Summarization, Resources and Evaluation
buet21_interspeech	['universite paris-saclay, cnrs, lisn, france']		
korzekwa21b_interspeech	['amazon, poland', 'gdansk university of technology, faculty of eti, poland', 'amazon, uk']	1	Speech Perception, Production and Acquisition  by Human Listeners
kanda21b_interspeech	['microsoft corp., usa']	10	Speech Recognition: Technologies and Systems for New Applications
soltau21_interspeech	['google, usa']		
vidal21_interspeech	['departamento de computacion, fceyn, universidad de buenos aires (uba), argentina', 'instituto de investigacion en ciencias de la computacion (icc), conicet-uba, argentina']	10	Speech Recognition: Technologies and Systems for New Applications
xu21k_interspeech	['tencent technology co., ltd, china']	10	Speech Recognition: Technologies and Systems for New Applications
ando21_interspeech	['graduate school of engineering, the university of tokyo, japan']	10	Speech Recognition: Technologies and Systems for New Applications
lin21j_interspeech	['smart platform product department, tencent technology co., ltd, china']	10	Speech Recognition: Technologies and Systems for New Applications
zhang21fa_interspeech	['institute for infocomm research, a*star, singapore']		
peng21e_interspeech	['beijing language and culture university, china', 'smart platform product department,tencent technology co., ltd, china']	10	Speech Recognition: Technologies and Systems for New Applications
qiao21b_interspeech	['rwth aachen university, germany', 'apptek gmbh, germany']	10	Speech Recognition: Technologies and Systems for New Applications
tanaka21c_interspeech	['ntt media intelligence laboratories, ntt corporation, japan']	10	Speech Recognition: Technologies and Systems for New Applications
cumbal21_interspeech	['kth royal institute of technology, sweden', 'heriot-watt university, united kingdom']	10	Speech Recognition: Technologies and Systems for New Applications
zhang21ga_interspeech	['nvidia, santa clara, usa', 'the graduate center, city university of new york, usa']		
naijo21_interspeech	['graduate school of engineering, tohoku university, japan']	10	Speech Recognition: Technologies and Systems for New Applications
haider21_interspeech	['usher institute, edinburgh medical school, the university of edinburgh, edinburgh, uk']	3	Paralinguistics in Speech and Language: Human and Automatic Analysis and Processing
liu21n_interspeech	['school of computer science and engineering, south china university of technology, china']	3	Paralinguistics in Speech and Language: Human and Automatic Analysis and Processing
li21p_interspeech	['school of information, renmin university of china, china']	3	Paralinguistics in Speech and Language: Human and Automatic Analysis and Processing
ito21_interspeech	['hitachi, ltd. r&d group, media intelligent processing research department, japan']	3	Paralinguistics in Speech and Language: Human and Automatic Analysis and Processing
bose21_interspeech	['school of electrical engineering and telecommunications', 'university of new south wales, sydney', 'nsw 2052, australia']	3	Paralinguistics in Speech and Language: Human and Automatic Analysis and Processing
gao21e_interspeech	['tianjin key laboratory of cognitive computing and application,', 'college of intelligence and computing, tianjin university, tianjin, china', 'tianjinuniversity-huiyantechnology joint ai lab, tianjinuniversity, tianjin, china', 'japan advanced institute of science and technology, ishikawa, japan']	3	Paralinguistics in Speech and Language: Human and Automatic Analysis and Processing
cai21b_interspeech	['baidu research, usa']	3	Paralinguistics in Speech and Language: Human and Automatic Analysis and Processing
seneviratne21b_interspeech	['university of maryland - college park, usa']	3	Paralinguistics in Speech and Language: Human and Automatic Analysis and Processing
wang21ga_interspeech	['college of computer science and technology, harbin engineering university, harbin, china']	3	Paralinguistics in Speech and Language: Human and Automatic Analysis and Processing
liu21o_interspeech	['tianjin key laboratory of cognitive computing and application,', 'college of intelligence and computing, tianjin university, tianjin, china', 'tianjin university-huiyan technology joint ai lab, tianjin university, china', 'japan advanced institute of science and technology, ishikawa, japan']	3	Paralinguistics in Speech and Language: Human and Automatic Analysis and Processing
mordido21_interspeech	['hasso plattner institute, germany', 'nvidia, germany']	9	Speech Recognition: Architecture, Search, and Linguistic Components
cheng21c_interspeech	['alibaba group, hangzhou, china']	9	Speech Recognition: Architecture, Search, and Linguistic Components
kim21l_interspeech		9	Speech Recognition: Architecture, Search, and Linguistic Components
swaminathan21_interspeech	['alexa machine learning, amazon.com, usa']	9	Speech Recognition: Architecture, Search, and Linguistic Components
gao21f_interspeech	['speech lab, alibaba group, china', 'platform of a i., alibaba group, china', 'ict cluster, singapore institute of technology, singapore']	9	Speech Recognition: Architecture, Search, and Linguistic Components
shangguan21_interspeech	['facebook ai, usa']	9	Speech Recognition: Architecture, Search, and Linguistic Components
macoskey21b_interspeech		9	Speech Recognition: Architecture, Search, and Linguistic Components
botros21_interspeech	['google inc., u.s.a']		
kim21m_interspeech	['qualcomm ai research†, qualcomm korea yh, south korea', 'seoul national university, south korea']	9	Speech Recognition: Architecture, Search, and Linguistic Components
nagaraja21_interspeech	['facebook, usa']	9	Speech Recognition: Architecture, Search, and Linguistic Components
wang21ha_interspeech	"['audio, speech and language processing group,', ""school of computer science, northwestern polytechnical university, xi'an, china"", 'tencent, beijing, china']"	9	Speech Recognition: Architecture, Search, and Linguistic Components
parcollet21_interspeech	['lia, avignon universite, france', 'university of cambridge, united kingdom', 'mila, universite de montreal, canada']	8	Speech Recognition: Signal Processing, Acoustic Modeling, Robustness, Adaptation
chen21v_interspeech	['amazon alexa, usa']	4	Speaker and Language Identification
li21q_interspeech	['amazon, usa']	4	Speaker and Language Identification
cumani21_interspeech	['politecnico di torino, italy']	4	Speaker and Language Identification
pelecanos21_interspeech		4	Speaker and Language Identification
kataria21b_interspeech	['center for language and speech processing, johns hopkins university, baltimore, md, usa', 'tencent ai lab, bellevue, wa, usa']	4	Speaker and Language Identification
padfield21_interspeech	['google research, usa']	4	Speaker and Language Identification
xiao21b_interspeech		4	Speaker and Language Identification
obrien21b_interspeech	['aix-marseille univ, cnrs, lpl, umr 7309, france']	4	Speaker and Language Identification
tong21_interspeech	['school of electronic science and engineering, xiamen university, china', 'school of informatics, xiamen university, china']	4	Speaker and Language Identification
liao21_interspeech	['school of informatics, xiamen university, china', 'school of electronic science and engineering, xiamen university, china']	4	Speaker and Language Identification
lian21_interspeech	['∗electrical and computer engineering, carnegie mellon university, usa', '+language technologies institute, carnegie mellon university, usa']	4	Speaker and Language Identification
lee21h_interspeech	['school of computing, kaist, daejeon, republic of korea']	7	Speech Synthesis and Spoken Language Generation
liu21p_interspeech	['singapore university of technology and design (sutd), singapore', 'ece department, national university of singapore (nus), singapore', 'machine listening lab, university of bremen, germany']	7	Speech Synthesis and Spoken Language Generation
sivaprasad21_interspeech	['∗', 'saiteja kosgi1 , vineet gandhi1', 'cvit, kcis, iiit hyderabad, india', 'tcs research, pune, india']	7	Speech Synthesis and Spoken Language Generation
cong21b_interspeech	"[""northwestern polytechnical university, xi'an, china"", 'tencent ai lab, china']"	7	Speech Synthesis and Spoken Language Generation
kim21n_interspeech	['department of electrical and computer engineering and inmc,', 'seoul national university, seoul, south korea', 'sk telecom, seoul, south korea']	7	Speech Synthesis and Spoken Language Generation
yan21d_interspeech	['#department of electronic engineering, tsinghua university, china', '$microsoft research asia, china', '%microsoft azure speech, china', '& department of electronic engineering, the chinese university of hong kong, china']		
li21r_interspeech	['tsinghua-cuhk joint research center for media sciences, technologies and systems,', 'shenzhen international graduate school, tsinghua university, shenzhen, china', 'department of systems engineering and engineering management,', 'the chinese university of hong kong, hong kong sar, china', 'department of computer science and technology, tsinghua university, beijing, china']	7	Speech Synthesis and Spoken Language Generation
pan21d_interspeech	['microsoft, china']	7	Speech Synthesis and Spoken Language Generation
tan21_interspeech	['department of electronic engineering, the chinese university of hong kong, hong kong, china']	7	Speech Synthesis and Spoken Language Generation
an21b_interspeech	"[""school of computer science, northwestern polytechnical university, xi'an, china""]"	7	Speech Synthesis and Spoken Language Generation
shechtman21_interspeech	['ibm haifa research lab, haifa, israel', 'ibm tj watson research lab, yorktown heights, ny, usa']	7	Speech Synthesis and Spoken Language Generation
dao21_interspeech	['vinai research, hanoi, vietnam']	12	Spoken Language Processing: Translation, Information Retrieval, Summarization, Resources and Evaluation
lin21k_interspeech	['national laboratory of pattern recognition, institute of automation, cas, beijing, china', 'school of artificial intelligence, university of chinese academy of sciences, china', 'fanyu ai laboratory, beijing fanyu technology co., ltd, beijing, china']	11	Spoken Dialog Systems and Conversational Analysis
gaspers21_interspeech	['amazon alexa ai, aachen, germany']	11	Spoken Dialog Systems and Conversational Analysis
jiang21c_interspeech	['department of electrical and computer engineering,', 'national university of singapore, singapore']	11	Spoken Dialog Systems and Conversational Analysis
wang21ia_interspeech	['ping an technology, china', 'yanshan university, hebei, china']	11	Spoken Dialog Systems and Conversational Analysis
cha21_interspeech	['new york university, usa', 'ibm research ai, usa', 'ibm research ai, brazil']	11	Spoken Dialog Systems and Conversational Analysis
zhang21ha_interspeech	['department of electronic engineering, tsinghua university, china', 'xinjiang university, china']	11	Spoken Dialog Systems and Conversational Analysis
saghir21_interspeech	['amazon alexa ai, canada']	11	Spoken Dialog Systems and Conversational Analysis
saxon21_interspeech	['alexa ai, amazon, usa', 'university of california, santa barbara, usa']	11	Spoken Dialog Systems and Conversational Analysis
han21f_interspeech	['school of computer science, university of sydney', 'sydney, nsw, australia']	11	Spoken Dialog Systems and Conversational Analysis
cutler21_interspeech		6	Speech Coding and Enhancement
pfeifenberger21_interspeech	['evolve technologies, austria', 'graz university of technology, austria']	6	Speech Coding and Enhancement
zhang21ia_interspeech	"[""northwestern polytechnical university, xi'an, china""]"	6	Speech Coding and Enhancement
seidel21_interspeech	['institute for communications technology, technische universitat braunschweig,', 'schleinitzstr. 22', ' braunschweig, germany']		
peng21f_interspeech	['institute of acoustics, chinese academy of sciences, beijing, china', 'university of chinese academy of sciences, beijing, china']	6	Speech Coding and Enhancement
ivry21_interspeech	['andrew and erna viterbi faculty of electrical and computer engineering', 'technion – israel institute of technology, technion city, haifa 3200003, israel']	6	Speech Coding and Enhancement
green21_interspeech		13	Speech, Voice, and Hearing Disorders
neumann21b_interspeech	['modality.ai, inc., san francisco, usa', 'university of california, san francisco, usa', 'everythingals, peter cohen foundation, los altos, usa', 'pr3vent, inc., palo alto, usa', 'ibm thomas j watson research center, yorktown heights, usa', 'massachusetts institute of technology, cambridge, usa', 'mgh institute of health professions, boston, usa', 'harvard university, cambridge, usa', 'university of nebraska, usa', 'university of texas at austin, usa']	13	Speech, Voice, and Hearing Disorders
hermann21_interspeech	['idiap research institute, martigny, switzerland', 'ecole polytechnique federale de lausanne, switzerland']	13	Speech, Voice, and Hearing Disorders
geng21b_interspeech	['the chinese university of hong kong', 'shenzhen institutes of advanced technology, chinese academy of sciences']	8	Speech Recognition: Signal Processing, Acoustic Modeling, Robustness, Adaptation
gutz21_interspeech	['harvard university, usa', 'mgh institute of health professions, usa']	8	Speech Recognition: Signal Processing, Acoustic Modeling, Robustness, Adaptation
jin21_interspeech	['the chinese university of hong kong, hong kong sar, china', 'shenzhen institutes of advanced technology, chinese academy of sciences, shenzhen, china']	8	Speech Recognition: Signal Processing, Acoustic Modeling, Robustness, Adaptation
xie21b_interspeech	['shenzhen institutes of advanced technology, chinese academy of sciences, shenzhen, china', 'chinese university of hong kong, hong kong, china']	13	Speech, Voice, and Hearing Disorders
wang21ja_interspeech	['human-computer communications laboratory', 'the chinese university of hong kong, hong kong sar, china', 'speechx limited, shenzhen, china', 'department of engineering, university of cambridge, uk']	7	Speech Synthesis and Spoken Language Generation
deng21d_interspeech	['the chinese university of hong kong, hong kong sar, china', 'shenzhen institutes of advanced technology, chinese academy of sciences, shenzhen, china']	8	Speech Recognition: Signal Processing, Acoustic Modeling, Robustness, Adaptation
cai21c_interspeech	['google research, usa', 'mgh institute of health professions, usa', 'harvard university, usa']	5	Analysis of Speech and Audio Signals
chen21w_interspeech	['google llc, usa']	13	Speech, Voice, and Hearing Disorders
macdonald21_interspeech	['google research, usa', 'mnd association, uk', 'mgh institute of health professions, usa', 'cerebral palsy associations of new york state, usa', 'harvard university, usa', 'copyright © 2021 isca', 'interspeech 2021', 'august – 3 september', ', brno, czechia', 'http://dx.doi.org/10.21437/interspeech.2021-697']	13	Speech, Voice, and Hearing Disorders
yeo21_interspeech	['department of linguistics, seoul national university, republic of korea', 'department of french language education, seoul national university, republic of korea']	13	Speech, Voice, and Hearing Disorders
venugopalan21_interspeech	['google research, usa', 'google research, japan', 'mgh institute of health professions, usa', 'harvard university, usa']	13	Speech, Voice, and Hearing Disorders
mitra21_interspeech	['apple, cupertino, ca, usa']	13	Speech, Voice, and Hearing Disorders
kawahara21b_interspeech	['wakayama university, wakayama', '-8510 japan', 'waseda university, tokyo', '-8555 japan', 'health science university of hokkaido, hokkaido', '-0293 japan', 'kyushu institute of technology, kitakyushu 804-8550 japan', 'meiji university, tokyo', '-8525 japan', 'meijo university, nagoya', '-8502 japan']		
tihelka21_interspeech			
zhang21ja_interspeech	['nvidia, santa clara, usa']	10	Speech Recognition: Technologies and Systems for New Applications
hembise21_interspeech	['lalilo, france', 'irit, paul sabatier university, cnrs, toulouse, france']		
nguyen21f_interspeech	['vinbrain llc, vietnam']		
shi21e_interspeech	['institute for infocomm research, a*star, singapore']		
jin21b_interspeech	['ant group', 'hangzhou, china']		
udupa21b_interspeech	['electrical engineering, indian institute of science (iisc), bangalore-560012, india']		
