paper_id	affiliations
yan23_interspeech	['Department of Neurological Diagnosis and Restoration, Osaka University Graduate School of', 'Medicine, Suita, Osaka, Japan', 'National Institute for Japanese Language and Linguistics, Japan', 'Department of Neurosurgery, Osaka University Graduate School of Medicine, Suita, Osaka, Japan', 'Global Center for Medical Engineering and Informatics, Osaka University, Suita, Osaka, Japan']
chen23_interspeech	['School of Computer Science and Engineering, Sun Yat-Sen University, China', 'Guangdong Province Key Laboratory of Information Security Technology, China', 'Key Laboratory of Machine Intelligence and Advanced Computing, Ministry of Education, China']
csapo23_interspeech	['Department of Telecommunications and Media Informatics,', 'Budapest University of Technology and Economics (BME), Budapest, Hungary', 'Department of Measurement and Information Systems, BME, Budapest, Hungary', 'Sound and speech perception Research Group, Institute of Cognitive Neuroscience and Psychology,', 'Research Centre for Natural Sciences, Budapest, Hungary']
cheng23_interspeech	['ADSPLAB, School of ECE, Peking University, China']
raj23_interspeech	['CLSP & 3HLTCOE, Johns Hopkins University, Baltimore, USA', 'Xiaomi Corp., Beijing, China']
sharp23_interspeech	['University at Buffalo, United States', 'Independent Researcher, China']
cheng23b_interspeech	['ADSPLAB, School of ECE, Peking University, China']
park23_interspeech	['CNAI, Korea', 'Institute for Convergence Research and Education in Advanced Technology, Yonsei University, Korea', 'Dept. of EE and GSAI, POSTECH, Korea.']
fish23_interspeech	['Samsung Research UK', 'University of Surrey']
cooke23_interspeech	['Ikerbasque, Bilbao, Spain', 'University of the Basque Country, Vitoria-Gasteiz, Spain']
rao23_interspeech	['Travellingwave, Seattle, WA, USA']
zhu23_interspeech	['School of ECE, Peking University, China']
amiriparian23_interspeech	['Chair of Embedded Intelligence for Health Care and Wellbeing, University of Augsburg, Germany', 'Institute for Agile Software Development, Augsburg University of Applied Sciences, Germany', 'GLAM – Group on Language, Audio, & Music, Imperial College London, UK']
bain23_interspeech	"['Visual Geometry Group, University of Oxford', 'Voice Activity', 'Detection', 'Cut &', 'Merge', 'Phoneme', 'Model', 'Forced', 'Alignment', ""[00.12→0.44] That's"", '[00.86→1.14] right.', '[01.98→2.33]  Over', '…', '[89.13→89.45]  Go!', 'Transcript &', 'word-level timestamps', 'Whisper', 'Batch', 'Input audio', '<|transcribe|>', 'Pad to 30s', 'Figure 1: WhisperX: We present a system for efficient speech transcription of long-form audio with word-level time alignment. The', 'input audio is first segmented with Voice Activity Detection and then cut & merged into approximately 30-second input chunks with', 'boundaries that lie on minimally active speech regions. The resulting chunks are then: (i) transcribed in parallel with Whisper, and (ii)', 'forced aligned with a phoneme recognition model to produce accurate word-level timestamps at high throughput.']"
ding23_interspeech	['SenseTime Research', 'University of Science and Technology Beijing']
dang23_interspeech	['Graduate School of Informatics, Nagoya University, Japan', 'School of Informatics, Daido University, Japan']
michieli23_interspeech	['Samsung Research UK']
cheng23c_interspeech	['ADSPLAB, School of ECE, Peking University, China']
li23_interspeech	['Shanghai Engineering Research Center of Intelligent Education and Bigdata,', 'Shanghai Normal University, Shanghai, China', 'Unisound AI Technology Co., Ltd., Beijing, China', 'Department of ECE, University of Texas at Dallas, Richardson, TX 75080, USA']
zuo23_interspeech	['National Key Laboratory for Novel Software Technology,', 'Department of Computer Science and Technology, Nanjing University, China']
hu23_interspeech	['School of Computer Science and Engineering, Nanyang Technological University, Singapore']
bredin23_interspeech	['IRIT, Universite de Toulouse, CNRS, Toulouse, France']
lee23_interspeech	['Samsung Research, Samsung Electronics, Seoul, South Korea', 'Biomedical Knowledge Engineering Laboratory, Seoul National University, Seoul, South Korea']
shuai23_interspeech	['Nanyang Technological University, Singapore', 'Xidian University, China', 'Brunel University London, UK', 'Chongqing University of Posts and Telecommunications, China']
jung23_interspeech	['School of Electrical Engineering, KAIST, Daejeon, Republic of Korea']
oota23_interspeech	['Inria Bordeaux, France', 'IIIT Hyderabad, India', 'Microsoft, India']
xiao23_interspeech	['Department of Electronic Engineering, The Chinese University of Hong Kong, Hong Kong', 'Microsoft, China']
zeng23_interspeech	['National Institute of Informatics, Japan 2SOKENDAI, Japan']
bhati23_interspeech	['†Center for Language and Speech Processing, Johns Hopkins University, USA', '‡Human Language Technology Center of Excellence, Johns Hopkins University, USA']
chen23b_interspeech	['Columbia University']
liu23_interspeech	['Meta AI, Menlo Park, CA, USA']
wang23_interspeech	['Key Innovation Group of Digital Humanities Resource and Research,', 'Shanghai Normal University, Shanghai, China', 'Unisound AI Technology Co., Ltd., Beijing, China', 'Department of ECE, University of Texas at Dallas, Richardson, TX 75080, USA']
chen23c_interspeech	['ByteDance']
li23b_interspeech	['The MARCS Institute, Western Sydney University, Australia', 'Independent Researcher, Australia']
deja23_interspeech	['Warsaw University of Technology', 'Amazon']
sarni23_interspeech	['Politecnico di Torino, Italy', 'Kore University of Enna, Italy']
lai23_interspeech	['Department of Linguistics and Cognitive Science, Pomona College, USA']
rybakov23_interspeech	['Google Research']
tseng23_interspeech	['Institute of Linguistics, Academia Sinica', 'Department of Information Engineering and Computer Science, Feng-Chia University']
fujimura23_interspeech	['Nagoya University, Japan', 'LINE Coporation, Japan']
deng23_interspeech	['School of Communication and Information Engineering, Chongqing University of Posts and', 'Telecommunications, Chongqing (CQUPT), China', 'Chongqing Key Laboratory of Signal and Information Processing, CQUPT, Chongqing, China', 'Intelligent Speech and Audio Research Lab (ISARL), CQUPT, Chongqing, China']
yang23_interspeech	['Department of Computer Science and Engineering, The Ohio State University, USA', 'Center for Cognitive and Brain Sciences, The Ohio State University, USA']
papi23_interspeech	['Fondazione Bruno Kessler, Italy', '♢University of Trento, Italy', '♮Independent Researcher']
elie23_interspeech	['Linguistics and English Language; School of Philosophy, Psychology and Language Sciences; the', 'University of Edinburgh; Edinburgh, Scotland, United Kingdom', 'Faculty of Arts; University of Helsinki; Helsinki, Finland']
yeo23_interspeech	['Seoul National University, Republic of Korea', 'Carnegie Mellon University, United States of America']
scheck23_interspeech	['Cognitive Systems Lab, University of Bremen, Bremen, Germany']
lin23_interspeech	['The University of Texas at Dallas, Richardson, USA', 'Robert Bosch Research and Technology Center, USA - Bosch Center for Artificial Intelligence']
singh23_interspeech	['Sony Research India, India', 'Sony Group Corporation, Japan']
bellegarda23_interspeech	['Etsy Inc., Brooklyn, New York 11201, USA∗']
zhou23_interspeech	['Lanzhou University, China']
eom23_interspeech	['Samsung Research, Samsung Electronics, Republic of Korea']
le23_interspeech	['Key Laboratory of Modern Acoustics, Nanjing University, Nanjing 210093, China', 'RTC Lab, ByteDance, China', 'NJU-Horizon Intelligent Audio Lab, Horizon Robotics, Beijing 100094, China']
wong23_interspeech	['Institute for Infocomm Research (I2R), A⋆STAR, Singapore']
ghosh23_interspeech	['Artificial Intelligence Lab (AILab), Otto-von-Guericke-University, Magdeburg, Germany', 'Mobile Dialog Systems, Otto-von-Guericke-University, Magdeburg, Germany', 'Speech and Language Technology, German Research Center for Artificial Intelligence (DFKI)']
choi23_interspeech	['School of Electrical Engineering, KAIST, South Korea']
cappellazzo23_interspeech	['University of Trento, Trento, Italy', 'Fondazione Bruno Kessler, Trento, Italy']
hedeshy23_interspeech	['University of Stuttgart, Germany', 'Semanux GmbH, Germany', 'University of Southampton, UK']
sugiura23_interspeech	['Graduate School of Medicine, Engineering, and Agricultural Sciences, University of Yamanashi']
fagniart23_interspeech	['Huberlant3, Myriam Piccaluga1,5 & Kathy Huet1,5', 'Language Sciences and Metrology Unit, UMONS, Mons, Belgium', 'ULB - Universite Libre de Bruxelles, Brussels, Belgium', 'Functional Rehabilitation Center « Comprendre et Parler », Brussels, Belgium', 'Fund for Scientific Research (F.R.S.–FNRS), Belgium', 'Research Institute for Language Science and Technology, UMONS, Mons, Belgium']
plaquet23_interspeech	['IRIT, Universite de Toulouse, CNRS, Toulouse INP, UT3, Toulouse, France']
hejna23_interspeech	['Aarhus University, Denmark', 'University of Lille, CNRS, STL, France']
romero23_interspeech	['Department of Computer Science, University of Sheffield, Sheffield S1 4DP, UK', 'PFL Healthcare Limited, HQ 5th Floor', ' Nicholas Street, Chester CH1 2NP, UK']
bousquet23_interspeech	['LIA - Avignon University']
schwarz23_interspeech	['Amazon Alexa, Germany', 'Amazon Alexa, USA']
lee23b_interspeech	['Samsung Research, Seoul, South Korea']
wei23_interspeech	['Bytedance, Singapore', 'Machine Learning Department, Mohamed bin Zayed University of Artificial Intelligence, Abu', 'Dhabi, UAE', '{pengfei.wei, yinxiang.stephen, wangchunfeng, lizhonghao.01, xinghua.qu,']
lin23b_interspeech	['Shenzhen International Graduate School, Tsinghua University, Shenzhen, China', 'Xiaomi Inc., Beijing, China']
niizumi23_interspeech	['NTT Corporation, Japan']
yue23_interspeech	"[""Department of Engineering, King's College London, UK"", 'Multimedia Computing Group, Delft University of Technology, the Netherlands', 'Speech Group, Machine Intelligence Laboratory, University of Cambridge']"
zhang23_interspeech	['School of Computer and Communication Engineering, University of Science and Technology Beijing, Beijing 100083, China', 'USTB-EEasyTech Joint Lab of Artificial Intelligence, University of Science and Technology Beijing, Beijing 100083, China', 'EEasy Technology Company Ltd., Zhuhai 519000, China']
lin23c_interspeech	['Inria Grenoble Rhˆone-Alpes, Univ. Grenoble Alpes, France', 'CentraleSupelec, IETR (UMR CNRS 6164), France', 'Univ. Grenoble Alpes, CNRS, Grenoble-INP, GIPSA-lab, France']
moore23_interspeech	['University of Sheffield, UK', 'Universite de Toulon, France']
ludusan23_interspeech	['Phonetics Workgroup, Faculty of Linguistics and Literary Studies & CITEC, Bielefeld University,', 'Germany', 'ISFAS, Kiel University, Germany']
lee23c_interspeech	['NIST ITL/IAD/Multimodal Information Group, MD, USA', 'MIT Lincoln Laboratory, Lexington, MA, USA', 'U.S. Department of Defense, MD, USA']
cappellazzo23b_interspeech	['University of Trento, Trento, Italy', 'Carnegie Mellon University, Pittsburgh, PA, USA', 'Fondazione Bruno Kessler, Trento, Italy']
goel23_interspeech	['Reality Defender Inc., USA']
yeshpanov23_interspeech	['Institute of Smart Systems and Artificial Intelligence, Nazarbayev University, Kazakhstan']
zhu23b_interspeech	['Changhong AI Lab (CHAIR), Sichuan Changhong Electronics Holding Group Co., Ltd.', 'Center for Robotics, University of Electronic Science and Technology of China', 'Department of Electrical Engineering and Computer Science, Northwestern University, USA']
yifan23_interspeech	['Data & AI Engineering System, OPPO, Beijing, China']
wang23b_interspeech	['Institute of Microelectronics of the Chinese Academy of Sciences, Beijing, China', 'University of Chinese Academy of Sciences, Beijing, China']
fan23_interspeech	['Bytedance Research']
li23c_interspeech	['School of Computer Science and Technology, Fudan University, Shanghai, China', 'Shanghai Key Laboratory of Intelligent Information Processing, Fudan University, Shanghai, China']
cumani23_interspeech	['Politecnico di Torino, Italy']
sanabria23_interspeech	['The University of Edinburgh']
ito23_interspeech	['Hosei University', ' Hitachi, Ltd.']
schroter23_interspeech	['Friedrich-Alexander-Universit¨at Erlangen-Nurnberg, Pattern Recognition Lab', 'WS Audiology, Research and Development, Erlangen, Germany']
jiang23_interspeech	['School of Computer and Control Engineering, Yantai University, China', 'Key Laboratory of Child Development and Learning Science (Southeast University), Ministry of', 'Education, Research Center for Learning Science, Southeast University, China']
zhao23_interspeech	['The State Key Laboratory of Tibetan Intelligent Information Processing and Application,', 'Tibetan information processing and Machine Translation Key Laboratory of Qinghai province', 'School of Computer and Control Engineering, Yantai University, China', 'School of Biological Science and Medical Engineering, Southeast University, China']
adhikary23_interspeech	['Michigan Technological University, USA']
yang23b_interspeech	['Dept. of Computer Science and Engineering, Sogang University, Korea', 'Dept. of Computer Science and Engineering, Seoul National University, Korea', 'LG Electronics, Korea']
zhang23b_interspeech	['Dept. of Electronic Engineering, Tsinghua University', 'Dept. of Otolaryngology, Beijing Tongren Hospital, Capital Medical University']
mamun23_interspeech	['Cochlear Implant Processing Laboratory, Center for Robust Speech Systems (CRSS-CILab),', 'Department of Electrical & Computer Engineering, The University of Texas at Dallas']
oota23b_interspeech	['Inria Bordeaux, France,']
yuan23_interspeech	['University of Science and Technology of China, China', 'Google Inc., USA', 'Northeastern University, USA']
otani23_interspeech	['Department of Information Sciences, Tokyo University of Science, Tokyo, Japan']
yang23c_interspeech	['Shenzhen International Graduate School, Tsinghua University, Shenzhen, China', 'ARC Lab, Tencent PCG', 'Department of Computer Science and Technology, Tsinghua University, Beijing, China']
zebe23_interspeech	['University of Zurich']
li23d_interspeech	['School of Artificial Intelligence, Beijing University of Posts and Telecommunications, China']
hu23b_interspeech	['The Chinese University of Hong Kong, Hong Kong SAR, China', 'Institute of Software, Chinese Academy of Sciences, China']
liu23b_interspeech	['Wang3', 'Qingdao University of Science and Technology, Qingdao, China', 'National Institute of Information and Communications Technology, Kyoto, Japan', 'College of Intelligence and Computing, Tianjin University, Tianjin, China']
geng23_interspeech	['Shujie Hu1,Zi Ye1, Helen Meng1, Xunying Liu1', 'The Chinese University of Hong Kong', 'Institute of Software, Chinese Academy of Sciences', 'Shenzhen Institute of Advanced Technology, Chinese Academy of Sciences', 'Tencent AI Lab']
zhu23c_interspeech	['†', 'Rosie Jones', '†', '†Spotify ‡Georgetown University']
addlesee23_interspeech	['Heriot-Watt University, United Kingdom', 'Amazon Alexa, United Kingdom']
kondratenko23_interspeech	['SaluteDevices, Russia', 'NVIDIA, Armenia,', 'Laboratory of Algorithms and Technologies for Network Analysis, HSE University, Russia', 'Department of Mathematics and Mechanics, Moscow State University, Russia']
benway23_interspeech	['1Communication Sciences and Disorders, Syracuse University, New York, USA', 'Haskins Laboratories, New Haven, Connecticut, USA', 'Electrical Engineering and Computer Science, Syracuse University, New York, USA', 'Communicative Sciences and Disorders, New York University, New York, USA']
sostarics23_interspeech	['Northwestern University, Department of Linguistics']
yoshinaga23_interspeech	['Toyohashi University of Technology, Japan   2Osaka University, Japan', 'Sophia University, Japan']
taherian23_interspeech	['Department of Computer Science and Engineering, The Ohio State University, USA', 'Meta Reality Labs Research, USA']
muromachi23_interspeech	['Shizuoka University, Japan']
geng23b_interspeech	['Li1, Jianwei Yu3,Xurong Xie2, Xunying Liu1', 'The Chinese University of Hong Kong', 'Institute of Software, Chinese Academy of Sciences', 'Tencent AI Lab']
cahyawijaya23_interspeech	['The Hong Kong University of Science and Technology']
xin23_interspeech	['School of ECE, Peking University, Shenzhen, China']
chen23d_interspeech	['Shanghai Jiao Tong University', 'Guangxi University', 'Nanjing University']
ryu23_interspeech	['Department of Linguistics, Seoul National University, Republic of Korea', 'Department of French Language Education, Seoul National University, Republic of Korea']
liu23c_interspeech	['Unisound AI Technology Co. Ltd, China', 'University of Science and Technology of China, China']
qu23_interspeech	['Carnegie Mellon University', 'Max Planck Institute', 'Mohamed bin Zayed University of Artificial Intelligence']
gao23_interspeech	['China Mobile Research']
yang23d_interspeech	['Department of Data Science & AI, Monash University']
gao23b_interspeech	['School of Computer Science and Communication Engineering, Jiangsu University, Zhenjiang,', 'China', 'Department of Computer Science, Wayne State University, Detroit, USA']
choi23b_interspeech	['Department of Electronic Engineering Hanyang University, Seoul, Republic of Korea']
vaessen23_interspeech	['Institute for Computing and Information Sciences, Radboud University']
ren23_interspeech	['Hunan University, China']
lin23d_interspeech	['Department of Electrical and Computer Engineering, National University of Singapore, Singapore', 'Shenzhen Research Institute of Big Data, School of Data Science, The Chinese University of Hong', 'Kong, Shenzhen, China']
kim23_interspeech	['NAVER Cloud, South Korea']
liu23d_interspeech	['MoE Key Lab of Artificial Intelligence, AI Institute', 'X-LANCE Lab, Department of Computer Science and Engineering', 'Shanghai Jiao Tong University, Shanghai, China']
andreev23_interspeech	['Samsung AI Center, Moscow', 'HSE University, Moscow', 'Skolkovo Institute of Science and Technology, Moscow', 'Artificial Intelligence Research Institute, Moscow', '∗equal contribution']
iashchenko23_interspeech	['Vetrov24', 'Samsung AI Center, Moscow', 'HSE University, Moscow', 'Skolkovo Institute of Science and Technology, Moscow', 'Artificial Intelligence Research Institute, Moscow', '∗equal contribution']
wang23c_interspeech	['School of Computer Science and Engineering, University of New South Wales, Australia']
kashiwagi23_interspeech	['Waseda University, Japan', 'Waseda Research Institute for Science and Engineering, Japan']
zhang23c_interspeech	['Nanyang Technological University, Singapore', 'Huawei International, Singapore', 'Huawei Technology, China']
ribeiro23_interspeech	['Meta AI', 'Universite de Lorraine, CNRS, Inria, LORIA, F-54000, Nancy, France']
jiang23b_interspeech	['X-LANCE Lab, Department of Computer Science and Engineering, Shanghai Jiao Tong University,', 'Shanghai, China', 'Department of Electronic Engineering, Shanghai Jiao Tong University, Shanghai, China']
shi23_interspeech	['ByteDance Research, Singapore', 'ByteDance Research, P.R. China']
zhang23d_interspeech	['Orange Innovation, France', 'Univ Rennes, CNRS, IRISA, Lannion, France']
vandermerwe23_interspeech	['ByteFuse', 'E&E Engineering, Stellenbosch University, South Africa']
yang23e_interspeech	"[""Faculty of Electronic and Information Engineering, Xi'an Jiaotong University, China"", 'Speech Lab of DAMO Academy, Alibaba Group', 'Nanyang Technological University, Singapore']"
phatthiyaphaibun23_interspeech	['School of Information Science and Technology, VISTEC, Thailand', 'Department of Computer Engineering Chulalongkorn University, Thailand', 'Department of Computer Engineering, Kasetsart University, Thailand']
shi23b_interspeech	['Speech Lab of DAMO Academy, Alibaba Group, China']
zhang23e_interspeech	"[""School of Computer Science, Northwestern Polytechnical University, Xi'an, China"", 'DiDi Chuxing, Beijing, China']"
sun23_interspeech	['School of Artificial Intelligence, Beijing University of Posts and Telecommunications, Beijing,', 'China 2 TEG AI, Tencent Inc, Beijing, China']
hsu23_interspeech	['Department of Computer Science and Information Engineering', 'National Cheng Kung University, Taiwan']
yao23_interspeech	"[""School of Marine Science and Technology, Northwestern Polytechnical University, Xi'an, China"", 'Horizon Robotics, Beijing, China', 'Research and Development Institute of Northwestern Polytechnical University in Shenzhen, China']"
peyser23_interspeech	['Center for Data Science, New York University, New York City, USA', 'Google Inc., U.S.A']
kawa23_interspeech	['Wroclaw University of Science and Technology, Wroclaw, Poland']
zhang23f_interspeech	['School of Intelligence Science and Technology, Speech and Hearing Research Center, and Key', 'Laboratory of Machine Perception (Ministry of Education), Peking University, Beijing, China', 'National Biomedical Imaging Center, College of Future Technology, Peking University']
zhao23b_interspeech	['College of Computer and Information Engineering, Tianjin Normal University, Tianjin, China', 'College of Computer Science, Zhejiang University, China', 'Chair of Embedded Intelligence for Health Care and Wellbeing, University of Augsburg, Germany', 'GLAM – Group on Language, Audio, & Music, Imperial College London, UK']
qiu23_interspeech	['Institute of Acoustics, Chinese Academy of Sciences, China', 'University of Chinese Academy of Sciences, China']
chiang23_interspeech	['National Taiwan University, Taiwan']
baas23_interspeech	['MediaLab, Department of Electrical & Electronic Engineering, Stellenbosch University, South Africa']
kim23b_interspeech	['School of Electrical Engineering and Computer Science,', 'Gwangju Institute of Science and Technology, Gwangju 61005, Korea']
jacobs23_interspeech	['Department of Electrical & Electronic Engineering, Stellenbosch University, South Africa', 'Universitat Pompeu Fabra, Spain', 'African Institute for Mathematical Sciences, Cape Town, South Africa', 'Department of Mathematics & Applied Mathematics, University of Cape Town, South Africa', 'VoxCroft Analytics, Cape Town, South Africa (http://www.voxcroft.com)']
han23_interspeech	['Institute of Automation, Chinese Academy of Sciences', 'School of Artificial Intelligence, University of Chinese Academy of Sciences', 'School of Future Technology, University of Chinese Academy of Sciences']
roy23_interspeech	['Department of Electrical Engineering, Indian Institute of Technology Patna, Bihar-801106, India']
sharoni23_interspeech	['∗Co-first authors', 'Up·AI, Israel', 'National Institute of Informatics, Japan']
havard23_interspeech	"['Language Acquisition Across Cultures Team, Laboratoire de Sciences Cognitives et de', ""Psycholinguistique, Departement d'Etudes Cognitives, ENS, EHESS, CNRS, PSL University, France"", 'Cognitive Machine Learning Team, INRIA, Paris, France', 'Human Ecology Group, Institute of Evolutionary Medicine, University of Zurich, Switzerland']"
geneva23_interspeech	['IICT – Bulgarian Academy of Sciences', 'IBL – Bulgarian Academy of Sciences,', 'FMI – Sofia University, Bulgaria', 'Chaos', 'INSAIT']
swiatkowski23_interspeech	['Amazon Science']
deseyssel23_interspeech	['Cognitive Machine Learning, ENS–CNRS–EHESS–INRIA–PSL Research University, France', 'Universite Paris Cite, CNRS, Laboratoire de linguistique formelle, Paris, France', 'Faculty of Linguistics and Literary Studies & CITEC, Bielefeld University, Germany', 'PEGASE, INRAE, Institut Agro, Saint-Gilles, France', 'Meta AI Research, France']
swiatkowski23b_interspeech	['Amazon Science']
hughes23_interspeech	['Department of Language and Linguistic Science, University of York, UK', 'Oxford Wave Research, Oxford, UK', 'Netherlands Forensic Institute, The Hague, The Netherlands']
thenguyen23_interspeech	['VinAI Research, Vietnam']
panariello23_interspeech	['EURECOM, Sophia Antipolis, France']
fang23_interspeech	['School of Information Science and Engineering, Xinjiang University, Urumqi 830017, China', 'Xinjiang Key Laboratory of Signal Detection and Processing, Urumqi 830017, China', 'Department of Electronic Engineering, Tsinghua University, Beijing 100084, China', 'School of Electronic Science and Engineering, Xiamen University, Xiamen 361005, China']
peng23_interspeech	['Omilia - Conversational Intelligence, Athens, Greece']
alsenani23_interspeech	['University of Glasgow, United Kingdom', 'Umm Al-Qura University, Mecca, Saudi Arabia']
zadorozhnyy23_interspeech	['Department of Mathematics, University of Kentucky, Lexington, USA', 'Applied Sciences Group, Microsoft Corporation, Redmond, USA']
li23e_interspeech	['Department of Electrical and Computer Engineering, University of Illinois', 'Beckman Institute for Advanced Science and Technology, University of Illinois', 'Department of Human Development and Family Studies, University of Illinois']
huang23_interspeech	['NVIDIA, USA']
fernandezlopez23_interspeech	['Petridis1,2, Maja Pantic1,2', 'Meta AI, UK', 'Imperial College London, UK']
luo23_interspeech	['Centre for Digital Music, Queen Mary University of London, UK', 'Amazon Alexa, Cambridge, MA, USA']
wagner23_interspeech	['Technische Hochschule Nurnberg Georg Simon Ohm, Germany', 'Friedrich-Alexander-University Erlangen-Nurnberg, Pattern Recognition Lab, Erlangen, Germany', 'Intel Labs']
lin23e_interspeech	['Saarland Informatics Campus, Germany', 'Language Science and Technology, Saarland University, Germany', 'Reality Labs, Meta Inc.', 'ILS, Utrecht University, the Netherlands']
triantafyllopoulos23_interspeech	['Chair of Embedded Intelligence for Health Care and Wellbeing, University of Augsburg, Germany', 'GLAM – Group on Language, Audio, & Music, Imperial College London, UK']
zhai23_interspeech	['Stanford University, USA', 'University of Illinois Urbana-Champaign, USA']
nishu23_interspeech	['Apple']
hu23c_interspeech	['Google LLC, USA']
azeemi23_interspeech	['Lahore University of Management Sciences']
banerjee23_interspeech	['Department of Electrical Engineering', 'Indian Institute of Technology Kanpur, India']
kanda23_interspeech	['Microsoft, USA']
filimonov23_interspeech	['Amazon Alexa']
ma23_interspeech	['Meta AI', 'Imperial College London']
munakata23_interspeech	['SANKEN, Osaka University, Osaka, Japan']
huang23b_interspeech	['Google Research, USA']
yousefi23_interspeech	['Microsoft, One Microsoft Way, Redmond, WA, USA']
casanova23_interspeech	['Coqui, Germany', ' Instituto de Ciencias Matem´aticas e de Computacao, Universidade de Sao Paulo, Brazil;', 'QuintoAndar, Portugal', ' Darmstadt University of Applied Sciences, Germany', ' Sao Paulo State University, Brazil;', 'Federal University of Goi´as, Brazil', ' Mercado Livre, Brazil.']
ioannides23_interspeech	['Carnegie Mellon University, USA', 'Amazon Alexa, USA']
park23b_interspeech	['Seoul National University, South Korea']
wang23d_interspeech	['School of Mathematical and Computational Sciences, Massey University, New Zealand']
choi23c_interspeech	['Department of Electronic Engineering, Hanyang University, Seoul, Republic of Korea']
lai23b_interspeech	['School of Computer and Communication Engineering, University of Science and Technology Beijing, Beijing 100083, China', 'USTB-EEasyTech Joint Lab of Artificial Intelligence, University of Science and Technology Beijing, Beijing 100083, China', 'EEasy Technology Company Ltd., Zhuhai 519000, China']
li23f_interspeech	['Osaka University, Japan']
li23g_interspeech	['Key Laboratory of Noise and Vibration Research, Institute of Acoustics, Chinese Academy', 'of Sciences, Beijing, China', 'University of Chinese Academy of Sciences, Beijing, China', 'Tencent Ethereal Audio Lab, Tencent Corporation, Shenzhen, China']
yang23f_interspeech	['Speech and Audio Signal Processing Laboratory, Faculty of Information Technology,', 'Beijing University of Technology, Beijing, China']
chen23e_interspeech	['RTC Lab, ByteDance, China', 'SSE, South China University of Technology, Guangzhou, China', 'EIC, Huazhong University of Science and Technology, Wuhan, China', 'EECE, University of Western Australia, Perth, Australia']
zhang23g_interspeech	['Beihang University, Beijing, China']
wei23b_interspeech	['School of Information, Renmin University of China, Beijing, China', 'Institute of Information Science, Beijing Jiaotong University, Beijing, China']
park23c_interspeech	['Riiid AI Research']
kong23_interspeech	['SK Telecom, South Korea']
zhou23b_interspeech	['Guangdong Key Lab of Intelligent Information Processing, CEIE, Shenzhen University, China', 'Faulty of Chinese Language and Culture, Guangdong University of Foreign Studies, China', 'Bailing Hearing Clinic, Guangzhou', ', Guangdong, China', 'School of Physics and Optoelectronics, South China University of Technology, China']
xu23_interspeech	['RTC Lab, ByteDance, Beijing, China', 'Beijing University of Posts and Telecommunications, Beijing, China', 'School of Information Technology, Murdoch University, Perth, Australia', '{jiangjiawei.lahm, zhangdejun, xiaxianjun, chenli.cloud, dingpiao1,']
chen23f_interspeech	['Institute of Automation, Chinese Academy of Sciences, Beijing, China', 'School of Future Technology, University of Chinese Academy of Sciences, Beijing, China', 'School of Artificial Intelligence, University of Chinese Academy of Sciences, Beijing, China']
singh23b_interspeech	['School of Mathematical and Computational Sciences, Massey University, Auckland, New Zealand']
li23h_interspeech	['Shanghai Engineering Research Center of Intelligent Education and Bigdata ,', 'Shanghai Normal University, Shanghai, China', 'Unisound AI Technology Co., Ltd., Beijing, China']
lu23_interspeech	['Key Laboratory of Child Development and Learning Science of Ministry of Education,', 'Southeast University, Nanjing, China', 'School of Biological Science and Medical Engineering, Southeast University, Nanjing, China', 'School of Information Science and Engineering, Southeast University, Nanjing, China']
chao23_interspeech	['Research Center for Psychological and Educational Testing, National Taiwan Normal University', 'Department of Computer Science and Information Engineering, National Taiwan Normal University', 'Department of Educational Psychology and Counseling, National Taiwan Normal University']
ho23_interspeech	['Georgia Institute of Technology, U.S.A', 'Kore University of Enna, Italy', 'Norwegian University of Science and Technology, Norway']
cui23_interspeech	['The Chinese University of Hong Kong, Hong Kong SAR, China', 'MoE Key Lab of Artificial Intelligence, AI Institute,', 'X-LANCE Lab, Department of Computer Science and Engineering,', 'Shanghai Jiao Tong University, Shanghai, China', 'Peng Cheng Laboratory, Shenzhen, China']
zhang23h_interspeech	['Guangzhou Shiyuan Electronic Technology Company Limited, China', 'School of Comuter Science, East China Normal University, China']
kong23b_interspeech	['Guangdong Key Lab of Intelligent Information Processing, CEIE, Shenzhen University, China', 'The First Affiliated Hospital, Sun Yat-Sen University, China', 'College of Psychology and Sociology, Shenzhen University, China', 'Department of Neuroscience, City University of Hong Kong, Hong Kong SAR of China', 'School of Physics and Optoelectronics, South China University of Technology, China']
kim23c_interspeech	['Speech AI Lab., NCSOFT Corporation, South Korea', 'Department of Electrical and Electronic Engineering, Yonsei University, South Korea']
zhang23i_interspeech	['Alibaba Group, China']
wen23_interspeech	['School of Computer Science, The University of Sydney, NSW, Australia', 'Faculty of Data Science, City University of Macau, Macao SAR, China']
makishima23_interspeech	['NTT Computer and Data Science Laboratories, NTT Corporation, Japan']
yin23_interspeech	['University of Science and Technology of China, Hefei, China', 'Microsoft Research Asia, Beijing, China']
zhang23j_interspeech	['Data Science Research Center, Duke Kunshan University, Kunshan, China', 'Data & AI Engineering System, OPPO, Beijing, China']
jiang23c_interspeech	['National University of Singapore, Singapore', 'Shenzhen Research Institute of Big Data, School of Data Science,', 'The Chinese University of Hong Kong, Shenzhen, China']
bn23_interspeech	['Pennsylvania State University, USA']
okamoto23_interspeech	['Ritsumeikan University, Japan', 'Doshisha University, Japan', 'Hitachi, Ltd., Japan']
kurata23_interspeech	['Waseda University', 'Chiba Institute of Technology']
tan23_interspeech	"['Key Laboratory of Aerospace Information Security and Trusted Computing, Ministry of Education,', 'School of Cyber Science and Engineering, Wuhan University, Wuhan, China', 'Department of Intelligent Science School of Advanced Engineering,', ""Xi'an Jiaotong-Liverpool University, Suzhou, China""]"
binhthien23_interspeech	['Ritsumeikan University, Shiga, Japan', 'Toyohashi University of Technology, Aichi, Japan']
deng23b_interspeech	['The Chinese University of Hong Kong, Hong Kong SAR, China', 'Institute of Software, Chinese Academy of Sciences, Beijing, China']
liang23_interspeech	['School of Computer Science and Technology, University of Science and Technology of China', 'State Key Laboratory of Cognitive Intelligence 3Microsoft Research']
fu23_interspeech	['ByteDance']
hu23d_interspeech	['Nagoya University']
shimonishi23_interspeech	['Ritsumeikan University, Japan', 'Hitachi, Ltd., Japan']
cheng23d_interspeech	['Department of Cognitive Science, UC San Diego, La Jolla, California, USA', 'Reality Labs Research at Meta, Redmond, Washington, USA']
lee23d_interspeech	['Speech AI Lab., NCSOFT Corporation, South Korea']
shi23c_interspeech	['NERC-SLIP, University of Science and Technology of China (USTC), China', 'Tianjin University, China', 'Speech Lab of DAMO Academy, Alibaba Group, China']
li23i_interspeech	['University of Cambridge', 'Microsoft']
shi23d_interspeech	['NERC-SLIP, University of Science and Technology of China (USTC), China', 'Speech Lab of DAMO Academy, Alibaba Group, China']
heo23_interspeech	['School of Computer Science, University of Seoul']
jia23_interspeech	['Wang', 'Speech, Audio & Music Intelligence (SAMI), ByteDance']
yang23g_interspeech	"[""Faculty of Electronic and Information Engineering, Xi'an Jiaotong University, China"", 'Speech Lab of DAMO Academy, Alibaba Group', 'Nanyang Technological University, Singapore']"
zheng23_interspeech	['MoE Key Lab of Artificial Intelligence, AI Institute, X-LANCE Lab', 'Department of Computer Science and Engineering, Shanghai Jiao Tong University', 'Cooperative Medianet Innovation Center, Shanghai Jiao Tong University', 'Shanghai AI Laboratory']
wang23e_interspeech	['NAVER Cloud, South Korea']
feng23_interspeech	['Speech and Music Intelligence (SAMI), ByteDance']
shin23_interspeech	['School of Industrial and Management Engineering, Korea University, Seoul, Republic of Korea', 'SK Telecom, Republic of Korea']
wang23f_interspeech	['School of Computing, National University of Singapore, Singapore', 'Department of Electrical and Computer Engineering, National University of Singapore, Singapore', 'Shenzhen Research Institute of Big Data, School of Data Science, The Chinese University of Hong', 'Kong, Shenzhen, China', 'Machine Listening Lab, University of Bremen, Germany']
feng23b_interspeech	['Speech and Music Intelligence (SAMI), ByteDance']
yang23h_interspeech	['Dept. of Electrical and Electronic Engineering, Yonsei University, South Korea']
xu23b_interspeech	['Tencent AI lab, Belleuve, USA']
delcroix23_interspeech	['Marc Delcroix1, Naohiro Tawara1, Mireia Diez2, Federico Landini2, Anna Silnova2,', 'Atsunori Ogawa1, Tomohiro Nakatani1, Lukas Burget2, Shoko Araki1']
ma23b_interspeech	['Shanghai Jiao Tong University, Shanghai, China', 'Shanghai AI Laboratory, Shanghai, China', 'Tsinghua University, Beijing, China']
keding23_interspeech	['Centre for Mathematical Sciences, Lund University', 'Automatic Control, Department of Electrical Engineering, Link¨oping University', 'Eriksholm Research Centre, Snekkersten, Denmark']
xu23c_interspeech	['Key Laboratory of Noise and Vibration Research, Institute of Acoustics, Chinese Academy of', 'Sciences, Beijing, China', 'University of Chinese Academy of Sciences, Beijing, China']
zhu23d_interspeech	['College of Intelligence and Computing, Tianjin University, China', 'The Academy of Tianjin University Hefei, China']
gu23_interspeech	['School of Computer Science and Technology, Harbin Institute of Technology, Harbin, China']
yuksel23_interspeech	['aiXplain Inc., Los Gatos, CA, USA']
zhu23e_interspeech	['Cooperative Medianet Innovation Center, Shanghai Jiao Tong University', 'Shanghai AI Laboratory']
yang23i_interspeech	['Peking University, China', 'Tencent AI Lab, China', 'Johns Hopkins University, USA']
song23_interspeech	"[""School of Computer Science, Northwestern Polytechnical University, Xi'an, China"", 'ByteDance']"
zhou23c_interspeech	['Guangdong Key Laboratory of Intelligent Information Processing,', 'College of Electronics and Information Engineering, Shenzhen University, Shenzhen, China', 'Acoustics Laboratory, School of Physics and Optoelectronics,', 'South China University of Technology, Guangzhou, China']
fang23b_interspeech	['South China University of Technology, China', 'Pazhou lab, China', 'VoiceAI Technologies, Shenzhen, China']
zhang23k_interspeech	['Key Laboratory of Intelligent Computing in Medical Image, Northeastern University, China', 'Department of Electrical and Computer Engineering, National University of Singapore, Singapore', 'Machine Listening Lab (MLL), University of Bremen, Germany', 'SDS, SRIBD, The Chinese University of Hong Kong, Shenzhen, China']
wang23g_interspeech	['China Telecom Corporation Ltd. Data&AI Technology Company']
zhang23l_interspeech	['NIO']
gao23c_interspeech	['Shenzhen Research Institute of Big Data, China', 'The Hong Kong University of Science and Technology (Guangzhou), China']
polacek23_interspeech	['Technical University of Liberec, Studentska 2', ' 17 Liberec, Czech Republic', 'NEWTON Technologies, Na Pankraci 1683/127', ' 00 Praha 4, Czech Republic']
nortje23_interspeech	['MediaLab, E&E Engineering, Stellenbosch University, South Africa']
wang23h_interspeech	['Shenzhen Institute of Advanced Technology, Chinese Academy of Sciences', 'Institute of Corpus Studies and Applications, Shanghai International Studies University', 'Department of English Language and Literature, Hong Kong Baptist University']
zhang23m_interspeech	['NERC-SLIP, University of Science and Technology of China (USTC)', 'School of Electronics and Information Engineering, Sichuan University']
luo23b_interspeech	['Tencent AI Lab, Shenzhen, China']
dang23b_interspeech	['Viettel Cyberspace Center, Viettel Group, Hanoi, Vietnam']
shen23_interspeech	['Tilburg University, the Netherlands', 'University of Groningen, the Netherlands']
nuttall23_interspeech	['The Forensic Voice Centre, York, UK', 'University of York, UK']
mariotte23_interspeech	['LAUM UMR CNRS 6613 IAGS, Le Mans Universite, France', 'LIUM, Le Mans Universite, France']
wu23b_interspeech	['Meta Reality Labs Research, USA', 'Graduate Institute of Communication Engineering, National Taiwan University']
yang23j_interspeech	['Qualcomm AI Research†, Qualcomm Korea YH, Seoul, Republic of Korea']
du23_interspeech	['NVIDIA Corporation']
liu23e_interspeech	['Department of Information Engineering and Computer Science, Feng-Chia University']
chen23g_interspeech	['Nanyang Technological University, Singapore', 'Georgia Institute of Technology, USA', 'Tsinghua University, China']
wang23i_interspeech	['Institute of Automation, Chinese Academy of Sciences', 'School of Future Technology', 'University of Chinese Academy of Sciences', 'GammaLab, PingAn OneConnect', 'PingAn Insurance (Group) Company of China']
mao23_interspeech	['School of Management, Fudan University, Shanghai, China']
ma23c_interspeech	['Qifu Technology, China']
panariello23b_interspeech	['EURECOM, Sophia Antipolis, France']
frenkel23_interspeech	['OriginAI, Israel', 'Faculty of Engineering, Bar-Ilan University, Israel']
yang23k_interspeech	['Xiaomi AI Lab, Beijing, China']
gessinger23_interspeech	['ADAPT Centre, University College Dublin, Ireland', 'Phonetics Laboratory, Linguistics, University of California, Davis, USA', 'Language Science and Technology, Saarland University, Saarbrucken, Germany']
wang23j_interspeech	['Zhejiang University, Hangzhou, China', 'Westlake Institute for Advanced Study & Westlake University , Hangzhou, China']
li23j_interspeech	['Tsinghua-CUHK Joint Research Center for Media Sciences, Technologies and Systems,', 'Shenzhen International Graduate School, Tsinghua University, Shenzhen, China', 'Tencent AI Lab, Shenzhen, China', 'Department of Systems Engineering and Engineering Management,', 'The Chinese University of Hong Kong, Hong Kong SAR, China']
naowarat23_interspeech	['Hasan2', 'Chulalongkorn University, Bangkok, Thailand', 'Amazon Alexa, Cambridge, UK']
mosuily23_interspeech	['University of Southampton, United Kingdom']
xiang23_interspeech	['Yousonic Technology, Beijing, China']
ye23_interspeech	['Faculty of Electrical Engineering and Computer Science, Ningbo University, Ningbo, China', 'Zhejiang Key Laboratory of Mobile Network Application Technology, China', 'Ningbo City College of Vocational Technology, Ningbo, China']
wang23l_interspeech	['School of Computer Science and Technology, Soochow University, Suzhou, China', 'Provincial Key Laboratory for Computer Information Processing Technology, Soochow University,', 'Suzhou, China']
mateju23_interspeech	['Faculty of Mechatronics, Informatics and Interdisciplinary Studies,', 'Technical University of Liberec, Studentska 2', ' 17 Liberec, Czech Republic']
harding23_interspeech	['Amazon Alexa']
cao23_interspeech	['Department of Electronic Systems, NTNU, Norway', 'KTH Royal Institute of Technology, EECS, Sweden']
feng23c_interspeech	['Korea Advanced Institute of Science and Technology, South Korea']
xue23_interspeech	"[""School of Computer Science, Northwestern Polytechnical University, Xi'an, China"", 'Huawei Cloud']"
wang23m_interspeech	['Li Liu3(B)', 'Tianyi Xu1', 'Qi Li4', 'Sen Li1', 'College of Intelligence and Computing, Tianjin University, Tianjin, China', 'Tianjin International Engineering Institute, Tianjin University, Tianjin, China', 'The Hong Kong University of Science and Technology (Guangzhou), Guangzhou, China', 'School of Electrical and Information Engineering, Tianjin University, Tianjin, China']
bae23_interspeech	['Samsung Electronics, Hwaseong, Republic of Korea']
demir23_interspeech	['Yang1', 'SLU Lab. Friedrich-Alexander-Universit¨at Erlangen-Nurnberg, Germany', 'Pattern Recognition Lab. Friedrich-Alexander-Universit¨at Erlangen-Nurnberg, Germany', 'Department of Radiology Friedrich-Alexander-Universit¨at Erlangen-Nurnberg, Germany']
kang23_interspeech	['AITRICS1, KAIST2']
gao23d_interspeech	['Graduate School of Informatics, Kyoto University, Kyoto, Japan']
verma23_interspeech	['†Convin.AI, ‡Indian Institute of Technology Kanpur (IIT-K)']
huang23c_interspeech	['School of Informatics, Xiamen University, China', 'School of Electronic Science and Engineering, Xiamen University, China']
yang23l_interspeech	['Xiaomi Corp., Beijing, China', 'Shanghai Jiao Tong University, Shanghai, China']
huang23d_interspeech	"[""Northwestern Polytechnical University, Xi'an, China""]"
antonova23_interspeech	['NVIDIA, USA']
an23_interspeech	['Speech Lab of DAMO Academy, Alibaba Group, China']
glocker23_interspeech	['AImotion Bavaria, Technische Hochschule Ingolstadt, Germany', 'Intel Labs, Germany']
liu23f_interspeech	['MoE Key Lab of Artificial Intelligence, AI Institute', 'X-LANCE Lab, Department of Computer Science and Engineering', 'Shanghai Jiao Tong University, Shanghai, China']
feindt23_interspeech	['ISFAS, Kiel University, Germany', 'Division of Speech, Music & Hearing, KTH Royal Institute of Technology, Sweden']
zheng23b_interspeech	['National Engineering Research Center of Speech and Language Information Processing,', 'University of Science and Technology of China, Hefei, P. R. China']
zhang23n_interspeech	['JD Technology Group']
alastruey23_interspeech	['TALP Research Center, Universitat Politecnica de Catalunya, Barcelona, Spain', 'Amazon Alexa, Germany']
chen23h_interspeech	['National Yang Ming Chiao Tung University', ' Academia Sinica,', 'National Cheng Kung University Hospital']
vandereeckt23_interspeech	['KU Leuven', 'Department Electrical Engineering ESAT-PSI, Leuven, Belgium']
spiesberger23_interspeech	['Chair of Embedded Intelligence for Health Care and Wellbeing, University of Augsburg, Germany', 'audEERING GmbH, Gilching, Germany', 'GLAM – Group on Language, Audio, & Music, Imperial College, UK']
zhou23d_interspeech	['DAMO Academy, Alibaba Group, China']
li23k_interspeech	['Technische Universit¨at Braunschweig', 'Institute for Communications Technology', 'Schleinitzstr. 22', ' Braunschweig, Germany']
sach23_interspeech	['*Technische Universit¨at Braunschweig', 'Institute for Communications Technology', 'Braunschweig, Germany', '◦Goodix Technology (Belgium) BV', 'Leuven, Belgium']
liu23g_interspeech	['MoE Key Lab of Artificial Intelligence, AI Institute', 'X-LANCE Lab, Department of Computer Science and Engineering', 'Shanghai Jiao Tong University, Shanghai, China']
liu23h_interspeech	['School of Communication and Information Engineering, Chongqing University', 'of Posts and Telecommunications, Chongqing 400065, China', 'Audio Analysis Lab, CREATE, Aalborg University', ' Aalborg, Denmark']
garnier23_interspeech	['Univ. Grenoble Alpes, CNRS, Grenoble INP, GIPSA-lab', ' Grenoble, France']
strauch23_interspeech	['Institute of Imaging & Computer Vision, RWTH Aachen University, Aachen, Germany', 'Clinic for Phoniatrics, Pedaudiology and Communication Disorders,', 'University Hospital and Medical Faculty of RWTH Aachen University, Aachen, Germany']
li23l_interspeech	['State Key Laboratory of Industrial Control Technology, Institute of Cyber Systems and Control,', 'Zhejiang University, China']
xin23b_interspeech	['Graduate School of Information Science and Technology, The University of Tokyo, Japan']
jiang23d_interspeech	['Microsoft Research', 'University of Cambridge', 'Microsoft Azure Speech']
gong23_interspeech	['School of Information and Communication Engineering, Beijing University of Posts and', 'Telecommunications, China']
wang23n_interspeech	['School of Electronic Information, Sichuan University, China']
choi23d_interspeech	['Department of Artificial Intelligence, Korea University, Seoul, Korea']
wu23c_interspeech	['Department of Electrical Engineering, National Tsing Hua University, Taiwan']
khan23_interspeech	['Xperi Inc.', 'SpeakUnique Ltd.', 'University of Edinburgh']
ma23d_interspeech	['MoE Key Lab of Artificial Intelligence, AI Institute,', 'X-LANCE Lab, Department of Computer Science and Engineering,', 'Shanghai Jiao Tong University, Shanghai, China', 'Department of Electronic Engineering, Tsinghua University, Beijing, China']
wang23o_interspeech	['Li Liu3(B)', 'Tianyi Xu1', 'Qi Li4', 'Sen Li1', 'College of Intelligence and Computing, Tianjin University, Tianjin, China', 'Tianjin International Engineering Institute, Tianjin University, Tianjin, China', 'The Hong Kong University of Science and Technology (Guangzhou), Guangzhou, China', 'School of Electrical and Information Engineering, Tianjin University, Tianjin, China']
kudera23_interspeech	['Department of Phonetics, Trier University, Germany']
lu23b_interspeech	['Department of Electrical Engineering, National Tsing Hua University, Taiwan']
yang23m_interspeech	['NetEase Yidun AI Lab, Hangzhou, China']
manocha23_interspeech	['Department of Computer Science, Princeton University, Princeton, NJ, USA', 'Meta Reality Labs Research, USA']
zhang23o_interspeech	['Amazon TTS', ' Department of Electronic Engineering, The Chinese University of Hong Kong,', 'Gda´nsk University of Technology', ' University of Warsaw']
wang23p_interspeech	['Ecole Polytechnique Federale de Lausanne, Lausanne, Switzerland', 'Logitech Europe S.A., Lausanne, Switzerland']
grosz23_interspeech	['Department of lnformation and Communications Engineering, Aalto University, Finland']
mijnders23_interspeech	['Radboud University, The Netherlands', 'GGNet Mental Health, The Netherlands', 'University of Twente, The Netherlands']
wang23q_interspeech	['Nankai University, Tianjin, China']
cui23b_interspeech	['Alibaba Group, China']
liu23i_interspeech	['MoE Key Lab of Artificial Intelligence, AI Institute', 'X-LANCE Lab, Department of Computer Science and Engineering', 'Shanghai Jiao Tong University, Shanghai, China']
arts23_interspeech	['University of Twente, The Netherlands']
chang23_interspeech	['MIT CSAIL, USA']
rouas23_interspeech	['Univ. Bordeaux, CNRS, Bordeaux INP, LaBRI, UMR 5800, F-33400 Talence, France', 'CRISCO/UR4255, Universite de Caen Normandie', ' Caen, France', 'Laboratoire de Phonetique et Phonologie UMR7018, CNRS-Sorbonne Nouvelle, France', 'LISN UMR 9015, CNRS, Univ. Paris-Saclay, France', 'CLLE CNRS UMR 5263, Bordeaux, France']
song23b_interspeech	['School of Information Science and Engineering, Xinjiang University, China', 'Xinjiang Key Laboratory of Signal Detection and Processing, China', 'Department of Electronic Engineering, Tsinghua University, China']
wang23r_interspeech	['Nankai University, China', 'Kuaishou Technology, China']
yariv23_interspeech	['♡The Hebrew University of Jerusalem , ♢Technion - Israel Institute of Technology', '♠Tel-Aviv University, ♣NetApp']
vashishth23_interspeech	['Google Research']
lin23f_interspeech	['Institute of Communication Engineering, National Tsing Hua University, Taiwan', 'Department of Electrical Engineering, National Tsing Hua University, Taiwan', 'E.SUN Financial Holding Co., Ltd., Taiwan']
lux23_interspeech	['University of Stuttgart, Institute for Natural Language Processing, Germany']
comini23_interspeech	['Amazon Alexa, TTS Research']
lin23g_interspeech	['Department of Computer Science and Information &', 'Empower Vocational Education Research Center,', 'National Taiwan University of Science and Technology, Taiwan']
kotey23_interspeech	['ADAPT Centre, School of Engineering, Trinity College Dublin, Ireland', 'ADAPT Centre, Department of Computer Science, Maynooth University, Ireland']
wang23s_interspeech	['College of Computer Science,Inner Mongolia University,China']
chien23_interspeech	['National Yang Ming Chiao Tung University', ' Academia Sinica', 'National Cheng Kung University Hospital']
liu23j_interspeech	['School of Informatics, University of Edinburgh, United Kingdom']
lehecka23_interspeech	['Department of Cybernetics, University of West Bohemia Pilsen, Czech Republic']
kogel23_interspeech	['Sony Europe B.V., Stuttgart Laboratory 1, Germany']
novoselov23_interspeech	['ITMO University, St.Petersburg,', 'STC Ltd., St.Petersburg,']
kovalyov23_interspeech	['Electrical and Computer Engineering, University of Texas at Dallas, Richardson, TX, USA']
cohen23_interspeech	['Sony Semiconductor Israel, Israel']
xu23d_interspeech	"[""Northwestern Polytechnical University, Xi'an, China""]"
chu23_interspeech	['School of Optoelectronic Science and Engineering, Soochow University, China', '∗Corresponding authors: Di Wu, Zhi Tao']
kirkland23_interspeech	['Division of Speech, Music & Hearing, KTH Royal Institute of Technology, Stockholm, Sweden']
liu23k_interspeech	['Shenzhen Research Institute of Big Data, Shenzhen, China', 'School of Data Science, The Chinese University of Hong Kong, Shenzhen, China', 'Department of Electrical and Computer Engineering, National University of Singapore, Singapore']
wu23d_interspeech	['Department of Electrical Engineering, National Tsing Hua University, Taiwan', 'Agency Against Corruption, Ministry of Justice, Taiwan', 'CPC Corporation, Taiwan']
nayem23_interspeech	['§Department of Computer Science, Indiana University, Bloomington, USA', '†Amazon, Alexa AI, Cambridge, USA']
carvalho23_interspeech	['INESC-ID, Lisbon, Portugal', 'Instituto Superior Tecnico, Universidade de Lisboa, Portugal']
tao23_interspeech	['University of Glasgow, UK', 'Univerista degli Studi della Campania Luigi Vanvitelli, Italy']
muller23_interspeech	['Fraunhofer AISEC']
bahar23_interspeech	['AppTek GmbH, Aachen, Germany', 'RWTH Aachen University, Aachen, Germany']
zhao23d_interspeech	['Audio Information Processing, Technical University of Munich, Germany']
bataev23_interspeech	['NVIDIA', 'University of London, UK;', 'ITMO University, Russia;', 'Higher School of Economics, Russia']
rumberg23_interspeech	['Institut fur Informationsverarbeitung - L3S, Leibniz University Hannover, Germany', 'Institut fur Sonderp¨adagogik, Leibniz University Hannover, Germany']
khandelwal23_interspeech	['Fortemedia Singapore, Singapore']
wang23t_interspeech	['Peking University, Beijing, China', 'Microsoft Research Asia, Beijing, China']
chen23i_interspeech	['Fancellu2, Thomas Schaaf2', 'University of Illinois at Urbana-Champaign', 'M Health Information Systems']
liu23l_interspeech	"['University of Surrey, UK', 'ByteDance, China', ""Xi'an Jiaotong-Liverpool University, China"", 'Southern University of Science and Technology, China 5Izmir Katip Celebi University, Turkey']"
sharma23_interspeech	['Electrical and Computer Engineering1, Language Technologies Institute 2', 'Carnegie Mellon University, USA']
liang23b_interspeech	['MoE Key Lab of Artificial Intelligence, AI Institute', 'X-LANCE Lab, Department of Computer Science and Engineering', 'Shanghai Jiao Tong University, Shanghai, China']
gebauer23_interspeech	['Institut fur Informationsverarbeitung - L3S, Leibniz University Hannover, Germany', 'Institut fur Sonderpadagogik, Leibniz University Hannover, Germany']
wang23u_interspeech	['MoE Key Lab of Artificial Intelligence, AI Institute', 'X-LANCE Lab, Department of Computer Science and Engineering', 'Shanghai Jiao Tong University, Shanghai, China']
piton23_interspeech	['Universite de Geneve, Switzerland', 'Campus Biotech, Switzerland', 'Idiap Research Institute, Switzerland']
koppelmann23_interspeech	['Institute of Communication Acoustics, Ruhr-Universit¨at Bochum, Bochum, Germany']
kano23_interspeech	['Nara Institute of Science and Technology, Japan']
lee23e_interspeech	['NAVER Cloud, South Korea']
jain23_interspeech	['School of Electrical and Electronics Engineering, University of Galway, Galway, Ireland', 'Speech and Dialogue Research Laboratory, University Politehnica of Bucharest, Romania']
wen23b_interspeech	['Chuan Wen1, Sarah Verhulst1']
ng23_interspeech	['Department of Electronic Engineering, The Chinese University of Hong Kong', 'Department of Chinese and Bilingual Studies, The Hong Kong Polytechnic University']
sun23b_interspeech	['Centre for Vision, Speech and Signal Processing (CVSSP), University of Surrey, UK', 'Department of Electrical and Electronics Engineering, Izmir Katip Celebi University, Turkey']
dineley23_interspeech	"[""Institute of Psychiatry, Psychology and Neuroscience, King's College London, London, UK"", 'School of Psychology, University of Sussex, Falmer, UK', 'Institute of Health Informatics, University College London, London, UK', 'MIT Lincoln Laboratory, Lexington, MA, USA']"
nielsen23_interspeech	['School of Informatics', 'University of Edinburgh, UK']
elie23b_interspeech	['Linguistics and English Language; the University of Edinburgh; Edinburgh, Scotland, UK']
alvarado23_interspeech	['Mendoza2, Richard Stern3, Nestor Becerra Yoma1', 'Speech Processing and Transmission Laboratory, University of Chile', 'Clinical Hospital, University of Chile', 'Department of Electrical and Computer Engineering, Carnegie Mellon University']
calderondepalma23_interspeech	['Radboud University Medical Center, The Netherlands', 'Washington State University, United States of America', 'Trinity College Dublin; Global Brain Health Institute; Trinity College Institute of Neuroscience;', 'Trinity Centre for Biomedical Engineering, Ireland']
abbas23_interspeech	['Alexa AI, Amazon']
pouthier23_interspeech	"['NXP Semiconductors, France', ""Universite Cˆote d'Azur, Inria, CNRS, LJAD, I3S, Maasai, France""]"
raissi23_interspeech	['Machine Learning and Human Language Technology,', 'Computer Science Department, RWTH Aachen University', ' Aachen, Germany', 'AppTek GmbH', ' Aachen, Germany']
wan23_interspeech	['Microsoft Research Asia', 'Computer Science Department, University of California, Los Angeles']
gaultier23_interspeech	['Cambridge Hearing Group, MRC Cognition and Brain Sciences Unit, University of Cambridge, UK']
sabev23_interspeech	['Department of Language Science and Technology, Saarland University, Germany', 'Department of Romance Studies, Johannes Gutenberg University Mainz, Germany']
lavechin23_interspeech	['LSCP, ENS, EHESS, CNRS, PSL University, Paris, France', 'Meta AI Research, France', 'Unit of Computing Sciences, Tampere University, Finland', 'IRIT, CNRS, Toulouse, France', 'Cognitive Machine Learning Team, INRIA, France']
liu23m_interspeech	['Centre for Vision, Speech and Signal Processing (CVSSP), University of Surrey, UK', 'Speech, Audio, and Music Intelligence (SAMI) Group, ByteDance, China']
zhang23p_interspeech	['Yeshiva University, NYC, NY, USA', 'Cornell University, Ithaca, NY, USA']
park23d_interspeech	['The University of Tokyo, Japan']
kushwaha23_interspeech	['Courant Institute of Mathematical Sciences, New York University, NY, USA', 'MARL, New York University, NY, USA', 'IDM, New York University, NY, USA']
belagali23_interspeech	['Electrical Engineering, Indian Institute of Science, Bengaluru 560012, India']
zhang23q_interspeech	['Tencent AI Lab, Bellevue, WA, USA', 'Tencent Ethereal Audio Lab, Shenzhen, Guangdong, China']
jakubiak23_interspeech	['University of Warsaw, Poland']
kolehmainen23_interspeech	['Amazon, US']
oberhag23_interspeech	['Institute of Communication Acoustics, Ruhr-Universit¨at Bochum, Bochum, Germany', 'WS Audiology, Erlangen, Germany']
christodoulidou23_interspeech	['Aristotle University of Thessaloniki, Greece']
moussa23_interspeech	['Federal Criminal Police Office (BKA), Germany', 'IT Security Infrastructures Lab, Friedrich-Alexander University of Erlangen-Nurnberg, Germany', 'Data Science Chair, Julius-Maximilians University of Wurzburg, Germany']
sullivan23_interspeech	['The University of British Columbia, Canada', 'Mohamed bin Zayed University of Artificial Intelligence, UAE']
archerboyd23_interspeech	['Institute of Communication Acoustics, Ruhr-Universit¨at Bochum, Bochum, Germany']
lu23c_interspeech	['Liu2, Feng-Ju Chang2, Simon Wiesler2, Grant P. Strimel2', 'Cambridge University, UK', 'Amazon Alexa']
rybakov23b_interspeech	['Google Research']
brown23_interspeech	['Department of Linguistics and English Language, Lancaster University, Lancaster, UK', 'Soundscape Voice Evidence, Lancaster, UK']
hou23_interspeech	['WAVES Research Group, Ghent University, Belgium. 2University of Leicester, UK.', 'Shenzhen University, China. 4University College London, UK.', 'AIRO-IDlab, Ghent University-Imec, Belgium. 6University of Surrey, UK.']
stemmer23_interspeech	['Cordourier Maruri5, Tobias Bocklet6', ',6Intel Corp., Germany', ',3,5Intel Corp., Mexico', 'Intel Corp., USA']
ditthapron23_interspeech	['Worcester Polytechnic Institute', ' Institute Rd, Worcester, MA 01609 ,USA']
ristea23_interspeech	['Cutler', 'Microsoft Corp.']
shechtman23_interspeech	['IBM Research AI']
kuang23_interspeech	['University of Pennsylvania, USA']
leem23_interspeech	['Department of Electrical and Computer Engineering, The University of Texas at Dallas', 'Occupational Therapy and Psychological & Brain Sciences, Boston University', 'Department of Biostatistics, Harvard T.H. Chan School of Public Health, Harvard University', 'Psychology Department, San Francisco State University']
fathullah23_interspeech	['University of Cambridge, UK', 'Meta AI, USA']
soltau23_interspeech	['Google DeepMind, USA', 'tomato.ai, USA']
lu23d_interspeech	['Apple']
zaiem23_interspeech	['LTCI, Telecom Paris, Institut Polytechnique de Paris, France', 'Samsung AI Center, Cambridge, United-Kingdom', 'University of Cambridge, United-Kingdom']
hedegard23_interspeech	['Universitat Bern', 'Zurich Forensic Science Institute', 'Universitat Tubingen']
talafha23_interspeech	['The University of British Columbia, Canada', 'Mohamed bin Zayed University of Artificial Intelligence, UAE']
pudo23_interspeech	['Janicki2', 'Samsung R&D Institute Poland', 'Warsaw University of Technology, Poland']
chi23_interspeech	['Centre for Speech Technology Research, University of Edinburgh', 'Center for Language and Speech Processing, Johns Hopkins University', 'Department of Computer Science, Indian Institute of Technology Bombay', 'Qatar Computing Research Institute, HBKU, Qatar']
ahn23_interspeech	['University of Washington, USA', 'University of Zurich, Switzerland']
rouditchenko23_interspeech	['Karlinsky2,3, Hilde Kuehne3,4, David Harwath5, Brian Kingsbury2,3, James Glass1', 'MIT, USA', 'IBM Research AI, USA', 'MIT-IBM Watson AI Lab, USA', 'Goethe University', 'Frankfurt, Germany', 'UT Austin, USA']
zhou23e_interspeech	['Machine Learning and Human Language Technology, Computer Science Department,', 'RWTH Aachen University', ' Aachen, Germany', 'AppTek GmbH', ' Aachen, Germany']
pal23_interspeech	['AWS AI Labs, USA', 'School of Informatics, University of Edinburgh, Scotland', 'Center for Information and Language Processing, LMU Munich, Germany']
heggan23_interspeech	['School Of Engineering, University of Edinburgh, Scotland', 'School Of Informatics, University of Edinburgh, Scotland', 'Thales UK RTI']
srivastava23_interspeech	['Universite de Lorraine, CNRS, Inria, Loria, F-54000 Nancy, France', 'Audio and Speech Processing Research Group, Tampere University, Finland']
zhang23r_interspeech	['Samsung AI Centre, Cambridge, UK']
mitsui23_interspeech	['rinna Co., Ltd., Tokyo, Japan']
huang23e_interspeech	['NLP2CT Lab, University of Macau', 'Tencent AI Lab']
jiang23e_interspeech	['Department of Engineering, University of Cambridge, Trumpington St., Cambridge, CB2 1PZ UK.', 'Department of Electrical Engineering, Tsinghua University, Beijing', ', P. R. China']
garnier23b_interspeech	['Univ. Grenoble Alpes, CNRS, Grenoble INP, GIPSA-lab', ' Grenoble, France', 'Grenoble INP, LIG, Univ. Grenoble Alpes, Inria, CNRS, Grenoble, France']
lavania23_interspeech	['AWS AI Labs', 'Amazon Web Services']
cooper23_interspeech	['National Institute of Informatics, Japan']
chen23j_interspeech	['National Taiwan University, Taiwan', 'Google, USA', 'Georgia Tech, USA']
malik23_interspeech	['Emulation AI', 'Trusted Networks Lab, Queensland University of Technology (QUT), Australia 3GLAM – Group on', 'Language, Audio, & Music, Imperial College London, UK', 'Chair of Embedded Intelligence for Health Care and Wellbeing, University of Augsburg, Germany']
liang23c_interspeech	['⋆Centre for Digital Music, Queen Mary University of London, UK', '∗Centre for Vision, Speech and Signal Processing (CVSSP)', '† Amazon Alexa ‡ The Alan Turing Institute, UK']
yakovlev23_interspeech	['ID R&D Inc., New York, USA']
ku23_interspeech	['Georgia Institute of Technology, U.S.A', 'Kore University of Enna, Italy', 'Norwegian University of Science and Technology, Norway']
yen23_interspeech	['Georgia Institute of Technology, USA', 'Research Center for Information Technology Innovation, Academia Sinica, Taiwan', 'Kore University of Enna, Italy and 4IBM Research, USA']
zaiem23b_interspeech	['LTCI, Telecom Paris, Institut Polytechnique de Paris, France', 'Hi! PARIS Engineering Team, France', 'Capgemini, France', 'Samsung AI Center, Cambridge, United-Kingdom', 'University of Cambridge, United-Kingdom', 'Mila-Quebec AI Institute, Universite de Montreal, Concordia University, Canada']
eskimez23_interspeech	['Microsoft, Redmond, WA, USA']
do23_interspeech	['Cambridge Research Laboratory, Toshiba Europe Ltd., Cambridge, UK', 'The University of Sheffield, Sheffield, UK', 'E-mails:']
villalba23_interspeech	['L. Paola Garcia-Perera1,2, Pedro A. Torres-Carrasquillo3, Najim Dehak1,2', 'Center for Language and Speech Processing', 'Human Language Technology Center of Excellence,', ',2Johns Hopkins University, Baltimore, MD, USA', 'MIT Lincoln Laboratory, Lexington, MA, USA']
saito23_interspeech	['The University of Tokyo, Japan', 'LINE Corp., Japan.']
subramanian23_interspeech	['Canary Speech, USA', 'Beth Israel Medical Center, USA']
yu23_interspeech	['Google USA⋆, University of Michigan†, Google Israel‡']
saito23b_interspeech	['The University of Tokyo, Japan', 'LINE Corp., Japan.']
olivier23_interspeech	['Carnegie Mellon University, USA']
naini23_interspeech	['Multimodal Signal Processing (MSP) Lab., Department of Electrical and Computer Engineering', 'The University of Texas at Dallas, Richardson TX 75080, USA']
mishra23_interspeech	['Department of Electrical Engineering, Indian Institute of Technology (IIT) Dharwad, India', 'Department of Electronics and Communication Engineering, KLE Technological University, India']
chou23_interspeech	['Multimodal Signal Processing (MSP) lab, Department of Electrical and Computer Engineering', 'The University of Texas at Dallas, Richardson TX 75080, USA', 'Department of Electrical Engineering, National Tsing Hua University, Taiwan']
araki23_interspeech	['NTT Corporation, Japan', 'Faculty of Systems Engineering, Wakayama University, Japan']
haque23_interspeech	['University of Texas at Dallas, USA', 'University of California, Riverside, USA']
shim23_interspeech	['Qualcomm AI Research†, Qualcomm Korea YH, Seoul, Republic of Korea']
huo23_interspeech	['Department of Linguistics, University of Illinois Urbana-Champaign, USA', 'Department of Speech and Hearing Science, University of Illinois Urbana-Champaign, USA', 'Beckman Institute for Advanced Science and Technology, USA']
zhang23s_interspeech	['University of British Columbia, Canada']
wu23e_interspeech	['Google LLC, USA']
lee23f_interspeech	['Samsung Research, Seoul, South Korea']
huybrechts23_interspeech	['Kirchhoff1', 'AWS AI Labs, USA', 'AWS AI Labs, Australia']
chen23k_interspeech	['Shenzhen International Graduate School, Tsinghua University, Shenzhen, China', 'Tencent Ethereal Audio Lab, Tencent, Shenzhen, China', 'The Chinese University of Hong Kong, Hong Kong SAR, China']
nagano23_interspeech	['NTT Human Informatics Laboratories, Japan', 'NTT Communication Science Laboratories, Japan']
zhang23t_interspeech	['Department of Applied Mathematics and Statistics, Stony Brook University, Stony Brook, NY, USA', 'Amazon.com Inc, Seattle, WA, USA']
deshmukh23_interspeech	['Microsoft']
rybakov23c_interspeech	['Google Research']
yanagida23_interspeech	['NTT Corporation, Japan']
szalay23_interspeech	['The University of Sydney, Australia']
deb23_interspeech	['Kanti Gayen1, Shankha Sanyal1, Archi Banerjee3, Samir Karmakar1', 'Jadavpur University, India', 'University of Toronto, Canada', 'IIT Kharagpur, India']
guan23_interspeech	['School of Informatics, Xiamen University, China', 'Institute of Artificial Intelligence, Xiamen University, China', 'School of Electronic Science and Engineering, Xiamen University, China']
avila23_interspeech	['University of Texas at El Paso, United States']
sun23c_interspeech	['Institute of Corpus Studies and Applications, Shanghai International Studies University, China', 'Speech-Language-Hearing Center, School of Foreign Languages, Shanghai Jiao Tong University,', 'China']
ning23_interspeech	"[""Northwestern Polytechnical University, Xi'an, China"", 'Fuxi AI Lab, NetEase Inc., Hangzhou, China', 'Shanghai Jiao Tong University, Shanghai, China']"
kim23d_interspeech	['Language Lab, LG AI Research, Seoul, Republic of Korea']
gulzar23_interspeech	['NTT, Software Innovation Center, Japan', 'Tokyo Institute of Technology, Japan']
nagase23_interspeech	['Graduate School of Information Science and Engineering, Ritsumeikan University, Japan', 'College of Information Science and Engineering, Ritsumeikan University, Japan']
wang23v_interspeech	['School of Computer Science, Wuhan University, Wuhan, China', 'Data Science Research Center, Duke Kunshan University, Kunshan, China', 'Data & AI Engineering System, OPPO, Beijing, China']
yang23n_interspeech	['University of Science and Technology of China, Hefei, China', 'Georgia Institute of Technology, Atlanta, GA, USA', 'Sensetime Research, Shanghai, China']
zhang23u_interspeech	['School of Computer Science and Engineering, Northeastern University, Shenyang, China', 'NiuTrans Research, Shenyang, China']
grageda23_interspeech	['Speech Processing and Transmission Lab., Electrical Engineering Department, University of Chile', 'MSP Lab, Department of Electrical and Computer Engineering, The University of Texas at Dallas']
li23m_interspeech	['South China University of Technology, Guangzhou, China', 'Pazhou Lab, Guangzhou, China', 'VoiceAI Technologies, Shenzhen, China', 'Forensic Science Institute of Guangzhou Public Security Bureau']
yang23o_interspeech	"['Audio, Speech and Language Processing Group, School of Computer Science,', ""Northwestern Polytechnical University, Xi'an, China"", 'Tencent Technology Co., Ltd, Beijing, China']"
gao23e_interspeech	['Rutgers University', 'Amazon APT']
zeng23b_interspeech	['National Engineering Research Center of Speech and Language Information Processing,', 'University of Science and Technology of China, Hefei, China.', 'ICT Cluster, Singapore Institute of Technology, Singapore.', 'iFLYTEK Research, iFLYTEK CO. LTD., Hefei, China.']
li23n_interspeech	['National Engineering Research Centre of Speech and Language Information Processing,', 'University Of Science And Technology Of China, Hefei, China.', 'ICT Cluster, Singapore Institute of Technology, Singapore.', 'iFLYTEK Research, iFLYTEK Co. Ltd, Hefei, China.']
luong23_interspeech	['National Institute of Informatics, Japan']
chen23l_interspeech	['Language Technologies Institute, Carnegie Mellon University, USA', 'Electrical and Computer Engineering, Carnegie Mellon University, USA', 'Meta, USA']
lv23_interspeech	"[""Northwestern Polytechnical University, Xi'an, China"", 'Tencent Technology Co., Ltd, Beijing, China']"
muthuchamyselvaraj23_interspeech	['Rapid-Rich Object Search (ROSE) Lab, Nanyang Technological University, Singapore', 'School of Computer Science and Engineering, Nanyang Technological University, Singapore', 'DSO National Laboratories, Singapore']
tanaka23_interspeech	['NTT Communication Science Laboratories, NTT Corporation, Japan']
peng23b_interspeech	['Carnegie Mellon University, Pittsburgh, PA, USA', 'ASAPP Inc., Mountain View, CA, USA']
chin23_interspeech	['The MARCS Institute for Brain, Behaviour and Development, Western Sydney University,', 'Australia', 'School of Psychology, Western Sydney University, Australia']
buker23_interspeech	['CIS Department, CCSIT, Imam Abdulrahman Bin Faisal University, Dammam, SA', 'University of Glasgow, Glasgow, UK']
heo23b_interspeech	['NAVER Cloud Corporation, South Korea', 'Bobidi, South Korea', 'Korea Advanced Institute of Science and Technology, South Korea']
su23_interspeech	['School of Information and Electronics, Beijing Institute of Technology, Beijing, China']
wang23w_interspeech	['University of Science and Technology of China, Hefei, China', 'State Key Laboratory of Multimodal Artificial Intelligence Systems, Institute of Automation,', 'Chinese Academy of Sciences, Beijng, China', 'School of Artificial Intelligence, University of Chinese Academy of Sciences, China', 'Department of Automation, Tsinghua University']
biswas23_interspeech	['Oracle Cloud Infrastructure, India', 'Oracle Cloud Infrastructure, France']
ng23b_interspeech	['Speech Lab of DAMO Academy, Alibaba Group', 'School of Computer Science and Engineering, Nanyang Technological University, Singapore']
yang23p_interspeech	['⋆National Yang Ming Chiao Tung University, Taiwan', '†Georgia Institute of Technology, USA']
peng23c_interspeech	['Carnegie Mellon University, Pittsburgh, PA, USA', 'Honda Research Institute Japan Co., Ltd., Saitama, Japan']
zhang23v_interspeech	['National Institute of Informatics, Tokyo, Japan', 'SOKENDAI (The Graduate University for Advanced Studies), Kanagawa, Japan', 'Digital Security Department, EURECOM, France']
p23_interspeech	['Adavanced Technology Development Centre,', 'Department of Computer Science and Engineering,', 'Indian Institute of Technology, Kharagpur, India-721302']
xie23_interspeech	['Center for Robust Speech Systems (CRSS), University of Texas at Dallas, TX']
chen23m_interspeech	['MoE Key Lab of Artificial Intelligence, AI Institute', 'X-LANCE Lab, Department of Computer Science and Engineering, Shanghai Jiao Tong University', 'AISpeech Ltd, Suzhou, China']
ng23c_interspeech	['Speech Lab of DAMO Academy, Alibaba Group', 'School of Computer Science and Engineering, Nanyang Technological University, Singapore']
jung23b_interspeech	['Channel Corporation, Republic of Korea', 'Naver Cloud, Republic of Korea']
chen23n_interspeech	['MoE Key Lab of Artificial Intelligence, AI Institute', 'X-LANCE Lab, Department of Computer Science and Engineering, Shanghai Jiao Tong University', 'Shenzhen Research Institute of Big Data, Shenzhen, China']
xiong23_interspeech	['School of Electrical, Computer and Energy Engineering', 'Arizona State University, Tempe, Arizona, USA']
ye23b_interspeech	['ByteDance']
kamo23_interspeech	['NTT Corporation, Japan']
shi23e_interspeech	['Nagoya University, Japan', 'Hainan University, China']
faustini23_interspeech	['Macquarie University, Sydney, NSW, Australia', 'Amazon.com, Inc., Seattle, WA, USA']
shi23f_interspeech	['School of Computer Science and Technology, Harbin Institute of Technology, China', 'Center for Speech and Language Technologies, BNRist, Tsinghua University, China', 'School of Artificial Intelligence, Beijing University of Posts and Telecommunications, China', 'Huawei Technologies Co., Ltd.']
lei23_interspeech	['School of Computer and Information Engineering, Jiangxi Normal University, Nanchang, China']
iwamoto23_interspeech	['Tokyo Institute of Technology', 'www.ts.ip.titech.ac.jp']
wang23x_interspeech	['University of Science and Technology of China, Hefei, China', 'State Key Laboratory of Multimodal Artificial Intelligence Systems, Institute of Automation,', 'Chinese Academy of Sciences, Beijng, China', 'School of Artificial Intelligence, University of Chinese Academy of Sciences, China', 'Department of Automation, Tsinghua University']
kim23e_interspeech	['Hanynag University, Seoul, Republic of Korea']
johnson23_interspeech	['University of California, Los Angeles, Department of Electrical and Computer Engineering']
shekar23_interspeech	['Center of Robust Speech Systems,', 'The University of Texas at Dallas, US']
wang23y_interspeech	['The Chinese University of Hong Kong, China', 'Nanyang Technological University, Singapore']
guo23_interspeech	['University of Science and Technology of China, Hefei 230027, China', 'Georgia Institute of Technology, Atlanta, GA. 30332-0250, USA', 'AI Innovation Center, Midea Group (Shanghai) Co.,Ltd., Shanghai 201702, China']
tsubokura23_interspeech	['Aichi Prefectural University, Japan', 'Toyohashi University of Technology, Japan']
lin23i_interspeech	['ByteDance']
xu23e_interspeech	['Tager-Flusberg2, Shrikanth Narayanan1', 'University of Southern California, Los Angeles, CA, USA', 'Boston University, Boston, MA, USA']
li23o_interspeech	['Department of Computer Science and Engineering, Shanghai Jiao Tong University, Shanghai, China', 'Microsoft, Redmond, WA, USA']
zhang23w_interspeech	['MoE Key Lab of Artificial Intelligence, AI Institute', 'X-LANCE Lab, Department of Computer Science and Engineering', 'Shanghai Jiao Tong University, China']
gitman23_interspeech	['NVIDIA, USA', 'ITMO University, Russia']
kim23f_interspeech	['Korea Advanced Institute of Science and Technology (KAIST), South Korea', 'AITRICS, South Korea']
yasuda23_interspeech	['Nagoya University, Japan']
zhang23x_interspeech	['School of Information Science and Engineering, Xinjiang University, Urumqi 830017, China', 'Xinjiang Key Laboratory of Signal Detection and Processing, Urumqi 830017, China', 'Department of Electronic Engineering, Tsinghua University, Beijing 100084, China']
kong23c_interspeech	['‡UCSD', '†NVIDIA']
liu23n_interspeech	['National Engineering Research Center of Speech and Language Information Processing,', 'University of Science and Technology of China, Hefei, P.R.China', 'iFLYTEK Research, iFLYTEK Co. Ltd., China']
chen23o_interspeech	['Speech Lab, Alibaba Group, Hangzhou, China', 'University of Science and Technology of China, Hefei, China']
li23p_interspeech	['School of Information Science and Engineering, Xinjiang University, China', 'School of Artificial Intelligence, Beijing University of Posts and Telecommunications, China', 'Center for Speech and Language Technologies, Tsinghua University, China']
kashiwagi23b_interspeech	['Sony Group Corporation, Japan,', 'Carnegie Mellon University, USA']
yang23q_interspeech	"[""Faculty of Electronic and Information Engineering, Xi'an Jiaotong University, China"", 'Speech Lab of DAMO Academy, Alibaba Group', 'Nanyang Technological University, Singapore']"
yoon23_interspeech	['Department of Electrical and Electronic Engineering, Yonsei University, Seoul, Korea,', 'NAVER Cloud, South Korea']
duan23_interspeech	['Institute for Infocomm Research (I2R), A*STAR, Singapore']
sudo23_interspeech	['Honda Research Institute Japan Co., Ltd., Saitama, Japan', 'Language Technologies Institute, Carnegie Mellon University, Pittsburgh, PA, USA']
matsuura23_interspeech	['NTT Corporation, Japan']
li23q_interspeech	['Kuaishou Technology Co., Beijing, China', 'Institute of Automation, Chinese Academy of Sciences, Beijing, China']
thakran23_interspeech	['ECE Department1, Infosys Centre for AI & CSE Department2, IIIT Delhi, India']
huang23f_interspeech	['ByteDance']
li23r_interspeech	['School of Computer Science and Technology, Harbin Institute of Technology, Harbin, China', 'School of Mathematical Science, Harbin Normal University, Harbin, China']
shi23g_interspeech	['Carnegie Mellon University', 'National Taiwan University', 'Meta AI', 'Rembrand']
tang23_interspeech	['Ping An Technology (Shenzhen) Co., Ltd., Shenzhen, China', 'University of Science and Technology of China, Hefei, China']
sudo23b_interspeech	['Honda Research Institute Japan Co., Ltd., Saitama, Japan', 'Department of Systems and Control Engineering, School of Engineering,', 'Tokyo Institute of Technology, Tokyo, Japan']
takahashi23_interspeech	['Japan Advanced Institute of Science and Technology, Japan']
liu23o_interspeech	['School of Computing, University of Eastern Finland, Joensuu, Finland', 'Universite de Lorraine, CNRS, Inria, LORIA, F-54000, Nancy, France', 'Institute for Advancing Intelligence, TCG CREST, India', 'Institute for Infocomm Research, A⋆STAR, Singapore']
jang23_interspeech	['School of Electrical Engineering, KAIST', 'Graduate School of AI, KAIST']
gao23f_interspeech	['Amazon, USA']
tran23_interspeech	['AI Center, FPT Software Company Limited, Vietnam', 'School of Computer Science and Information Technology, University College Cork, Ireland', 'Department of Computing Science, Ume˚a University, Sweden']
sudo23c_interspeech	['Honda Research Institute Japan Co., Ltd., Saitama, Japan', 'Language Technologies Institute, Carnegie Mellon University, Pittsburgh, PA, USA']
gupta23_interspeech	['RingCentral Innovation, India', 'RingCentral Inc., USA']
shi23h_interspeech	['Language Technologies Institute, Carnegie Mellon University', 'Meta AI']
wang23z_interspeech	['MoE Key Lab of Artificial Intelligence, AI Institute', 'X-LANCE Lab, Department of Computer Science and Engineering', 'Shanghai Jiao Tong University, Shanghai, China']
nespoli23_interspeech	['Microsoft, London, UK', 'Fraunhofer Institute for Digital Media Technology IDMT, Oldenburg, Germany', 'Imperial College, London, UK']
tian23_interspeech	['Tencent AI LAB', 'Tencent ASR Oteam,', 'Language Technologies Institute, Carnegie Mellon University']
liao23_interspeech	['Hummingbird Audio Lab, Alibaba Group, Hangzhou, China', 'The University of Tokyo, Japan', 'Nanyang Technological University, Singapore']
wang23aa_interspeech	['MoE Key Lab of Artificial Intelligence, AI Institute', 'X-LANCE Lab, Department of Computer Science and Engineering', 'Shanghai Jiao Tong University, Shanghai, China']
sun23d_interspeech	['Wang4, Yuan Cheng4', 'School of Artificial Intelligence, University of Chinese Academy of Sciences', 'State Key Laboratory of Multimodal Artificial Intelligence Systems', 'Department of Automation, Tsinghua University', 'Ant Group']
wang23ba_interspeech	"[""Northwestern Polytechnical University (NPU), Xi'an, China""]"
choi23e_interspeech	['Nagoya University, Japan']
kato23_interspeech	['RevComm Inc., Japan']
hu23e_interspeech	['Tianjin University, China', 'Institute of linguistics, Chinese Academy of Social Sciences, China']
zhang23y_interspeech	['College of Intelligence and Computing, Tianjin University, China', 'Computer College, Qinghai Nationalities University, China 3National Institute of Information and', 'Communications Technology, Japan 4Institute of Automation, Chinese Academy of Sciences, China', 'Department of Automation, Tsinghua University, China']
feng23d_interspeech	['ByteDance Inc, San Jose, CA, US']
han23b_interspeech	['NERCMS, School of Computer Science, Wuhan University, China', 'Hubei Luojia Laboratory, China', 'Hubei Key Laboratory of Multimedia and Network Communication Engineering,', 'Wuhan University, China']
xu23f_interspeech	['NERCMS, School of Computer Science, Wuhan University, China', 'Hubei Luojia Laboratory, China', 'Hubei Key Laboratory of Multimedia and Network Communication Engineering, Wuhan', 'University, China']
yang23r_interspeech	['Tianjin key Laboratory of Cognitive Computing and Application, Tianjin University, China', 'School of Software, Henan University, China', 'Japan Advanced Institute of Science and Technology, Japan']
zhu23f_interspeech	['Shenzhen International Graduate School, Tsinghua University, Shenzhen, China', 'Peng Cheng Lab, Shenzhen, China', 'Tencent AI Lab, Shenzhen, China', 'Tencent AI Lab, Bellevue, WA, USA', 'The Chinese University of Hong Kong, Hong Kong SAR, China']
cordlandwehr23_interspeech	['Haeb-Umbach1', 'Paderborn University, Department of Communications Engineering, Paderborn, Germany', 'Toshiba Cambridge Research Laboratories, Cambridge, United Kingdom']
kim23g_interspeech	['Department of Artificial Intelligence, Korea University, Republic of Korea', 'Department of Brain and Cognitive Engineering, Korea University, Republic of Korea']
xie23c_interspeech	['State Key Laboratory of Media Convergence and Communication, Communication University of', 'China, Beijing 100024, China']
zhou23f_interspeech	['Sichuan Changhong Electronics Holding Group Co. Ltd., China', 'Xinjiang University of Finance & Economics, China', 'Leshan Normal University, China', 'Southwest Petroleum University, China']
saijo23_interspeech	['Department of Communications and Computer Engineering, Waseda University, Tokyo, Japan']
meng23_interspeech	['ByteDance', 'Shenzhen Research Institute of Big Data, School of Data Science, The Chinese University of Hong', 'Kong, Shenzhen, China']
han23c_interspeech	['Seoul National University, Republic of Korea', 'SNU-LG AI Research Center, Republic of Korea', 'LG AI Research, Republic of Korea']
tan23b_interspeech	['Singapore University of Technology and Design, Singapore']
cai23_interspeech	['Speech Processing and Machine Intelligence (SPMI) Lab, Tsinghua University, Beijing, China', 'China Mobile Research Institute, Beijing, China', 'Tsinghua University-China Mobile Communications Group Co., Ltd. Joint Institute, Beijing, China']
geiger23_interspeech	['Know-Center GmbH, Austria', 'Signal Processing and Speech Communication Laboratory, Graz University of Technology, Austria']
mun23_interspeech	['Seoul National University, South Korea', 'University of Eastern Finland, Finland,', 'EURECOM, France', 'National Institute of Informatics, Japan', 'Inria, France', 'TCG CREST, India,', 'Institute for Infocomm Research, A*STAR, Singapore', 'Carnegie Mellon University, USA']
jeoung23_interspeech	['Department of Electronic Engineering, Hanyang University, Seoul, Republic of Korea']
oh23_interspeech	['Department of Intelligence and Information, Seoul National University', 'Supertone, Inc.', 'School of Electronic Engineering, Soongsil University', 'Interdisciplinary Program in Artificial Intelligence, Seoul National University', 'Artificial Intelligence Institute, Seoul National University']
radhakrishnan23_interspeech	['King Abdullah University of Science and Technology, Saudi Arabia', 'Manipal Institute of Technology, India', 'Georgia Institute of Technology, USA', 'SDAIA-KAUST', 'Center of Excellence in Data Science and Artificial Intelligence, Thuwal 23952, Saudi Arabia']
matsuda23_interspeech	['Chiba Institute of Technology']
steiner23_interspeech	['University of Bern, Switzerland', 'University of Zurich, Switzerland']
sasou23_interspeech	['National institute of advanced industrial science and technology, AIST']
ray23_interspeech	['Amazon Alexa, USA', ',3Samsung Research America, USA']
meng23b_interspeech	['Dept. of Systems Engineering & Engineering Management, The Chinese University of Hong Kong', 'Graduate Institute of Communication Engineering, National Taiwan University']
lee23g_interspeech	['National Institute of Advanced Industrial Science and Technology, Japan']
bae23b_interspeech	['KAIST AI', 'Department of AI, Kyungpook National University', 'SmartSound', 'Dongguk University', 'MODULABS']
gao23g_interspeech	['Speech Lab of DAMO Academy, Alibaba Group, China']
lemercier23_interspeech	['Signal Processing (SP), Universit¨at Hamburg, Germany']
xiao23b_interspeech	['Xiong Chen2,B, Weiyan Yi1, Jie Lin1, Yuhong Yang1, Yanzhen Ren3', 'NERCMS, School of Computer Science, Wuhan University', 'Sleep Medicine Centre, Zhongnan Hospital of Wuhan University', 'School of Cyber Science and Engineering, Wuhan University']
wang23ca_interspeech	['School of Electronic Information, Sichuan University, China']
zhu23g_interspeech	['Shenzhen International Graduate School, Tsinghua University, Shenzhen, China', 'Peng Cheng Lab, Shenzhen, China', 'The Chinese University of Hong Kong, Hong Kong SAR, China']
yu23b_interspeech	['Tencent AI Lab, Audio and Speech Signal Processing Oteam']
botelho23_interspeech	['INESC-ID/Instituto Superior Tecnico, University of Lisbon, Portugal', 'Cognitive Systems Lab (CSL), University of Bremen, Germany']
liang23d_interspeech	['Digital Futures and KTH Royal Institute of Technology, Stockholm, Sweden', 'Codemill AB, Ume˚a, Sweden', 'Google LLC, Stockholm, Sweden']
lee23h_interspeech	['Graduate School of Informatics, Kyoto University, Japan']
mallolragolta23_interspeech	['EIHW – Chair of Embedded Intelligence for Health Care & Wellbeing, University of Augsburg, Germany', 'Centre for Interdisciplinary Health Research, University of Augsburg, Germany', 'GLAM – Group on Language, Audio, & Music, Imperial College London, UK']
sun23e_interspeech	['University of Cambridge Department of Engineering, Trumpington St., Cambridge, CB2 1PZ U.K.']
lu23e_interspeech	['National Engineering Research Center of Speech and Language Information Processing,', 'University of Science and Technology of China, Hefei, P. R. China']
wang23da_interspeech	['Department of Electronic Engineering, Tsinghua University, Beijing 100084, China', 'Data & AI Engineering System, OPPO, Beijing 100026, China']
wagner23b_interspeech	['Phonetics Work Group, Faculty of Linguistics and Literary Studies & CITEC, Bielefeld University,', 'Germany']
wang23ea_interspeech	['Beijing National Research Center for Information Science and Technology', 'Department of Electronic Engineering, Tsinghua University, Beijing 100084, China', 'TAL Education, Beijing 100084, China']
lay23_interspeech	['Signal Processing (SP), University of Hamburg, Germany', 'Center for Free-Electron Laser Science, DESY, Hamburg, Germany']
chua23_interspeech	['Psychology, School of Social Sciences, Nanyang Technological University, Singapore', 'School of Electrical and Electronic Engineering, Nanyang Technological University, Singapore', 'CLSP and HLT-COE, Johns Hopkins University, USA', 'Department of Microelectronics, Delft University of Technology, Netherlands']
lahiri23_interspeech	['Narayanan1', 'Signal Analysis and Interpretation Laboratory, University of Southern California, USA', 'Semel Institute of Neuroscience and Human Behavior, University of California, USA', 'School of Psychology, Korea University, Korea']
qian23_interspeech	['Harbin Institute of Technology, Shenzhen, China']
white23_interspeech	['Centre for Language Sciences, Department of Linguistics, Macquarie University, Australia']
venkatathirumalakumar23_interspeech	['Electrical Engineering Department, Indian Institute of Science, Bengaluru, India', 'National Institute of Mental Health and Neurosciences, Bengaluru, India']
shao23_interspeech	"[""Departement d'etudes cognitives, Ecole Normale Superieure, Universite PSL, Paris, France"", 'Laboratoire de Phonetique et Phonologie, UMR7018, CNRS/Sorbonne Nouvelle, Paris, France']"
wang23fa_interspeech	['Gaoling School of Artificial Intelligence, Renmin University of China, China', 'School of Statistics, Renmin University of China, China']
hojo23_interspeech	['NTT Computer and Data Science Laboratories, NTT Corporation, Japan']
tan23c_interspeech	['Ping An Technology, China']
li23s_interspeech	['MoE Key Lab of Artificial Intelligence, AI Institute', 'X-LANCE Lab, Department of Computer Science and Engineering', 'Shanghai Jiao Tong University, Shanghai, China']
markopoulos23_interspeech	['Innoetics, Samsung Electronics, Greece', 'Mobile eXperience Business, Samsung Electronics, Republic of Korea']
lai23c_interspeech	['Dept. of Computer Science, University of Oregon, USA', 'Adobe Research, USA', 'University of Southern California, USA']
liu23p_interspeech	['Department of Electronic Engineering, The Chinese University of Hong Kong']
cuervo23_interspeech	['Universite de Toulon, Aix Marseille Universite, CNRS, LIS, France']
xin23c_interspeech	['School of ECE, Peking University, Shenzhen, China']
lepage23_interspeech	"['Speaker and Language Recognition Group (ESLR),', ""Laboratoire de Recherche de l'EPITA, France""]"
ge23_interspeech	['Institute of Corpus Studies and Applications, Shanghai International Studies University, China', 'Speech-Language-Hearing Center, School of Foreign Languages, Shanghai Jiao Tong University,', 'China']
bharati23_interspeech	['Indian Institute of Technology Kharagpur 721302, India']
zhang23z_interspeech	['Ping An Technology (Shenzhen) Co., Ltd., China']
xiao23c_interspeech	['Tencent Ethereal Audio Lab, Tencent, Shenzhen, China', 'Tencent AI Lab, Tencent, Shenzhen, China', 'Tencent AI Lab, Tencent, Bellevue, WA, USA']
song23c_interspeech	['Tsinghua Univ., Beijing, China 2Horizon Inc., Beijing, China 3WeNet Open Source Community']
lertpetchpun23_interspeech	['Department of Computer Engineering, Chulalongkorn University, Thailand']
niu23_interspeech	['University of Science and Technology of China, Hefei, China', 'Georgia Institute of Technology, Atlanta, USA', 'SenseTime Research']
wang23ga_interspeech	['Wei, Shimin Tao, Min Zhang, Hao Yang', 'Huawei Translation Services Center']
kitagishi23_interspeech	['NTT Corporation']
xu23g_interspeech	['University of Chinese Academy of Sciences, Beijing, China', 'China Mobile Research Institute, Beijing, China']
parcollet23_interspeech	['Samsung AI Center, Cambridge, United-Kingdom']
liu23q_interspeech	['Tencent Ethereal Audio Lab, Tencent, Shenzhen, China', 'Shenzhen International Graduate School, Tsinghua University, Shenzhen, China', 'Institute of Acoustics, Chinese Academy of Sciences, Beijing, China']
wang23ha_interspeech	['Speech Lab, Alibaba Group']
tsunoo23_interspeech	['Sony Group Corporation, Japan', 'Carnegie Mellon University, U.S.A.']
liang23e_interspeech	['Northwestern Polytechnical University, China,', 'Speech Lab of DAMO Academy, Alibaba Group, China']
li23t_interspeech	['Department of Electronic Engineering, The Chinese University of Hong Kong, Hong Kong', 'School of Science and Engineering, The Chinese University of Hong Kong, Shenzhen, China']
wu23f_interspeech	['Xiaomi AI Lab, Beijing, China']
matejka23_interspeech	['Klco2, Junyi Peng1, Themos Stafylakis3 Luk´as Burget1,', 'Phonexia, Czech Republic', 'Omilia, Greece']
yu23c_interspeech	['MoE Key Lab of Artificial Intelligence, AI Institute', 'X-LANCE Lab, Department of Computer Science and Engineering', 'Shanghai Jiao Tong University, Shanghai, China']
diener23_interspeech	['Microsoft Corporation']
kawa23b_interspeech	['Wroclaw University of Science and Technology, Wroclaw, Poland']
kelterer23_interspeech	['Signal Processing and Speech Communication Laboratory, Graz University of Technology, Austria', 'Institute of Linguistics, University of Graz, Austria', 'ISFAS, Christian-Albrechts-Universit¨at zu Kiel, Germany']
baali23_interspeech	['Mohamed bin Zayed University of Artificial Intelligence, Abu Dhabi, UAE']
bhattacharjee23_interspeech	['Electrical Engineering Department, Indian Institute of Science, Bengaluru, India', 'National Institute of Mental Health and Neurosciences, Bengaluru, India']
sawata23_interspeech	['†Sony Group Corporation, Tokyo, Japan', '‡Sony Research, Tokyo, Japan']
chen23p_interspeech	['North Co., Ltd., Taiwan', 'Academia Sinica, Taiwan']
vali23_interspeech	['Department of Information and Communications Engineering, Aalto University, Finland']
kunesova23_interspeech	['New Technologies for the Information Society and Department of Cybernetics,', 'Faculty of Applied Sciences, University of West Bohemia, Pilsen, Czech Republic']
qi23_interspeech	['Alibaba Group, China', 'Chinese Academy of Sciences, China']
wang23ia_interspeech	['School of Informatics, Xiamen University, China', 'School of Electronic Science and Engineering, Xiamen University, China']
zhang23aa_interspeech	['The Department of Electronic Engineering and Information Science (EEIS)', 'University of Science and Technology of China, Hefei, China']
zheng23c_interspeech	['NERCMS, School of Computer Science, Wuhan University, China', 'Hubei Luojia Laboratory, China', 'Hubei Key Laboratory of Multimedia and Network Communication Engineering,', 'Wuhan University, China']
pellegrini23_interspeech	['Artificial and Natural Intelligence Toulouse Institute (ANITI), France', 'Institut de Recherche en Informatique de Toulouse (IRIT), France', 'Universite de Toulouse, CNRS, Toulouse INP, UT3, France', 'CerCo UMR 5549, CNRS, Universite de Toulouse, France']
wang23ja_interspeech	['Center for Speech and Language Technologies, BNRist, Tsinghua University, China', 'Huawei Cloud, China', 'Beijing University of Posts and Telecommunications, China']
mehrish23_interspeech	['Singapore University of Technology and Design, Singapore', 'ASUS Intelligent Cloud Services (AICS) Singapore,', 'Beijing University of Posts and Telecommunications, China']
sy23_interspeech	"['Language Acquisition Across Cultures Team, Laboratoire de Sciences Cognitives et de', ""Psycholinguistique, Departement d'Etudes Cognitives, ENS, EHESS, CNRS, PSL University, France"", 'Cognitive Machine Learning Team, INRIA, Paris, France', 'Meta AI Research, France']"
fan23b_interspeech	['Ping An Technology (Shenzhen) Co., Ltd., China', 'Lanzhou University, China']
yoon23b_interspeech	['Department of Electrical and Electronic Engineering, Yonsei University, Seoul, Korea']
paterson23_interspeech	['University of Leeds', 'Leeds Teaching Hospitals NHS Trust']
sato23_interspeech	['NTT Corporation, Japan']
yoon23c_interspeech	['Department of ECE and INMC, Seoul National University, Seoul, Republic of Korea']
ahn23b_interspeech	['Gwangju Institute of Science and Technology, Korea', 'Nankai University, China', 'Microsoft, China']
li23u_interspeech	['Ajmide Media, Shanghai, China']
koizumi23_interspeech	['Google, Japan', ' Tokyo University of Agriculture & Technology, Japan', ' Google, USA']
stanley23_interspeech	['and Dimitri Palaz', 'Speech Graphics Ltd, Edinburgh, United Kingdom']
liu23r_interspeech	['School of Computing, National University of Singapore, Singapore']
bandekar23_interspeech	['Electrical Engineering, Indian Institute of Science, Bangalore, India']
wang23ka_interspeech	['University of St.Gallen, Switzerland', 'Reykjavik University, Iceland']
singh23c_interspeech	['Dept of Electronics and Electrical Communication Engineering, Indian Institute of Technology', 'Kharagpur, India']
liu23s_interspeech	['East China University of Science and Technology, Shanghai, China', 'University of St.Gallen, St.Gallen, Switzerland']
nam23_interspeech	['Korea Advanced Institute of Science and Technology, South Korea', 'University of Oxford, United Kingdom', 'Naver Corporation, South Korea', 'Carnegie Mellon University, USA']
simantiraki23_interspeech	['Institute of Applied and Computational Mathematics, FORTH, Greece', 'Ikerbasque (Basque Science Foundation), Spain']
li23v_interspeech	['Gaoling School of Artificial Intelligence, Renmin Uniiversity of China, Beijing', 'Beijing Key Laboratory of Big Data Management and Analysis Methods, Beijing']
toth23_interspeech	['Institute of Informatics, University of Szeged, Hungary', 'ELRN-SZTE Research Group on Artificial Intelligence, Szeged, Hungary', 'Department of Telecommunications and Media Informatics,', 'Budapest University of Technology and Economics, Budapest, Hungary']
lee23i_interspeech	['Department of Artificial Intelligence, Korea University, Seoul, Korea']
fu23b_interspeech	['JD AI Research, Beijing, China']
li23w_interspeech	['School of Electronic and Information Engineering, South China University of Technology, Guangzhou, China']
mai23_interspeech	['†Idiap Research Institute, Martigny, Switzerland', '‡LIDIAP, Ecole Polytechnique Federale de Lausanne (EPFL), Switzerland', '¶University of Cambridge, United Kingdom', '§Faculty of Information Technology, Brno University of Technology, Czech Republic']
farooq23_interspeech	['Speech and Hearing Research Group, University of Sheffield, UK.']
xie23d_interspeech	['MoE Key Lab of Artificial Intelligence X-LANCE Lab,', 'Department of Computer Science and Engineering AI Institute,', 'Shanghai Jiao Tong University, Shanghai, China']
ma23e_interspeech	['ALTA Institute, Machine Intelligence Lab, Department of Engineering, Cambridge University, UK']
meng23c_interspeech	['University of New South Wales, Australia']
sakuma23_interspeech	['Waseda University, Japan', 'Chiba Institute of Technology, Japan']
hutin23_interspeech	['University of Louvain, F.R.S.-FNRS, Institute for Language and Communication, Belgium', 'Universite Paris-Saclay, CNRS, LISN, UMR 9015, France', 'Universite Paris-Cite, CNRS, MNHN, EA, UMR 7206, France']
gong23b_interspeech	['East China University of Science and Technology, ShangHai, China']
perezzarazaga23_interspeech	['Division of Speech, Music and Hearing, KTH Royal Institute of Technology, Sweden', 'Department of Information and Communications Engineering, Aalto University, Finland']
chen23q_interspeech	['Ping An Technology, China']
wei23c_interspeech	['School of Artificial Intelligence, Beijing University of Posts and Telecommunications, China', 'Center for Speech and Language Technologies, BNRist, Tsinghua University, China']
qi23b_interspeech	['Department Electrical Engineering-ESAT-PSI, KULeuven, Belgium']
zhang23ba_interspeech	['MoE Key Lab of Artificial Intelligence, AI Institute', 'X-LANCE Lab, Department of Computer Science and Engineering', 'Shanghai Jiao Tong University, Shanghai, China']
wei23d_interspeech	['Centre for Language and Speech Technology (CLST), Radboud University, The Netherlands', 'Centre for Language Studies (CLS), Radboud University, The Netherlands', 'Linguistics, Radboud University, The Netherlands', 'Donders Institute for Brain, Cognition and Behaviour, Radboud University, The Netherlands']
tian23b_interspeech	['Department of Electronic Engineering, The Chinese University of Hong Kong, Hong Kong SAR']
masumura23_interspeech	['NTT Computer and Data Science Laboratories, NTT Corporation, Japan']
kim23h_interspeech	['Department of Electrical and Electronic Engineering, Yonsei University, South Korea', 'NAVER Cloud, South Korea']
dasare23_interspeech	['Indian Institute of Information Technology, Dharwad, India']
benamor23_interspeech	"[""Laboratoire Informatique d'Avignon, EA 4128, Avignon Universite,France""]"
zhao23e_interspeech	['College of Computer Science and Electronic Engineering, Hunan University, China']
bodur23_interspeech	['Aix-Marseille Universite, LPL, CNRS, France', 'Avignon Universite, LIA, CNRS, France']
chien23b_interspeech	['Inst. of Electrical and Computer Engineering, National Yang Ming Chiao Tung University, Taiwan']
zusag23_interspeech	['myReha GmbH, Austria']
ihori23_interspeech	['NTT Computer and Data Science Laboratories, NTT Corporation, Japan']
hao23_interspeech	['Dongguan University of Technology, China', 'Jinan University, China', 'Beijing Language and Culture University, China']
li23x_interspeech	['The Chinese University of Hong Kong', 'Nanyang Technological University']
kathan23_interspeech	['Chair of Embedded Intelligence for Health Care and Wellbeing, University of Augsburg, Germany', 'Department of Psychiatry and Psychotherapy, University Hospital, LMU Munich, Germany', 'Zentrumspraxis Friedberg, Germany', 'Group on Language, Audio & Music, Imperial College London, UK']
sankar23_interspeech	['Univ. Grenoble Alpes, CNRS, Grenoble INP, GIPSA-lab', ' Grenoble, France']
zhong23_interspeech	['Tencent AI Lab, China', 'Zhejiang University, China']
ogun23_interspeech	['Universite de Lorraine, CNRS, Inria, LORIA, F-54000 Nancy, France']
li23y_interspeech	['Center for Speech and Language Technologies, BNRist, Tsinghua University, China', 'School of Artificial Intelligence, Beijing University of Posts and Telecommunications, China', '∗Corresponding authors:']
li23z_interspeech	['The Chinese University of Hong Kong, Hong Kong SAR, China', 'Centre for Perceptual and Interactive Intelligence, Hong Kong SAR, China']
obrien23_interspeech	"['Bonastre1', ""Laboratoire Informatique d'Avignon, EA 4128, Avignon Universite, France"", 'Semaxone, France']"
do23b_interspeech	['Graduate School of AI, POSTECH, Republic of Korea', 'Department of Computer Science and Engineering, POSTECH, Republic of Korea']
ueda23_interspeech	['The University of Tokyo, Japan.']
molenaar23_interspeech	['Centre for Language and Speech Technology, Radboud University Nijmegen, Netherlands']
ryumina23_interspeech	['St. Petersburg Federal Research Center of the Russian Academy of Sciences, St. Petersburg, Russia', 'Department of Information and Computing Sciences, Utrecht University, The Netherlands', 'ITMO University, St. Petersburg, Russia']
gu23b_interspeech	['State Key Laboratory of Information Security, Institute of Information Engineering, Chinese', 'Academy of Sciences, Beijing 100085, China', 'School of Cyber Security, University of Chinese Academy of Sciences, Beijing 100085, China']
zhang23ca_interspeech	['The State Key Laboratory of Information Security, Institute of Information Engineering, Chinese', 'Academy of Sciences, Beijing 100093, China', 'School of Cyber Security, University of Chinese Academy of Sciences, Beijing 100085, China']
li23aa_interspeech	['School of Information Science and Engineering, Xinjiang University, Urumqi, China', 'Bytedance', 'National University of Singapore, Singapore', 'School of Computer Science and Engineering, Nanyang Technological University, Singapore', 'Xinjiang Key Laboratory of Multi-lingual Information Technology, Urumqi, China']
burridge23_interspeech	['School of Mathematics and Physics, University of Portsmouth, United Kingdom']
styles23_interspeech	['Psychology, School of Social Sciences, Nanyang Technological University, Singapore', 'School of Electrical and Electronic Engineering, Nanyang Technological University, Singapore', 'CLSP and HLT-COE, Johns Hopkins University, USA', 'Department of Microelectronics, Delft University of Technology, Netherlands']
fara23_interspeech	"['Thymia, London, UK', ""Institute of Psychiatry, Psychology & Neuroscience (IoPPN), King's College London, London, UK""]"
wang23la_interspeech	['National Engineering Research Center of Speech and Language Information Processing,', 'University of Science and Technology of China, Hefei, Anhui, China', 'School of Electrical and Computer Engineering, Georgia Institute of Technology, American', 'China Mobile Online Services Company Limited, China']
wu23g_interspeech	['National Taiwan University, Taiwan', 'Meta AI, USA']
campbell23_interspeech	"['Vairavan7, Richard J.B. Dobson2,6, Laura Docio-Fern´andez1, Carmen Garcia-Mateo1, Vaibhav A.', 'Narayan8, Matthew Hotopf2,5, Nicholas Cummins2, The RADAR-CNS Consortium9', 'GTM research group, AtlanTTic Research Center, University of Vigo, Spain', ""Institute of Psychiatry, Psychology and Neuroscience, King's College London, UK"", 'School of Psychology, University of Sussex, Falmer, UK', ""RADAR-CNS Patient Advisory Board, King's College London, UK"", 'NIHR Biomedical Research Centre at South London and Maudsley NHS Foundation Trust and', ""King's College London, UK"", 'Institute of Health Informatics, University College London, UK', 'Janssen Research and Development LLC, Titusville, NJ, United States', ""Davos Alzheimer's Collaborative"", 'www.radar-cns.org']"
svihlik23_interspeech	['Jech5, Jan Rusz1', 'Czech Technical University in Prague, Czech Republic', 'University of Chemistry and Technology, Prague, Czech Republic', 'University Hospital of Bern, Switzerland', 'University College London Hospitals NHS Foundation Trust, United Kingdom', 'General University Hospital, Prague, Czech Republic']
kim23i_interspeech	['Department of Electrical and Electronic Engineering, Yonsei University, South Korea']
yip23_interspeech	['Speech Lab of DAMO Academy, Alibaba Group', 'SCSE, Nanyang Technological University (NTU), Singapore', 'Alibaba-NTU Singapore JRI, Interdisciplinary Graduate Programme, NTU, Singapore.']
kaneko23_interspeech	['NTT Communication Science Laboratories, NTT Corporation, Japan']
cong23_interspeech	['ByteDance']
jouaiti23_interspeech	['Imperial College London, UK', 'UK Dementia Research Institute Care Research and Technology Centre, UK']
wang23ma_interspeech	['JD AI Research, Beijing, China']
gomezzaragoza23_interspeech	['Instituto Universitario de Investigacion en Tecnologia Centrada en el Ser Humano, Universitat', 'Politecnica de Valencia, Spain', 'Radboud University, The Netherlands']
chandrasekar23_interspeech	['Indian Institute of Information Technology, Design and Manufacturing, Kancheepuram, India', 'National Institute of Technology Tiruchirappalli, India', 'Idiap Research Institute, Martigny, Switzerland', 'Ecole polytechnique federale de Lausanne (EPFL), Switzerland', 'Indian Institute of Science (IISc), Bengaluru, India']
wu23h_interspeech	['School of Computer Science and Engineering, Beihang University, Beijing, China', 'State Key Lab of Software Development Environment, Beihang University, Beijing, China', 'JD AI Research, Beijing, China']
zeng23c_interspeech	['School of Computer Science, Wuhan University, Wuhan, China', 'Data Science Research Center, Duke Kunshan University, Kunshan, China', 'Data&AI Engineering System, OPPO, Beijing, China']
martel23_interspeech	['Department of Computer Science and Technology, Tsinghua University, Beijing, China', 'Signal Processing (SP), Department of Informatics, Universit¨at Hamburg, Hamburg, Germany', 'Chinese Institute for Brain Research (CIBR), Beijing, China']
li23ba_interspeech	['Shenzhen International Graduate School, Tsinghua University, Shenzhen, China', 'XVerse Inc., Shenzhen, China', 'The Chinese University of Hong Kong, Hong Kong SAR, China']
deoliveira23_interspeech	['Signal Processing (SP), Universit¨at Hamburg, Germany']
gonzalezmachorro23_interspeech	['audEERING GmbH, Gilching, Germany', 'Digital Health – Connected Healthcare, Hasso Plattner Institute, University of Potsdam, Germany', 'Department of Neurology, Inselspital, Bern University Hospital and University of Bern,', 'Freiburgstrasse, Bern, Switzerland', 'Biogen Switzerland AG, Baar, Switzerland', 'Chair of Embedded Intelligence for Health Care and Wellbeing, University of Augsburg, Germany', 'GLAM – Group on Language, Audio, & Music, Imperial College, UK']
rajaa23_interspeech	['Skit.ai', 'Bengaluru, India']
luo23c_interspeech	['School of Electrical and Information Engineering, Beijing University of Civil Engineering and', 'Architecture, Beijing, China']
li23ca_interspeech	['Tianjin Key Laboratory of Cognitive Computing and Application,', 'College of Intelligence and Computing, Tianjin University, Tianjin, China']
jain23b_interspeech	['Speech Lab, Language Technologies Research Center (LTRC), IIIT Hyderabad', ', India', 'Spire Lab, Electrical Engineering, Indian Institute of Science (IISc), Bangalore', ', India']
wang23na_interspeech	['College of Intelligence and Computing, Tianjin University, Tianjin, China', 'Beijing Xiaoju Technology Co., Ltd., Beijing, China', 'Department of Electrical and Computer Engineering, National University of Singapore, Singapore']
gaido23_interspeech	['†Fondazione Bruno Kessler, Italy ‡University of Trento, Italy ⋆Independent Researcher']
reynerfuentes23_interspeech	['Department of Electronics, University Carlos III of Madrid (UC3M), Spain', 'Department of Signal Theory and Communications, University Carlos III of Madrid (UC3M), Spain', 'INESC-ID/Instituto Superior Tecnico, University of Lisbon, Portugal']
hope23_interspeech	['University of Delaware, USA', 'The Nemours Foundation, USA']
macintyre23_interspeech	['Cambridge Hearing Group, MRC Cognition and Brain Sciences Unit, University of Cambridge, UK']
fu23c_interspeech	['College of Intelligence and Computing, Tianjin University, Tianjin, China', 'Department of Electrical and Computer Engineering, National University of Singapore, Singapore', 'Beijing Xiaoju Technology Co., Ltd., Beijing, China']
rugayan23_interspeech	['Department of Electronic Systems, NTNU, Norway', 'KTH Royal Institute of Technology, EECS, Sweden']
liu23t_interspeech	"[""School of Computer Science, Northwestern Polytechnical University, Xi'an, China"", 'Shanghai Mobvoi Information Technology Co., Ltd']"
zhang23da_interspeech	['MIIT Key Lab for Language Information Processing and Applications', 'School of Foreign Studies, Nanjing University of Science and Technology, China']
favaro23_interspeech	['Department of Electrical and Computer Engineering, The Johns Hopkins University, Baltimore, MD,', 'USA', 'Department of Neurology, The Johns Hopkins University, Baltimore, MD, USA']
chen23r_interspeech	['Department of Electrical and Computer Engineering, University of Rochester, Rochester, NY, USA']
alumae23_interspeech	['Kheder2', 'Tallinn University of Technology, Estonia', 'Vocapia Research, France']
park23e_interspeech	['Department of Electronic Engineering, Hanyang University, Seoul, Republic of Korea']
he23_interspeech	['Idiap Research Institute, Martigny, Switzerland', 'Ecole Polytechnique Federale de Lausanne, Switzerland']
lamyeemui23_interspeech	['University of Paris-Saclay, CNRS, LISN, France,', 'Vocapia Research, France', 'The Centre for Speech Technology Research, University of Edinburgh, UK']
zhang23ea_interspeech	['College of Intelligence and Computing, Tianjin University, China', 'Huiyan Technology (Tianjin) Co., Ltd., Tianjin, China', 'The Academy of Tianjin University, Hefei, China']
berger23_interspeech	['Machine Learning and Human Language Technology,', 'Computer Science Department, RWTH Aachen University, Germany', 'AppTek GmbH, Germany', 'Paderborn University, Germany']
behera23_interspeech	['Reliance Jio - Artificial Intelligence Centre of Excellence (AICoE), Hyderabad, India']
gosselkeberthelsen23_interspeech	['Centre for Languages and Literature, Lund University, Sweden', 'Department for Nordic Studies and Linguistics, University of Copenhagen, Denmark']
rosello23_interspeech	['University of Granada, Spain']
lennes23_interspeech	['University of Helsinki, Finland']
ashihara23_interspeech	['NTT Corporation, Japan']
suwanbandit23_interspeech	['Chulalongkorn University, Thailand', 'CMKL university, Thailand']
gong23c_interspeech	['Jou2', 'KAIST, Republic of Korea', 'Google Research']
doukhan23_interspeech	"[""Institut National de l'Audiovisuel (INA), France"", 'Hˆopital Tenon, AP-HP, France', 'Independent;', 'Universite Paris Saclay, CNRS, LISN, France', 'Universidade Federal do Rio de Janeiro, Brazil']"
pirlogeanu23_interspeech	['Zevo Tech, Romania', 'Speech and Dialogue Research Laboratory', 'University Politehnica of Bucharest, Romania']
vanvuren23_interspeech	['Stellenbosch University, Stellenbosch, South Africa']
pandey23_interspeech	['Sigmedia Lab, ADAPT Centre, School of Engineering, Trinity College Dublin, Ireland', 'Department of Speech, Music and Hearing, KTH Royal Institute of Technology, Sweden']
tenbosch23_interspeech	['Center for Language Studies/CLST, Radboud University Nijmegen']
markl23_interspeech	['University of Edinburgh, Scotland']
kadkhodaeielyaderani23_interspeech	['Department of Computational Science and Engineering, McMaster University, Canada', 'Department of Computational Science and Engineering, McMaster University, Canada']
bhattacharya23_interspeech	['Columbia University, USA', 'University of Edinburgh, UK']
park23f_interspeech	['ActionPower, Seoul, Republic of Korea', 'Dept. of Applied Biology and Chemistry, Seoul National University, Seoul, Republic of Korea']
tulchinskii23_interspeech	['Skoltech, Russia', 'CNRS, Universite Paris Cite, France;', 'Artificial Intelligence Research Institute (AIRI), Russia;', 'St. Petersburg Department of the Steklov Institute of Mathematics, Russia']
hallap23_interspeech	['University of Toronto', 'CoML, ENS/CNRS/EHESS/INRIA/PSL Research University']
thienpondt23_interspeech	['IDLab, Department of Electronics and Information Systems, Ghent University - imec, Belgium', 'Department of Oral and Maxillofacial Surgery and Special Dental Care, University Medical Center', 'Utrecht, Utrecht University, The Netherlands']
baumann23_interspeech	['Technische Hochschule Nurnberg Georg Simon Ohm, Germany', 'Friedrich-Alexander-Universit¨at Erlangen-Nurnberg, Pattern Recognition Lab, Germany', 'Intel Labs, Germany']
kim23j_interspeech	['Apsingekar', 'Samsung Research America, USA']
pohnlein23_interspeech	['Institute for Phonetics and Speech Processing (IPS), LMU Munich, Germany']
blaylock23_interspeech	['University of Southern California, USA']
salomons23_interspeech	['HiTZ Basque Center for Language Technology, University of the Basque Country, Spain']
benway23b_interspeech	['Communication Sciences and Disorders, Syracuse University, New York, USA', 'Haskins Laboratories, New Haven, Connecticut, USA']
chowdhury23_interspeech	['Davis Institute for AI, Colby College, USA', 'Department of Psychology, Colby College, USA']
kouzelis23_interspeech	['Institute for Language and Speech Processing, Athena Research Center,', 'School of ECE, National Technical University of Athens, Athens, Greece']
tabassum23_interspeech	['Systems and Software Lab (SSL), Department of Computer Science and Engineering (CSE)', 'Islamic University of Technology (IUT), Gazipur, Bangladesh']
dowerah23_interspeech	['∗Universite de Lorraine, CNRS, Inria, Loria, F-54000, Nancy, France, †MBZUAI University, UAE']
rathod23_interspeech	['Speech Research Lab, Dhirubhai Ambani Institute of Information and Communication Technology', '(DA-IICT), Gandhinagar-382007, Gujarat, India', 'Sprinklr, India']
ma23f_interspeech	['ALTA Institute, Machine Intelligence Lab, Department of Engineering, Cambridge University, UK']
shim23b_interspeech	['University of Eastern Finland, Finland', 'University of Oulu, Finland', 'TCG CREST, India']
jalal23_interspeech	['Han2, Jung In Lee2, Seokyeong Jung2', 'Samsung Research, UK', 'AI R&D Group, Samsung Electronics, Suwon, South Korea']
audibert23_interspeech	['Laboratoire de Phonetique et Phonologie, UMR7018 CNRS/Sorbonne Nouvelle, Paris, France', 'LPL, CNRS, Aix-Marseille University, Aix-en-Provence, France', 'School of Psychology, University of Kent, Canterbury, United Kingdom']
rusci23_interspeech	['PSI, KU Leuven, Belgium']
nguyen23_interspeech	['Meta AI']
shim23c_interspeech	['University of Eastern Finland, Finland', 'Carnegie Mellon University, USA']
branco23_interspeech	['INESC ID / IST, Portugal', 'CIMA, IIFA, Department of Mathematics, ECT, University of Evora, Portugal', 'University of Twente, The Netherlands']
simek23_interspeech	['Faculty of Electrical Engineering, Czech Technical University in Prague, Czechia', 'Department of Neurology and Centre of Clinical Neuroscience, First Faculty of Medicine, Charles', 'University and General University Hospital, Czechia', 'Department of Neurology ARTORG Center, Inselspital, Bern University Hospital, University of', 'Bern, Switzerland']
charola23_interspeech	['Speech Research Lab, Dhirubhai Ambani Institute of Information and Communication Technology', '(DA-IICT), Gandhinagar-382007, Gujarat, India']
elmerich23_interspeech	['LPP (UMR7018, CNRS/Sorbonne Nouvelle), France', 'Hˆopital Foch: Service de Laryngologie Phoniatrie, Universite Paris Saclay, Suresnes, France']
yee23_interspeech	['Apple, USA']
jurov23_interspeech	['Department of Linguistics, University of Maryland, USA', 'UMIACS, University of Maryland, USA']
burdisso23_interspeech	['Idiap Research Institute, Switzerland', 'Faculty of Information Technology, Brno University of Technology, Czech Republic']
benway23c_interspeech	['1Communication Sciences and Disorders, Syracuse University, New York, USA', 'Electrical and Computer Engineering, University of Maryland College Park, Maryland, USA', 'Haskins Laboratories, New Haven, Connecticut, USA', 'Communication Sciences and Disorders, Montclair State University, New Jersey, USA', 'Communicative Sciences and Disorders, New York University, New York, USA']
kakouros23_interspeech	['University of Helsinki, Finland', 'UiT The Arctic University of Norway']
kejriwal23_interspeech	['Institute of Informatics, Slovak Academy of Sciences, Slovakia', 'Faculty of Informatics and Information Technology, Slovak Technical University, Slovakia', 'Constantine the Philosopher University, Nitra, Slovakia', 'Orange Innovation, Lannion, France']
gibson23_interspeech	['Universidad de Navarra', 'University of Houston', 'University of California Santa Barbara']
mahshie23_interspeech	['George Washington University, Washington, DC', 'St. Michaels College, Colchester, Vermont USA']
melistas23_interspeech	['Behavioral Signal Technologies Inc., Los Angeles, CA, USA', 'Institute for Language and Speech Processing, Athena Research Center, Athens, Greece', 'NCSR Demokritos, Athens, Greece', 'SAIL-University of Southern California, Los Angeles, CA, USA']
flynn23_interspeech	['Department of Computer Science, University of Sheffield', ' Portobello, Sheffield S1 4DP, UK']
ghaffarzadegan23_interspeech	['Bosch Center for Artificial Intelligence-USA', 'Highmark Health', 'Allegheny Health Network']
kejriwal23b_interspeech	['Institute of Informatics, Slovak Academy of Sciences, Slovakia', 'Faculty of Informatics and Information Technology, Slovak Technical University, Slovakia', 'Constantine the Philosopher University, Nitra, Slovakia']
cantisani23_interspeech	['Laboratoire des systemes perceptifs, DEC, ENS, PSL University, CNRS, France', 'ADAPT Centre, School of Computer Science and Statistics, Trinity College, The University of', 'Dublin; Trinity College Institute of Neuroscience, Ireland', 'University of Maryland College Park, USA', '∗senior authors']
wallbridge23_interspeech	['Centre for Speech Technology Research, University of Edinburgh']
rose23_interspeech	['Google Inc., New York']
wesoek23_interspeech	['Leibniz-Centre General Linguistics, Germany', 'Humboldt University Berlin, Germany', 'University of Wroclaw, Poland']
arora23_interspeech	['Carnegie Mellon University, U.S.A.', 'Sony Group Corporation, Japan']
almudevar23_interspeech	['ViVoLab, Aragon Institute for Engineering Research (I3A), University of Zaragoza, Spain']
beeson23_interspeech	['University of Edinburgh, Scotland', 'Centre for Speech Technology Research, University of Edinburgh, Scotland']
sarkar23_interspeech	['Idiap Research Institute, Martigny, Switzerland', 'Ecole polytechnique federale de Lausanne, Switzerland']
das23_interspeech	['SHL Labs, India']
minixhofer23_interspeech	['Centre for Speech Technology Research, University of Edinburgh, United Kingdom']
sikasote23_interspeech	['University of Zambia, Zambia', 'George Mason University, U.S.A']
koudounas23_interspeech	['♢Politecnico di Torino, Turin, Italy', '♣Kore University of Enna, Enna, Italy', '♡Bocconi University, Milan, Italy']
gurunathshivakumar23_interspeech	['Amazon Alexa AI, USA']
paturi23_interspeech	['AWS AI Labs']
hori23_interspeech	['Mitsubishi Electric Research Laboratories (MERL), Cambridge, MA', 'The University of Texas at Austin, Austin, TX', 'Brown University, Providence, RI']
english23_interspeech	['SFI Centre for Research Training in Digitally-Enhanced Reality (d-real), Ireland', 'ADAPT Research Centre, School of Computer Science, University College Dublin, Ireland', 'ADAPT Research Centre, Technological University Dublin, Ireland']
nieto23_interspeech	['Adobe Research, San Francisco, CA, USA']
niu23b_interspeech	['University of Michigan, USA']
mehta23_interspeech	['Division of Speech, Music and Hearing, KTH Royal Institute of Technology, Stockholm, Sweden']
braun23_interspeech	['Technische Hochschule Nurnberg', 'Friedrich-Alexander-Universit¨at Erlangen-Nurnberg, Germany', 'Klinik fur Psychiatrie und Psychotherapie, Universit¨atsklinik der Paracelsus Medizinischen', 'Privatuniversit¨at, Klinikum Nurnberg, Germany', 'KST Institut GmbH, Bad Emstal, Germany']
novotny23_interspeech	['Faculty of Electrical Engineering, Czech Technical University in Prague, Czechia', 'First Faculty of Medicine, Charles University and General University Hospital, Czechia', 'Bern University Hospital (Inselspital), University of Bern, Switzerland']
purohit23_interspeech	['Idiap Research Institute, Martigny, Switzerland', 'Ecole polytechnique federale de Lausanne (EPFL), Switzerland']
fatehi23_interspeech	['School of Computer Science, University of Nottingham']
kothare23_interspeech	['Ramanarayanan1,3', 'Modality.AI, Inc., San Francisco, CA, USA', 'MGH Institute of Healthcare Professions, Boston, MA USA', 'University of California, San Francisco, CA, USA']
wang23oa_interspeech	['Microsoft']
kerpicci23_interspeech	['Georgia Institute of Technology, Atlanta, Georgia', 'Qualcomm Technologies, Inc., San Diego, California']
melnikleroy23_interspeech	['Institute of Data Science and Digital Technologies, Vilnius University, Lithuania']
camp23_interspeech	['Google']
phokhinanan23_interspeech	['Sorbonne Universite, CNRS, ISIR, F-75005 Paris, France', 'Sorbonne Universite, CNRS, STMS lab, IRCAM, Paris, France']
vanbemmel23_interspeech	['Centre for Language and Speech Technology, Radboud University, the Netherlands', 'Department of Humanities, Universita degli studi di Torino, Italy', 'Centre for Language Studies, Radboud University, the Netherlands', 'Donders Institute for Brain, Cognition and Behaviour, the Netherlands']
sunder23_interspeech	['The Ohio State University, Columbus, OH, USA', 'IBM Research AI, Yorktown Heights, NY, USA']
adams23_interspeech	['Phonetics Laboratory, University of Cambridge']
bayerl23_interspeech	['Technische Hochschule Nurnberg Georg Simon Ohm, Germany', 'KST Institut GmbH', 'Intel Labs', 'Friedrich-Alexander-Universit¨at Erlangen-Nurnberg, Germany']
kataria23_interspeech	['Center for Language and Speech Processing', 'Human Language Technology Center of Excellence', 'Johns Hopkins University, Baltimore, MD, USA']
peng23d_interspeech	['Department of Computer Science, The University of Texas at Austin, USA', 'Language Technology Institute, Carnegie Mellon University, USA']
bijwadia23_interspeech	['Google, USA']
kodali23_interspeech	['Department of Information and Communications Engineering, Aalto University, Finland.']
zang23_interspeech	['University of Rochester, Rochester, New York, USA']
peng23e_interspeech	['Department of Computer Science, The University of Texas at Austin, USA', 'Meta AI, USA', 'Unit of Computing Sciences, Tampere University, Finland', 'Rembrand, USA']
yang23s_interspeech	['Department of Electrical & Computer Engineering, University of California, Santa Barbara, CA', 'Amazon Alexa AI']
miodonska23_interspeech	['Badura1', 'Faculty of Biomedical Engineering, Silesian University of Technology, Zabrze, Poland', 'Leiden University Centre for Linguistics, Leiden University, Leiden, Netherlands', 'Faculty of Humanities, Institute of Linguistics, University of Silesia, Katowice, Poland']
praveen23_interspeech	['Shaik', 'Samsung R&D Institute Bangalore, India']
sant23_interspeech	['TALP Research Center, Universitat Politecnica de Catalunya, Spain', 'Barcelona Supercomputing Center, Spain']
chang23b_interspeech	['Carnegie Mellon University, PA, USA', 'Yahoo Japan Corporation, Japan']
singh23d_interspeech	['University of Eastern Finland, Finland', 'Institute for Advancing Intelligence, TCG CREST, India']
xu23h_interspeech	['Columbia University', ' Snap Inc.']
wells23_interspeech	['The Centre for Speech Technology Research', 'Celtic and Scottish Studies', 'University of Edinburgh, United Kingdom']
hung23_interspeech	['Friedrich-Alexander Universit¨at Erlangen-Nurnberg, Germany', 'Pattern Recognition Lab, Friedrich-Alexander Universit¨at Erlangen-Nurnberg, Germany']
li23da_interspeech	['Centre for Speech Technology Research, University of Edinburgh, UK']
ekstedt23_interspeech	['KTH, Royal Institute of Technology, Stockholm, Sweden']
praveen23b_interspeech	['Samsung R&D Institute Bangalore, India']
chen23s_interspeech	['Center for Robust Speech Systems (CRSS), University of Texas at Dallas, USA1,', 'Meta AI, USA2']
erdogan23_interspeech	['Zeghidour1, John R. Hershey1', 'Google Research', 'Carnegie Mellon University']
wu23i_interspeech	['Ecole Polytechnique Federale de Lausanne (EPFL), Lausanne, Switzerland', 'Logitech Europe S.A., Lausanne, Switzerland', 'University of Copenhagen, Copenhagen, Denmark']
lameris23_interspeech	['Division of Speech, Music & Hearing, KTH Royal Institute of Technology, Stockholm, Sweden']
lin23j_interspeech	['Meta, USA']
huttner23_interspeech	['Aix Marseille University, CNRS, Laboratoire Parole et Langage, Aix-en-Provence, France', 'The University of Edinburgh, United Kingdom']
li23ea_interspeech	['Centre for Speech Technology Research, University of Edinburgh, UK']
bai23_interspeech	['Centre for Language and Speech Technology (CLST), Radboud University, The Netherlands', 'Centre for Language Studies (CLS), Radboud University, The Netherlands', 'Donders Institute for Brain, Cognition and Behaviour, Radboud University, The Netherlands']
szekely23_interspeech	['Division of Speech, Music and Hearing', 'Division of Robotics, Perception and Learning,', 'KTH Royal Institute of Technology, Stockholm, Sweden']
kachel23_interspeech	['Department of Social, Environmental, and Economic Psychology, University of Kaiserslautern-', 'Landau, Germany', 'Department of General Psychology and Cognitive Neuroscience, Friedrich Schiller University', 'Jena, Germany']
fahed23_interspeech	['Neuromuscular Systems Group, School of Electrical and Electronic Engineering, University', 'College Dublin, Ireland', 'Insight Centre for Data Analytics, University College Dublin, Ireland']
simmatis23_interspeech	['Dept. Speech-Language Path., Temerty Faculty of Medicine, Univ. Toronto, Toronto, ON, Canada', 'KITE-Toronto Rehabilitation Institute, Toronto, ON, Canada', 'Sunnybrook Research Institute, Sunnybrook Health Sciences Centre, Toronto, ON, Canada']
ahmadikalkhorani23_interspeech	['Department of Computer Science and Engineering, The Ohio State University, USA', 'Meta Reality Labs, USA']
neumann23_interspeech	['Modality.AI, Inc., San Francisco, USA']
wang23pa_interspeech	['Dept . of Electrical and Computer Engineering, University of California, Los Angeles, USA']
kitahara23_interspeech	['Sophia University', 'The University of Tokyo', 'Tokyo Medical and Dental University', 'Nagoya Gakuin University', 'Tokyo Kasei-gakuin College', 'Maebashi Institute of Technology', 'NINJAL']
tayebiarasteh23_interspeech	['Hee Yang2, Jan Rusz5, Juan Rafael Orozco-Arroyave1,4', 'Pattern Recognition Lab, Friedrich-Alexander-Universit¨at Erlangen-Nurnberg, Erlangen, Germany', 'Speech & Language Processing Lab, Friedrich-Alexander-Universit¨at Erlangen-Nurnberg,', 'Erlangen, Germany', 'Department of Diagnostic and Interventional Radiology, University Hospital RWTH Aachen,', 'Aachen, Germany', 'GITA Lab, Faculty of Engineering, University of Antioquia, Medellin, Colombia', 'Department of Circuit Theory, Czech Technical University in Prague, Prague, Czech Republic']
field23_interspeech	['Stanford University, USA']
tavernor23_interspeech	['University of Michigan, United States']
richter23_interspeech	['⋆Modality.AI, Inc., San Francisco, CA', '∗MGH Institute of Healthcare Professions, Boston, MA', '†University of California, San Francisco, CA']
repp23_interspeech	['University of Cologne', 'University of Aberdeen']
sarabia23_interspeech	['Apple']
blau23_interspeech	['Gekhman, Genady Beryozkin, Parisa Haghani, Bhuvana Ramabhadran', 'Google']
olatunji23_interspeech	['Tonja9,∗, Chris Chinenye Emezue6,8,10,∗, Amina Mardiyyah Rufai11,∗, Sahib Singh12,∗', 'Intron Health Inc 2 Georgia Institute of Technology 3 AI Saturdays Lagos 4 CISPA Helmholtz Center for Information Security 5', 'McGill University 6 Mila Quebec AI Institute 7 Lelapa AI 8 Lanfrica 9 Instituto Politecnico Nacional 10 Technical University of', 'Munich 11 Idiap Research Institute 12 Ford Motor Company ∗Masakhane NLP']
maison23_interspeech	"[""Laboratoire Informatique d'Avignon, Avignon, France"", 'Thales SIX, Multimedia Lab, Gennevilliers, France']"
gu23c_interspeech	['Amazon Alexa']
abdullah23_interspeech	['Language Science and Technology (LST), Saarland University, Germany', 'Saarland Informatics Campus, Germany']
gerlach23_interspeech	['University of Cambridge, United Kingdom', 'Oxford Wave Research, United Kingdom']
bleeker23_interspeech	['University of Amsterdam, The Netherlands', 'Apple']
tran23b_interspeech	['Institute for Creative Technologies, Los Angeles, USA']
huang23g_interspeech	['Alexa AI, Amazon.com Inc, Boston, MA, USA']
do23c_interspeech	['Campus Fryslˆan, University of Groningen, the Netherlands', 'Fryske Akademy/Mercator Research Centre, the Netherlands', 'ReadSpeaker, the Netherlands']
eisenstein23_interspeech	['Google Research', 'Stanford University', 'Queen Mary University of London']
schulz23_interspeech	['Tilburg University, The Netherlands', 'Lund University, Sweden']
do23d_interspeech	['Campus Fryslˆan, University of Groningen, the Netherlands', 'Fryske Akademy/Mercator Research Centre, the Netherlands', 'ReadSpeaker, the Netherlands']
baskar23_interspeech	['Google Inc.,']
murton23_interspeech	['R. Green1,3', 'Department of Communication Sciences and Disorders, MGH Institute of Health Professions,', 'Boston, MA', 'School of Medicine and Health Sciences, George Washington University, Washington, DC', 'Speech and Hearing Biosciences and Technology Program, Harvard University, Cambridge, MA']
tran23c_interspeech	['Institute for Creative Technologies, University of Southern California, USA']
krug23_interspeech	['Institute of Acoustics and Speech Communication, Technische Universit¨at Dresden, Germany', 'Faculty of Electrical Engineering and Information Technologies, UKIM Skopje, R. N. Macedonia', 'Department of Speech, Hearing and Phonetic Sciences, University College London, UK', 'Harbin Institute of Technology, Shenzhen, China']
chivriga23_interspeech	['Technical University of Munich, Germany']
bartolewska23_interspeech	['AGH University of Science and Technology, Institute of Electronics', '-059 Krakow, Poland']
elmers23_interspeech	['Saarland University, Germany', 'University of Edinburgh, United Kingdom', 'KTH Royal Institute of Technology, Sweden']
lu23f_interspeech	['National University of Singapore, Singapore', 'The University of Texas at Dallas, USA', 'Shenzhen Research Institute of Big Data, School of Data Science,', 'The Chinese University of Hong Kong, Shenzhen, China']
martinez23_interspeech	['LumenVox GmbH, Munich, Germany', 'ViVoLab, Aragon Institute for Engineering Research (I3A), University of Zaragoza, Zaragoza,', 'Spain']
krishnan23_interspeech	['Spoken Language Systems Group, Saarland University, Germany', 'German Research Center for Artificial Intelligence (DFKI)', 'Saarland Informatics Campus, Germany']
bekal23_interspeech	['AWS AI Labs, USA']
charuau23_interspeech	['Univ. Grenoble Alpes, CNRS, Grenoble INP, GIPSA-lab', 'University of Strasbourg, U.R.1339 Linguistique, Langues, Parole LiLPa', 'Pavol Jozef Safarik University, Language, Information and Communication Laboratory LICOLAB']
zhao23f_interspeech	['Centre for Speech Technology Research, University of Edinburgh, UK']
issa23_interspeech	['University of Gharyan, Libya.']
solanki23_interspeech	['Indian Institute of Science, Bangalore, India', 'R V College of Engineering, Bangalore, India']
tang23b_interspeech	['Language Technologies Institute, Carnegie Mellon University, USA', 'Department of Psychology, Carnegie Mellon University, USA']
bhatia23_interspeech	['AWS AI Labs', 'University of Virginia']
gong23d_interspeech	['MIT CSAIL, USA', 'MIT-IBM Watson AI Lab, USA', 'github.com/yuangongnd/whisper-at']
neumann23b_interspeech	['Modality.ai, Inc., San Francisco, CA']
papadimitriou23_interspeech	['Department of Electrical & Computer Engineering, University of Thessaly, Volos, Greece']
hoffmann23_interspeech	['Phonetics and Speech Laboratory, School of Linguistic, Speech and Communication Sciences', 'Trinity College Dublin, Ireland']
quamer23_interspeech	['Department of Computer Science and Engineering, Texas A&M University, United States']
wang23qa_interspeech	['Dehak1,2, Laureano Moro-Velazquez1', 'Center for Language and Speech Processing, Johns Hopkins University, USA', 'Human Language Technology Center of Excellence, Johns Hopkins University, USA', 'Department of Physical Medicine and Rehabilitation, Johns Hopkins University School of Medicine, USA']
wang23ra_interspeech	[',', '2 Phonetics and Speech Laboratory, School of Linguistic, Speech and Communication Sciences,', 'Trinity College Dublin, Ireland']
agrawal23_interspeech	['∗University of Maryland, U.S.A.', '†Amazon Alexa AI, U.S.A.']
cui23c_interspeech	['IBM Research AI']
panchapagesan23_interspeech	['Google LLC, U.S.A.']
attia23_interspeech	['University of Maryland College Park, MD', ' Haskins Laboratories, New Haven, CT']
wu23j_interspeech	['School of Electrical Engineering and Telecommunications, UNSW Sydney, Australia', 'Nokia Bell Labs, Cambridge, UK']
essery23_interspeech	['Department of Language and Linguistic Science, University of York, UK']
li23fa_interspeech	['Google LLC']
yang23t_interspeech	['Samsung Research America, Mountain View, CA, USA']
kulkarni23_interspeech	['∗MBZUAI, UAE, †Erisha Labs, India']
polak23_interspeech	['Charles University, Czechia', 'Carnegie Mellon University, USA']
radfar23_interspeech	['Filimonov, Grant Strimel, Nathan Susanj, Athanasios Mouchtaris', 'Alexa Machine Learning, Amazon, USA']
eren23_interspeech	['Department of Electrical and Computer Engineering, University of California, Los Angeles, USA']
kulshreshtha23_interspeech	['AWS AI Labs']
shetty23_interspeech	['Electrical and Computer Engineering, University of California, Los Angeles, California, USA', 'Speech Language and Hearing Sciences, Indiana University, Bloomington, Indiana, USA']
ma23g_interspeech	['University of California, Los Angeles', 'Amazon Alexa AI']
nguyen23b_interspeech	['Department of Computer Science, University of Oregon, OR, USA', 'Amazon Alexa AI, CA, USA']
li23ga_interspeech	['Beijing Language and Culture University, China', 'Beijing University of Posts and Telecommunications, China']
tran23d_interspeech	['Japan Advanced Institute of Science and Technology (JAIST), Japan', 'Institute of Information Technology (IOIT), Vietnam']
maity23_interspeech	['School of Biomedical Engineering, University of British Columbia, Canada', 'Gordon Center for Medical Imaging, Harvard Medical School, Boston, USA', 'Department of Electrical and Computer Engineering, John Hopkins University, USA', 'University of Maryland Dental School, Baltimore, USA']
meng23d_interspeech	['Sean Shensheng Xu5,16, Naijun Zheng1, Ranzo Huang4, Jiawen Kang1, Xiaoquan Ke5, Junan Li3,', 'Jinchao Li1, Yi Wang1', '−3,6−15The Chinese University of Hong Kong', 'The Hong Kong University of Science and', 'Technology', 'The Hong Kong Polytechnic University', 'Shenzhen University, China']
yang23u_interspeech	"['Dobriban1, Robert Schultz1,2, Insup Lee1, Julia Parish-Morris1,2', ""University of Pennsylvania, Philadelphia, PA 2Children's Hospital of Philadelphia, Philadelphia, PA"", 'Vanderbilt University, Nashville, TN']"
arvan23_interspeech	['University of Illinois Chicago, USA', 'Ghent University, Belgium']
yang23v_interspeech	['Center for Robust Speech Systems (CRSS), University of Texas at Dallas, Richardson, TX, USA', 'Northern Arizona University, Flagstaff, AZ, USA']
nishikawa23_interspeech	['Nara Institute of Science and Technology, Japan']
yang23w_interspeech	['College of Computer Science, Inner Mongolia University, National & Local Joint Engineering', 'Research Center of Intelligent Information Processing Technology for Mongolian, Inner Mongolia', 'Key Laboratory of Mongolian Information Processing Technology, Hohhot, China']
ito23b_interspeech	['LINE Corporation, Japan', 'Hosei University, Japan']
gao23h_interspeech	['CLSP & 2HLTCOE, Johns Hopkins University, USA', 'NVIDIA, USA', 'Xiaomi Corp., China']
chang23c_interspeech	['Department of Computer Science, University of Southern California, USA', 'Center for Artificial Intelligence in Society, University of Southern California, USA']
liu23u_interspeech	['Inner Mongolia University, China', 'Shenzhen Research Institute of Big Data, School of Data Science,', 'The Chinese University of Hong Kong, Shenzhen, China', 'National University of Singapore, Singapore']
ghosh23b_interspeech	['♠University of Maryland, College Park, USA,', '♣NVIDIA, Bangalore, India, ♥IIT Delhi, India']
tamayoflorez23_interspeech	['Department of Systems and Computing Engineering, Universidad de los Andes, Colombia', 'College of Engineering, Computing and Cybernetics, Australian National University, Australia']
sun23f_interspeech	['Ping An Technology (Shenzhen) Co., Ltd., China', 'Department of Electrical and Computer Engineering, Stony Brook University, USA']
anwar23_interspeech	['Meta AI']
moriya23_interspeech	['NTT Corporation, Japan']
yuan23b_interspeech	['Istituto Italiano di Tecnologia, Italy', 'Universita degli Studi di Ferrara, Italy', 'University of California San Diego, USA']
escobargrisales23_interspeech	['GITA Lab, Faculty of Engineering, University of Antioquia UdeA, Medellin, Colombia', 'Pattern Recognition Lab. Friedrich-Alexander Universit¨at, Erlangen-Nurnberg, Erlangen, Germany', 'Global Brain Health Institute, University of California, San Francisco, USA', 'Cognitive Neuroscience Center, Universidad de San Andres, Buenos Aires, Argentina', 'Facultad de Humanidades, Universidad de Santiago de Chile, Santiago, Chile']
jung23c_interspeech	['NAVER Corporation, Republic of Korea 2NAVER Cloud Corporation, Republic of Korea']
wang23sa_interspeech	['NetEase Yidun AI Lab, Hangzhou, China']
huo23b_interspeech	['Google LLC, USA']
jiang23g_interspeech	['Department of Electrical Engineering, Columbia University, USA']
kang23b_interspeech	['Massachusetts Institute of Technology', 'University of Illinois at Urbana-Champaign']
weld23_interspeech	['The University Of Sydney, Australia', 'The University Of Western Australia, Australia', '∗Corresponding Author']
chen23t_interspeech	['Tencent AI Lab, Audio and Speech Signal Processing Oteam']
yang23x_interspeech	['dot Inc., Seoul, Republic of Korea']
byun23_interspeech	['Intelligent Signal Processing Lab., Yonsei University, Wonju, Korea', 'Electronics and Telecommunications Research Institute (ETRI), Daejeon, Korea']
jia23b_interspeech	['NVIDIA Corporation, United States']
hsieh23_interspeech	['NVIDIA, USA']
li23ha_interspeech	['Amazon Alexa']
wu23k_interspeech	['University of California, Berkeley, United States', 'Carnegie Mellon University, United States', 'University of Southern California, United States']
kim23k_interspeech	['Data Science and AI Lab, ECE, Seoul National University, Seoul 08826, Korea', 'Interdisciplinary Program in AI, Seoul National University, Seoul 08826, Korea']
badlani23_interspeech	['Catanzaro', 'NVIDIA']
ostrand23_interspeech	['IBM Research, Yorktown Heights, NY, USA', 'University of California - San Diego, San Diego, CA, USA']
liu23v_interspeech	['Inner Mongolia University, China', 'Shenzhen Research Institute of Big Data, School of Data Science,', 'The Chinese University of Hong Kong, Shenzhen, China', 'National University of Singapore, Singapore']
yoon23d_interspeech	['Korea Advanced Institute of Science and Technology (KAIST), Republic of Korea', 'University of Illinois at Urbana-Champaign, USA', 'Samsung Electronics, Republic of Korea']
ratko23_interspeech	['Department of Linguistics, Macquarie University, Sydney, Australia']
buddi23_interspeech	['Yanosik1, Saravana Rathinam2∗, Saurabh Adya1', 'Apple, USA', 'elbo.ai, USA']
cai23b_interspeech	['Comp & Info Tech Dept, Purdue University, West Lafayette, IN 47906, USA', 'Comp & Info Tech Dept, IUPUI, Indianapolis, IN 46202, USA']
aldarmaki23_interspeech	['MBZUAI']
xiao23d_interspeech	['Center for Language and Speech Processing', 'Human Language Technology Center of Excellence', 'Johns Hopkins University, Baltimore, MD, USA']
unni23_interspeech	['Indian Institute of Technology Bombay, India', 'IBM Research, India']
naowarat23b_interspeech	['Chulalongkorn University, Bangkok, Thailand']
martin23_interspeech	['Massachusetts Institute of Technology, USA']
yang23y_interspeech	['Centre for Speech Technology Research, University of Edinburgh', 'Alexa Perceptual Technologies, Amazon', 'Zoom Video Communications, Inc.']
baghel23_interspeech	['Chowdhuri2, Kaustubh Kulkarni1, Swapnil Padhi1, Deepu Vijayasenan2, Sriram Ganapathy1', 'LEAP Lab, Department of Electrical Engineering, Indian Institute of Science, Bengaluru, India', 'Department of Electronics and Communication, National Institute of Technology Karnataka,', 'Surathkal, India']
cho23_interspeech	['Department of Electronic Engineering, Hanyang University, Seoul, Republic of Korea']
kyung23_interspeech	['Department of Electronic Engineering, Hanyang University, Seoul, Republic of Korea']
soman23_interspeech	['LEAP Lab, Indian Institute of Science Bangalore, India']
jang23b_interspeech	['Kakao Enterprise Corporation, Republic of Korea']
kanagawa23_interspeech	['NTT Corporation, Japan']
kim23l_interspeech	['∗Hanynag University, Seoul, Republic of Korea', '†Amazon Web Services']
broughton23_interspeech	['Fano Labs, Hong Kong SAR, China']
choi23f_interspeech	['Department of Artificial Intelligence, Sogang University, Republic of Korea']
jayakumar23_interspeech	['Speech Lab, Indian Institute of Technology Madras, India']
shaheen23_interspeech	"[""Huawei Noah's Ark Lab""]"
kang23c_interspeech	['Ping An Technology (Shenzhen) Co., Ltd., Shenzhen, China']
zhang23fa_interspeech	['Group of Intelligent Signal Processing, Harbin Engineering University, China', 'Centre for Audio, Acoustics and Vibration, University of Technology Sydney, Australia', 'School of Computer Science and Technology, Harbin Institute of Technology, China']
zhou23g_interspeech	"['College of Intelligence and Computing, Tianjin University, Tianjin, China', ""Huawei Noah's Ark Lab, China"", 'Huawei International Pte Ltd, Singapore', 'School of Computer Science and Technology, Kashi University, Kashi, China']"
pandey23b_interspeech	['Reality Labs Research at Meta']
zuluagagomez23_interspeech	['†Idiap Research Institute, Switzerland ‡Ecole Polytechnique Federale de Lausanne, Switzerland', 'Sketch Recognition Lab, Texas A&M University, USA', '§Vilnius Gediminas Technical University, Lithuania', '♮Universite Laval, Canada ♯Concordia University, Canada ♭Mila-Quebec AI Institute, Canada']
kim23m_interspeech	['IPAI', 'AIIS, Seoul National University, Seoul, Republic of Korea']
liu23w_interspeech	['Speech Processing and Machine Intelligence (SPMI) Lab, Tsinghua University, Beijing, China', 'China Unicom (Guangdong) Industrial Internet Co., Ltd.']
lee23j_interspeech	['Korea Advanced Institute of Science and Technology (KAIST), Republic of Korea']
li23ia_interspeech	['CCA Lab, College of Intelligence and Computing, Tianjin University, Tianjin, China', 'Information Science, Japan Advanced Institute of Science and Technology']
nigmatulina23_interspeech	['Idiap Research Institute, Switzerland 2University of Zurich, Switzerland', 'Faculty of Information Technology, Brno University of Technology, Czech Republic', 'LIDIAP, Ecole Polytechnique Federale de Lausanne (EPFL), Switzerland', 'Uniphore, India']
baek23_interspeech	['Department of Electronic Engineering, Hanyang University, Seoul, Republic of Korea']
mori23_interspeech	['Utsunomiya University, Japan']
miwa23_interspeech	['Graduate School of Integrated Science and Technology, Shizuoka University, Japan']
bansal23_interspeech	['Uniphore Software Systems, Bengaluru, India', 'Robert Bosch Centre for Cyber-Physical Systems, Indian Institute of Science, Bengaluru, India']
gudepu23_interspeech	['Samsung R&D Institute Bangalore, India']
fallgren23_interspeech	['Speech, Music & Hearing, KTH Royal Institute of Technology, Sweden']
zhang23ga_interspeech	['Shanghai Jiao Tong University, China']
yeen23_interspeech	['Sogang University, Korea']
mun23b_interspeech	['Seoul National University, Republic of Korea', 'Seoul National University Bundang Hospital, Republic of Korea', 'Seoul National University College of Medicine, Republic of Korea']
chen23u_interspeech	['ByteDance', 'Department of Electronic Engineering, Tsinghua University']
hermann23_interspeech	['Idiap Research Institute, Martigny, Switzerland']
duquenne23_interspeech	['Meta AI', 'Inria']
chung23_interspeech	['Dept. of Electrical & Electronic Engineering, Yonsei University, South Korea', 'NAVER Cloud, South Korea']
xin23d_interspeech	['Peking University, Beijing, China', 'Microsoft Research Asia, Beijing, China']
gao23i_interspeech	['College of Information Science and Engineering, Xinjiang University, Urumqi, China', 'Department of Electronic Engineering, Tsinghua University, Beijing, China', 'Key Laboratory of Signal Detection and Processing, Xinjiang, Urumqi, China']
tao23b_interspeech	['Department of Electronic Engineering', 'Department of Educational Psychology', 'The Chinese University of Hong Kong']
kreyssig23_interspeech	['Abdelrahman Mohamed2, Philip C. Woodland1', 'Department of Engineering, University of Cambridge, UK', 'Meta AI, USA']
kesiraju23_interspeech	['Univ. Grenoble Alpes, France. 4University of Pittsburgh, USA.']
ta23_interspeech	['Viettel Cyberspace Center, Viettel Group, Hanoi, Vietnam']
yao23b_interspeech	['Xiaomi Corp., Beijing, China']
lee23k_interspeech	['Graduate School of Artificial Intelligence, POSTECH, Republic of Korea', 'Department of Computer Science and Engineering, POSTECH, Republic of Korea']
okamoto23b_interspeech	['National Institute of Information and Communications Technology, Japan', 'Information Technology Center, Nagoya University, Japan']
mcneill23_interspeech	['CUNY Graduate Center, New York, NY, USA', 'Brooklyn College, Brooklyn, NY, USA']
lonergan23_interspeech	['Phonetics and Speech Laboratory, School of Linguistics, Speech and Communication Sciences,', 'Trinity College Dublin, Ireland', 'Engineering Department, Cambridge University, UK']
kadiri23_interspeech	['Department of Information and Communications Engineering, Aalto University, Finland.']
shahin23_interspeech	['School of Electrical Engineering and Telecommunications, UNSW, Australia']
huang23i_interspeech	['The University of Sydney']
mosner23_interspeech	['Ladislav Mosner, Oldrich Plchot, Junyi Peng, Luk´as Burget, Jan “Honza” ˇCernocky']
gao23j_interspeech	['†The University of Tokyo, Japan,', '‡Kobe Gakuin University, Japan']
yuan23c_interspeech	['College of Computer Science and Technology, Jilin University, Changchun, China', 'Tencent AI Lab, Shenzhen, China', 'School of Computer Science, Zhuhai College of Science and Technology, Zhuhai, China', 'Tencent AI Lab, Bellevue, WA, USA']
li23ja_interspeech	['Tianjin Key Laboratory of Cognitive Computing and Application,', 'College of Intelligence and Computing, Tianjin University, Tianjin, China', 'Department of Electrical and Computer Engineering, National University of Singapore, Singapore', 'Institute of Data Science, National University of Singapore, Singapore', 'Shenzhen Research Institute of Big Data, Shenzhen, China']
yu23d_interspeech	['ShanghaiTech University, China', 'The University of Manchester, United Kingdom', 'University College London, United Kingdom']
chetiaphukan23_interspeech	['IIIT-Delhi, India', 'University of Tartu, Estonia']
uezu23_interspeech	['Japan Advaced Institute of Science and Technology, Japan', 'Kanazawa University, Japan']
dey23_interspeech	['Department of Electronics & Electrical Communication Engineering,', 'Indian Institute of Technology Kharagpur, West Bengal, India']
sivaguru23_interspeech	['Speech Lab, Indian Institute of Technology Madras, India']
kim23n_interspeech	['Meta, USA', 'TikTok, USA']
richter23b_interspeech	['Huld Magnusdottir6, Jon Guðnason7', ',2,7Reykjavik University, Iceland', ',6Tiro, Iceland', 'University of Iceland, Iceland', 'Árni Magnusson Institute, Iceland']
taguchi23_interspeech	['University of Notre Dame, United States', 'Nara Institute of Science and Technology, Japan', 'Google, United States']
javed23_interspeech	['Raman2, Kaushal Bhogale1,2, Pratyush Kumar1,2,3, Mitesh M. Khapra1,2', 'Indian Institute of Technology Madras, India', 'AI4Bharat, India', 'Microsoft, India']
bhogale23_interspeech	['Indian Institute of Technology Madras, India', 'AI4Bharat, India', 'Microsoft, India']
schroter23b_interspeech	['Friedrich-Alexander-Universit¨at Erlangen-Nurnberg, Pattern Recognition Lab', 'WS Audiology, Research and Development, Erlangen, Germany']
burkhardt23_interspeech	['audEERING GmbH, Germany,', 'Chair EIHW, University of Augsburg, Germany,', 'GLAM, Imperial College London, UK']
gibson23b_interspeech	['Voiceitt']
yin23b_interspeech	['Signals and Interactive Systems Lab, University of Trento, Italy']
baali23b_interspeech	['Mohamed bin Zayed University of Artificial Intelligence, Abu Dhabi, UAE', 'Qatar Computing Research Institute, HBKU, Doha, Qatar']
minematsu23_interspeech	['†Graduate School of Engineering, The University of Tokyo, Japan', '‡Faculty of Global Communication, Kobe Gakuin University, Japan']
lee23l_interspeech	['KAIST, Daejeon, Republic of Korea']
lemaguer23_interspeech	['Sigmedia Lab, School of Engineering, Trinity College Dublin, Ireland']
cho23b_interspeech	['Speech AI Lab., NCSOFT Corporation, South Korea']
corkey23_interspeech	['The Centre for Speech Technology Research, University of Edinburgh, UK']
bujnowski23_interspeech	['Samsung Research Poland, Warsaw', 'Warsaw University of Technology, Warsaw']
nicholls23_interspeech	['English Language iTutoring Ltd., Cambridge, UK', 'Enhanced Speech Technology Ltd., Cambridge, UK', 'ALTA Institute / Cambridge University Engineering Department, Cambridge, UK']
szekely23b_interspeech	['Division of Speech, Music and Hearing, KTH Royal Institute of Technology, Stockholm, Sweden']
valentine23_interspeech	['New York University, New York, NY, USA', 'Speech Technology and Applied Research Corporation, Lexington, MA, USA', 'Northwestern University, Chicago, IL, USA']
chongwhite23_interspeech	['National Acoustic Laboratories, Sydney Australia', 'Macquarie University, Sydney, Australia']
liu23x_interspeech	['IT Platform Chief Expert Office, Huawei Technologies Co., Ltd., China']
arai23_interspeech	['Sophia Univ. (Japan)', 'Osaka Univ. (Japan)', 'Toyohashi Univ. of Technology (Japan)']
ekstedt23b_interspeech	['KTH, Royal Institute of Technology, Sweden']
nicolao23_interspeech	['SoapBox Labs, Dublin']
ramanarayanan23_interspeech	['Richter, David Fox, David Suendermann-Oeft and Ira Shoulson', 'Modality.AI, Inc.']
nathan23_interspeech	['Observe.AI, India']
tripathi23_interspeech	['Observe.AI, India']
mandke23_interspeech	['Qualcomm AI Research∗', 'Microsoft Corporation', 'Figure 1: System overview']
motepalli23_interspeech	['Sangeetha Mahesh,Ajish K. Abraham, Anil Kumar Vuppala']
zusag23b_interspeech	['myReha GmbH, Austria']
nissen23_interspeech	['Department of Communication Disorders, Brigham Young University, Provo, Utah, USA']
solinsky23_interspeech	['College of Pharmacy', 'School of Nursing, University of Minnesota']
rastorgueva23_interspeech	['NVIDIA Corporation, United States']
walsh23_interspeech	['Microsoft', 'MIT', 'Project Gutenberg', 'Google, *Equal Contribution']
tanna23_interspeech	['University of California, Santa Barbara']
gupta23b_interspeech	['Heriot-Watt Watt University, Edinburgh, United Kingdom', 'University of Edinburgh, Edinburgh, United Kingdom', 'Edinburgh Napier University, Edinburgh, United Kingdom', 'University of Wolverhampton, Wolverhampton, United Kingdom.']
dugan23_interspeech	['University of Pennsylvania', 'Roblox']
elkheir23_interspeech	['Qatar Computing Research Institute, HBKU, Doha, Qatar']
svec23_interspeech	['Department of Cybernetics, University of West Bohemia, Pilsen, Czech Republic']
bhat23_interspeech	['Department of Computer Science, IIT Bombay, India']
pattnaik23_interspeech	['Observe.AI, India']
sachdeva23_interspeech	['Kumar, Jithendra Vepa', 'Observe.AI, India']
agrawal23b_interspeech	['Observe.AI, India']
gogate23_interspeech	['Edinburgh Napier University, Edinburgh, UK']
elshahawy23_interspeech	['Qatar Computing Research Institute, HBKU, Doha, Qatar']
hromada23_interspeech	['2Berlin University of the Arts / Einstein Center Digital Future, Germany']
dignum23_interspeech	['Umeå University, Sweden']
grice23_interspeech	['University of Cologne, Germany']
