paper_id	affiliations
ai24_interspeech	['school of communication and information engineering, shanghai university, shanghai, china']
lu24_interspeech	['national engineering research center of speech and language information processing,', 'university of science and technology of china, hefei, p r. china']
simantiraki24_interspeech	['institute of applied and computational mathematics, forth, greece', 'ikerbasque, bilbao, spain', 'university of the basque country, vitoria-gasteiz, spain']
williams24_interspeech	['university of southampton, uk', 'university of nottingham, uk;', 'university of missouri-columbia, usa', 'university of texas at austin, usa']
yang24_interspeech	['division of emerging interdisciplinary areas,', 'hong kong university of science and technology,', 'hong kong, china']
chen24_interspeech	"['college of blockchian industry, chengdu university of information technology, chengdu, china', 'dept. of electrical and electronic engineering, the university of hong kong, hong kong, china', ""school of marine science and technology, northwestern polytechnical university, xi'an, china"", 'institute of artificial intelligence (teleai), china telecom corp ltd, shanghai, china']"
doan24_interspeech	['school of electronic engineering, soongsil university, seoul, republic of korea']
li24_interspeech	['cambridge research laboratory, toshiba europe ltd, cambridge, uk']
niizumi24_interspeech	['ntt corporation', ' doshisha university, japan']
muller24_interspeech	['fraunhofer aisec 2wroclaw university of science and technology 3technical university of', 'munich 4bundesamt fur sicherheit in der informationstechnik 5university of southampton']
kuhn24_interspeech	['stuttgart media university, germany', 'university of tubingen, germany']
shi24_interspeech	['jin5,⋆, shinji watanabe1', 'carnegie mellon university', ' duke kunshan university', ' cornell university', ' multimodal art', 'projection community', ' renmin university of china', ' georgia institute of technology']
cappellazzo24_interspeech	['university of trento, trento, italy', 'fondazione bruno kessler, trento, italy']
parcollet24_interspeech	['samsung ai center cambridge, united kingdom']
deshmukh24_interspeech	['carnegie mellon university', 'microsoft']
pesan24_interspeech	['faculty of information technology, brno university of technology, brno, czech republic', 'faculty of civil engineering, brno university of technology, brno, czech republic']
bentum24_interspeech	['center for language studies, radboud university nijmegen, the netherlands', 'tilburg university, the netherlands']
huo24_interspeech	['google llc, usa']
niu24_interspeech	['australian national university']
rybakov24_interspeech	['google llc, usa']
hwang24_interspeech	['netmarble ai center, seoul, korea']
gao24_interspeech	['china mobile research, china']
cao24_interspeech	['tianjin key laboratory of cognitive computing and application, college of intelligence and', 'computing, tianjin university, tianjin, china', 'national university of singapore, singapore', 'tencent ai lab, china', 'tianjin branch of national computer network emergency response technical team/coordination', 'center of china, tianjin, china']
kim24_interspeech	['data science and ai lab, ece, seoul national university (snu), korea', 'nvidia', 'aiis, asri, inmc, isrc, and interdisciplinary program in ai, snu, korea']
liu24_interspeech	['ai lab, xiaomi corporation, china']
sun24_interspeech	['the university of edinburgh, edinburgh, uk']
ohagi24_interspeech	['sb intuitions corp']
chen24b_interspeech	['chen chunyi4, james cheung4, yan liu5, zhuoming chen6', 'department of chinese and bilingual studies, hong kong polytechnic university', 'department of english and communication, hong kong polytechnic university', 'department of linguistics and translation, city university of hong kong', 'department of biomedical engineering, hong kong polytechnic university', 'department of computing, hong kong polytechnic university', 'brain hospital, the first hospital of jinan university', 'research institute for smart ageing, the hong kong polytechnic university']
wang24b_interspeech	['school of computer science and engineering, university of new south wales, australia']
pieper24_interspeech	['institute for telecommunication sciences, national telecommunications and information', 'administration, united states']
yoon24_interspeech	['department of ai, chung-ang university, seoul, south korea', 'department of ece and inmc, seoul national university, seoul, south korea']
oiso24_interspeech	['university of tsukuba, japan', 'nec corporation, japan']
lay24_interspeech	['signal processing (sp), university of hamburg, germany']
christ24_interspeech	['boutalikakis3, lorenz graf-vlachy4, andreas k¨onig3, bj¨orn w schuller1,2,5', 'university of augsburg, germany 2chi, tu munich, germany 3university of passau, germany', 'tu dortmund, germany 5glam, imperial college london, uk']
jin24_interspeech	['∗, yifan yang1', '∗, mohan shi2', '∗, wei kang1, xiaoyu yang1, zengwei yao1, fangjun kuang1,', 'liyong guo1, lingwei meng3, long lin1, yong xu2, shi-xiong zhang2, daniel povey1', 'xiaomi corp., beijing, china', 'tencent ai lab, bellevue, usa;', 'the chinese university of hong kong, hong kong sar, china']
triantafyllopoulos24_interspeech	['chi – chair of health informatics, mri, technical university of munich, germany', 'department of cardiology, university hospital augsburg, university of augsburg, germany', 'division of phoniatrics, medical university of graz, austria', 'chair of embedded intelligence for health care and wellbeing, university of augsburg, germany', 'glam – group on language, audio, & music, imperial college, uk']
triantafyllopoulos24b_interspeech	['chi – chair of health informatics, mri, technical university of munich, germany', 'eihw – embedded intelligence for health care & wellbeing, university of augsburg, germany', 'glam – group on language, audio, & music, imperial college london, uk']
triantafyllopoulos24c_interspeech	['chi – chair of health informatics, mri, technical university of munich, germany', 'mcml – munich center for machine learning 3mdsi – munich data science institute', 'glam – group on language, audio, & music, imperial college london, uk']
wang24c_interspeech	['meta ai']
wiepert24_interspeech	['department of neurology, mayo clinic (rochester), usa']
li24b_interspeech	['huawei translation services center, beijing, china', 'school of informatics, xiamen university, china']
li24c_interspeech	['huawei translation services center, china']
xiao24_interspeech	['national engineering research center for multimedia software,', 'school of computer science, wuhan university', 'sleep medicine centre, zhongnan hospital of wuhan university']
gao24b_interspeech	['wxg tencent, china']
ai24b_interspeech	['national engineering research center of speech and language information processing,', 'university of science and technology of china, hefei, p r. china']
irino24_interspeech	['faculty / graduate school of systems engineering, wakayama university, japan']
wang24d_interspeech	['beijing key laboratory of mobile computing and pervasive device, institute of computing', 'technology, chinese academy of sciences, beijing, china', 'university of chinese academy of sciences, beijing, china', 'beijing jiaotong university, beijing, china']
vali24_interspeech	['aalto university, department of information and communications engineering, finland']
wu24_interspeech	['school of electrical engineering and telecommunications, unsw sydney, australia', 'university of melbourne, australia']
bn24_interspeech	['college of information sciences & technology, penn state, usa', 'central queensland university, australia']
chen24c_interspeech	['department of computer science, columbia university, united states']
mawalim24_interspeech	['japan advanced institute of science and technology, japan']
mun24_interspeech	['department of linguistics, seoul national university, republic of korea', 'department of french language education, seoul national university, republic of korea']
nijat24_interspeech	['school of computer science and technology, xinjiang university , china', 'center for speech and language technologies, bnrist, tsinghua university, china']
vandereeckt24_interspeech	['ku leuven', 'department electrical engineering esat-psi, leuven, belgium']
scheibler24_interspeech	['ly corporation, japan']
lee24_interspeech	['department of applied artificial intelligence, sungkyunkwan university, seoul 03063, korea', 'department of immersive media engineering, sungkyunkwan university, seoul 03063, korea']
tao24_interspeech	['speech and audio signal processing laboratory, beijing university of technology, beijing, china', 'shanghai branch of the southwest institute of electronics and telecommunication technology of', 'china, shanghai, china']
jing24_interspeech	['chair of embedded intelligence for health care & wellbeing, university of augsburg, germany', 'school of technology, beijing forestry university, china 3chi – chair of health informatics,', 'mri, technical university of munich, germany 4group on language, audio, & music, imperial', 'college london, uk 5 hume ai, new york, usa']
mu24_interspeech	['school of artificial intelligence', 'beijing university of posts and telecommunications, china']
yang24b_interspeech	['labs huawei co., ltd beijing, china', 'monash university, melbourne,australia']
richter24_interspeech	['signal processing (sp), universitat hamburg, germany', 'codec avatars lab, meta, pittsburgh, pa, usa', 'language technology institute, carnegie mellon university, pittsburgh, pa, usa']
despotovic24_interspeech	['bioinformatics & ai, department of medical informatics, luxembourg institute of health', 'deep digital phenotyping, department of precision health, luxembourg institute of health', 'multi-omics data science, department of cancer research, luxembourg institute of health']
wang24e_interspeech	['tracey2, yishu gong2, alan premasiri3, fernando vieira3, james glass1', 'mit csail, usa', 'takeda development center americas, inc., usa', 'als therapy development institute, usa']
wang24f_interspeech	['clsp and hlt-coe, johns hopkins university, usa', 'college of computing and data science, nanyang technological university, singapore']
loweimi24_interspeech	['speech group, machine intelligence laboratory, university of cambridge, uk', 'alta institute, department of engineering, university of cambridge, uk']
li24d_interspeech	['tokyo institute technology']
lee24b_interspeech	['kakao corporation, sungnam, south korea']
zhang24_interspeech	['ohio state university, columbus, oh, usa', 'tencent ai lab, bellevue, wa, usa']
yang24c_interspeech	['cyberagent, inc., japan', 'the university of tokyo, japan']
suda24_interspeech	['national institute of advanced industrial science and technology (aist), japan', 'the university of tokyo, japan', 'keio university, japan']
singh24_interspeech	['sony ai, japan', 'sony ai, zurich']
kim24b_interspeech	['school of electrical engineering, kaist, south korea']
kaland24_interspeech	['institute of linguistics - phonetics, university of cologne, germany', 'linguistics and english language, the university of edinburgh, united kingdom', 'department of linguistics, northwestern university, united states']
kaland24b_interspeech	['institute of linguistics-phonetics, university of cologne, germany', 'department of german language and literature i, university of cologne, germany']
ilias24_interspeech	['dss laboratory, school of ece, national technical university of athens, greece']
paissan24_interspeech	['fondazione bruno kessler, italy']
wang24g_interspeech	['speech and hearing research center, school of intelligence science and technology, peking', 'university, beijing, china 2national key laboratory of general artificial intelligence', 'institute for artificial intelligence, peking university']
kwok24_interspeech	['digital trust centre, nanyang technological university, singapore', 'college of computing and data science, nanyang technological university, singapore']
gengembre24_interspeech	['orange, france', 'laboratoire de phonetique et de phonologie, france']
murata24_interspeech	['cyberagent, inc., japan']
wang24h_interspeech	['google llc, usa']
bujnowski24_interspeech	['samsung research, poland', 'warsaw university of technology, poland']
nam24_interspeech	['korea advanced institute of science and technology, south korea,', 'samsung research, south korea', 'supertone inc, south korea']
lee24c_interspeech	['kadiri, shrikanth narayanan', 'university of southern california, usa']
chen24d_interspeech	['university of washington', 'microsoft', 'assemblyai']
jung24_interspeech	['samsung research, seoul, south korea']
lee24d_interspeech	['department of intelligence and information, seoul national university', 'interdisciplinary program in artificial intelligence, seoul national university', 'artificial intelligence institute, seoul national university']
park24_interspeech	['squeezebits inc., republic of korea']
lee24e_interspeech	['seoul national university, republic of korea']
munakata24_interspeech	['ly corporation, japan']
dinkel24_interspeech	['ai lab, xiaomi corporation, china']
meng24_interspeech	"['mashang consumer finance co.,ltd., china', ""university, xi'an, china""]"
fujita24_interspeech	['ly corporation, tokyo, japan']
dinkel24b_interspeech	['ai lab, xiaomi corporation, china']
muller24b_interspeech	['fraunhofer aisec 2eurecom 3pindrop, usa']
chen24e_interspeech	['nerc-slip, university of science and technology of china (ustc), china', 'tencent ai lab']
wu24b_interspeech	['nerc-slip, university of science and technology of china, hefei, china', 'china merchants bank, shenzhen, china']
wu24c_interspeech	['nerc-slip, university of science and technology of china, hefei, china']
xie24_interspeech	['cheng1,∗, long ye1, jianhua tao4,5', 'state key laboratory of media convergence and communication, communication university of china 2institute of automation,', 'chinese academy of sciences 3school of artificial intelligence, university of chinese academy of sciences 4department of', 'automation, tsinghua university 5 beijing national research center for information science and technology, tsinghua university']
du24_interspeech	['national engineering research center of speech and language information processing,', 'university of science and technology of china, hefei, p r. china']
honda24_interspeech	['kyoto university, japan']
ye24_interspeech	['hithink royalflush ai research institute, zhejiang, china']
peng24_interspeech	['nerc-slip, university of science and technology of china, hefei, china']
ling24_interspeech	['guangdong university of technology, guangzhou, china', 'imsl shenzhen key lab, pku-hkust shenzhen hong kong institute, shenzhen, china', 'shenzhen raisound technologies, co., ltd, shenzhen, china']
yang24d_interspeech	['zhejiang university', 'huawei cloud,']
maisonneuve24_interspeech	['lia, avignon university, france', 'aix-marseille univ, cnrs, lpl, aix-en-provence, france', 'lnpl, toulouse university and toulouse hospital, toulouse, france']
setoguchi24_interspeech	['chiba institute of technology']
shi24b_interspeech	['graduate school of informatics, kyoto university, kyoto, japan']
truong24_interspeech	['english department, university of tubingen, germany']
niebuhr24_interspeech	['centre for industrial electronics, university of southern denmark, sonderborg, denmark', 'department of foreign languages and linguistics, shiraz university, iran']
amiriparian24_interspeech	['chi – chair of health informatics, mri, tu munich, germany', 'chair of embedded intelligence for health care & wellbeing, university of augsburg, germany', 'glam – group on language, audio, & music, imperial college, uk']
lin24_interspeech	['nercms, school of computer science, wuhan university', 'sleep medicine centre, zhongnan hospital of wuhan university']
messica24_interspeech	['school of computer science and engineering', 'the hebrew university of jerusalem, israel']
riegger24_interspeech	['university of konstanz, germany']
liu24b_interspeech	"['nanjing university of posts and telecommunications, nanjing, china', ""school of advanced technology, xi'an jiaotong-liverpool university, suzhou, china""]"
li24e_interspeech	['dept. of electrical and electronic engineering, the hong kong polytechnic university', 'graduate institute of communication engineering, national taiwan university', 'dept. of systems engineering & engineering management, the chinese university of hong kong']
yusuf24_interspeech	['google inc., usa', 'bogazici university, turkey']
abel24_interspeech	['universite de lorraine, cnrs, inria, loria, f-54000 nancy, france']
li24f_interspeech	['universite paris cite, cnrs, llf, france']
dissen24_interspeech	['faculty of electrical and computer engineering,', 'technion – israel institute of technology, israel']
audibert24_interspeech	['laboratoire de phonetique et phonologie (cnrs & sorbonne nouvelle), paris, france', 'aix marseille univ, cnrs, lpl, aix-en-provence, france']
singh24b_interspeech	['iit kanpur, india', 'iiser bhopal, india']
roth24_interspeech	['school of computer science and engineering', 'the hebrew university of jerusalem, israel']
boukun24_interspeech	['machine learning lab', 'department of medical physics and acoustics, carl von ossietzky universitat oldenburg, germany']
jones24_interspeech	['department of linguistics, university of georgia, athens ga usa', 'department of cognitive science, johns hopkins university, baltimore md usa']
tadavarthy24_interspeech	['institute for artificial intelligence, university of georgia, athens ga usa', 'department of linguistics, university of georgia, athens ga usa', 'department of cognitive science, johns hopkins university, baltimore md usa']
rouditchenko24_interspeech	['mit, usa', 'ibm research ai, usa', 'mit-ibm watson ai lab, usa', 'university of bonn, germany']
deshmukh24b_interspeech	['carnegie mellon university', 'microsoft']
shih24_interspeech	['department of computer science, the university of texas at austin, usa']
wang24i_interspeech	['dehak1,2', 'center for language and speech processing, johns hopkins university, usa', 'human language technology center of excellence, johns hopkins university, usa', 'laboratory for computational auditory perception, johns hopkins university, usa']
ghosh24_interspeech	['artificial intelligence lab', 'mobile dialog systems, otto-von-guericke-university, magdeburg, germany', 'school of computer science, university of birmingham', 'speech and language technology, german research center for artificial intelligence (dfki)']
dhawan24_interspeech	['nvidia corporation, santa clara, ca, usa']
srinivas24_interspeech	['university of washington', 'microsoft', 'assemblyai']
shim24_interspeech	['qualcomm ai research†, qualcomm korea yh, seoul, republic of korea']
neekhara24_interspeech	['nvidia corporation, santa clara, ca, usa']
guo24_interspeech	"[""school of marine science and technology, northwestern polytechnical university, xi'an, china"", 'institute of artificial intelligence (teleai), china telecom, china', 'research & development institute of northwestern polytechnical university in shenzhen, china']"
yip24_interspeech	['alibaba-ntu singapore jri, interdisciplinary graduate programme, ntu, singapore', 'nanyang technological university, singapore', 'alibaba group']
ward24_interspeech	['university of texas at el paso, usa']
shirahata24_interspeech	['ly corporation., japan']
xu24_interspeech	['machine learning and human language technology group, computer science dept., rwth', 'aachen university, germany', 'apptek gmbh', ' aachen, germany']
li24g_interspeech	['nerc-slip, university of science and technology of china, hefei, china']
chen24f_interspeech	['shin1, julia hirschberg1', 'columbia university, usa']
khassanov24_interspeech	['bytedance']
matsuura24_interspeech	['ntt corporation, japan']
jin24b_interspeech	['dept. of electrical and electronic engineering, the hong kong polytechnic university', 'hong kong sar']
lambropoulos24_interspeech	['speech and language laboratory, australian national university, canberra, australia', 'school of culture, history and language, australian national university, canberra, australia']
zhou24_interspeech	['hieu nguyen, jia qi yip, bin ma', 'alibaba group, singapore']
jin24c_interspeech	['dept. of electrical and electronic engineering, the hong kong polytechnic university', 'hong kong sar']
kim24c_interspeech	['university of seoul, republic of korea', 'naver cloud corporation, republic of korea']
kim24d_interspeech	['ipai, seoul national university, republic of korea', 'naver cloud, republic of korea', 'dept. of intelligence and information, aiis, seoul national university, republic of korea']
shen24_interspeech	['china mobile research institute, china']
yu24_interspeech	['national taiwan normal university, taiwan', 'national chi nan university, taiwan', 'realtek semiconductor corp., taiwan']
um24_interspeech	['dept. of electrical and electronic eng., yonsei university, seoul, south korea']
lu24b_interspeech	['key laboratory of speech acoustics and content understanding, institute of acoustics, chinese', 'academy of sciences, china 2university of chinese academy of sciences, china']
li24h_interspeech	['national institute of information and communications technology (nict), japan', 'nanyang technological university, singapore 3kyoto university, japan']
kan24_interspeech	['huawei international, singapore', 'huawei technology, china']
choi24_interspeech	['university of science and technology, south korea', 'electronics and telecommunications research institute, south korea']
suh24_interspeech	['department of applied artificial intelligence, hanyang university, republic of korea']
shen24b_interspeech	['key laboratory of aerospace information security and trusted computing, ministry of education', 'school of cyber science and engineering, wuhan university']
feng24_interspeech	['cooperative medianet innovation center, shanghai jiao tong university, china', 'shanghai artificial intelligence laboratory, china']
wang24j_interspeech	['national taiwan university of science and technology, taiwan', 'national taiwan university, taiwan']
saito24_interspeech	['the university of tokyo, japan', 'keio university, japan', 'ly corp., japan.']
svirsky24_interspeech	['bar ilan university, israel']
shamsian24_interspeech	['aiola research, israel']
bonafos24_interspeech	"['universite de saint-etienne', ""universite d'aix-marseille"", 'resurgences r&d']"
ullah24_interspeech	['school of computer science, university college dublin, ireland']
cho24_interspeech	['department of artificial intelligence, korea university, seoul, korea', 'department of software and computer engineering, ajou university, gyeonggi-do, korea']
zhang24b_interspeech	['department of automation, xiamen university, xiamen 361000, china', 'xiamen key laboratory of big data intelligent analysis and decision making, xiamen university,', 'xiamen 361000, china']
kunesova24_interspeech	['new technologies for the information society and department of cybernetics,', 'faculty of applied sciences, university of west bohemia, pilsen, czech republic']
rosello24_interspeech	['martin-donas2', 'dept. signal theory, telematics and communications and citic, university of granada, spain', 'fundacion vicomtech, basque research and technology alliance (brta), san sebastian, spain']
wang24k_interspeech	['cui1, shujie hu1, mengzhe geng4, guinan li1, helen meng1, xunying liu1', 'the chinese university of hong kong', 'institute of software, chinese academy of sciences', 'nanyang technological university', 'national research council cananda']
xin24_interspeech	['school of ece, peking university, shenzhen, china']
sato24_interspeech	['ashihara1, atsushi ando1, kentaro shinayama1, marc delcroix1', 'ntt corporation, japan']
monaghan24_interspeech	['easwar1,2, padraig kitterick1,2', 'national acoustic laboratories, australia', 'macquarie university, australia']
zaitova24_interspeech	['saarland university, germany']
turetzky24_interspeech	['cohen2, yosi shrem2, bronya r chernyak2, olga seleznova2, joseph keshet2, yossi adi1', 'the hebrew university of jerusalem, israel', 'technion, israel institute of technology']
xue24_interspeech	['language science and techonology, saarland university, germany']
yan24_interspeech	['ai lab, xiaomi corporation, china']
wang24l_interspeech	"['national institute of informatics, japan', 'school of computing, university of eastern finland,', 'finland', 'department of electrical and electronic engineering, the hong kong polytechnic', 'university, hong kong', ""laboratoire informatique d'avignon, avignon universite, france""]"
kim24e_interspeech	['naver cloud, south korea', 'yonsei university, south korea']
sun24b_interspeech	['china mobile research institute', 'institute of automation, chinese academy of sciences']
hwang24b_interspeech	['university of tsukuba', 'seikei university']
rousso24_interspeech	['technion - israel institute of technology, israel', 'university of zurich, switzerland']
ahn24_interspeech	['kaist 2kwangwoon university 3ajou university 4seoul national university']
zhang24c_interspeech	['kuaishou technology, beijing, china', 'graduate school of informatics, kyoto university, sakyo-ku,kyoto, japan']
makishima24_interspeech	['ntt corporation, japan']
qiu24_interspeech	['key laboratory of brain health intelligent evaluation and intervention (beijing institute of technology),', 'ministry of education, beijing 100081, china', 'school of medical technology, beijing institute of technology, beijing 100081, china', 'school of automation, nanjing university of aeronautics and astronautics, nanjing, china', 'msu-bit-smbu joint research center of applied mathematics, shenzhen msu-bit university, shenzhen,', ', china', 'educational physiology laboratory, graduate school of education, university of tokyo, japan', 'glam – the group on language, audio, & music, imperial college london, uk', 'chi – chair of health informatics, mri, technical university of munich, germany']
moriya24_interspeech	['ntt corporation, japan']
hsieh24_interspeech	['graduate program of multimedia systems and intelligent computing,', 'national cheng kung university, tainan, taiwan']
vankeirsbilck24_interspeech	['nvidia, germany']
lin24b_interspeech	['national taiwan university, taiwan', 'asus intelligent cloud services, singapore']
lu24c_interspeech	['graduate institute of communication engineering, national taiwan university, taiwan', 'nvidia']
yang24e_interspeech	['department of electrical engineering, national tsing hua university, taiwan']
cao24b_interspeech	['department of electronic systems, ntnu, norway', 'kth royal institute of technology, eecs, sweden']
chien24_interspeech	['department of electrical engineering, national tsing hua university, taiwan']
lenglet24_interspeech	['univ. grenoble alpes, cnrs, grenoble inp, gipsa-lab, france']
lin24c_interspeech	['institute of communication engineering, national tsing hua university, taiwan', 'department of electrical engineering, national tsing hua university, taiwan']
lee24f_interspeech	['kim2', 'samsung research, seoul, republic of korea', 'department of ece and inmc, seoul national university, seoul, republic of korea']
upadhyay24_interspeech	['national tsing hua university, taiwan', 'university of texas at dallas, usa']
hsu24_interspeech	['department of electrical engineering, national tsing hua university, taiwan']
chou24_interspeech	['department of electrical engineering, national tsing hua university, taiwan']
lehecka24_interspeech	['department of cybernetics, university of west bohemia pilsen, czech republic']
hoffner24_interspeech	['communication acoustics and cluster of excellence hearing4all,', 'carl von ossietzky universitat oldenburg, germany']
getman24_interspeech	['department of lnformation and communications engineering, aalto university, finland']
cumlin24_interspeech	['codemill ab, umea, sweden', 'google llc', 'digital futures and kth royal institute of technology, stockholm, sweden']
getman24b_interspeech	['department of lnformation and communications engineering, aalto university, finland', 'uit the arctic university of norway']
tran24_interspeech	['delhay1, pierre-francois marteau3', 'univ rennes, irisa, cnrs, france', 'universite le mans, lium, france', 'universite bretagne sud, irisa, cnrs, france']
wu24d_interspeech	['national tsing hua university, taiwan', 'university of new south wales, australia']
zhang24d_interspeech	['multimedia computing group, delft university of technology, the netherlands']
miara24_interspeech	['epita research laboratory (lre), france']
yang24f_interspeech	['moe key lab of artificial intelligence, ai institute, x-lance lab,', 'shanghai jiao tong university, china', 'alibaba group, china']
macaire24_interspeech	['esperanca-rodier1', 'univ. grenoble alpes, cnrs, grenoble inp, lig', ' grenoble, france']
kim24f_interspeech	['department of ai, kyungpook national university, south korea', 'rsc lab, modulabs, south korea', 'naver digital healthcare lab, naver ai lab, naver cloud, south korea']
kathan24_interspeech	['bj¨orn w schuller1,2,5, shahin amiriparian1,2', 'chair of embedded intelligence for health care and wellbeing, university of augsburg, germany', 'chi – chair of health informatics, mri, technical university of munich, germany', 'department of psychiatry and psychotherapy, university hospital, lmu munich, germany', 'zentrumspraxis friedberg, germany', 'glam – group on language, audio, & music, imperial college london, uk']
wang24m_interspeech	['department of mathematics, school of science, university of science and technology, liaoning, anshan, china', 'school of public policy, cornell university, ithaca, ny, usa', 'school of electronic and information engineering, university of science and technology liaoning, anshan, china', 'department of artificial intelligence and computer science, yeshiva university, new york, ny, us']
graave24_interspeech	['technische universitat braunschweig', 'institute for communications technology', 'braunschweig, germany']
zhang24e_interspeech	['samsung ai center cambridge, united kingdom']
huang24_interspeech	['school of computer science and engineering, sun yat-sen university, guangzhou, china', 'china mobile internet co., ltd., guangzhou, china']
li24i_interspeech	['technische universitat braunschweig, institute for communications technology,', 'braunschweig, germany 2amazon agi', ' pittsburgh, pa, usa']
kundu24_interspeech	['apple inc.']
lemerle24_interspeech	['stms lab', 'ircam, cnrs, sorbonne universite', 'paris, france']
kang24_interspeech	['department of electronic engineering, hanyang university, seoul, republic of korea']
parragallego24_interspeech	['gita lab. university of antioquia, medellin, colombia. 2konecta group s.a.s. medellin,', 'colombia. 3idiap research institute, martigny, switzerland.', 'epfl, ecole polytechnique federale de lausanne, switzerland.', 'pattern recognition lab. friedrich alexander university, erlangen-nuremberg']
chen24g_interspeech	['meta ai, uk', 'imperial college london, uk']
barberis24_interspeech	['experimental otorhinolaryngology (exporl), department of neurosciences, ku leuven', 'processing speech and images (psi), department of electrical engineering (esat), ku leuven', 'laboratory for cognitive neurology (lcn), department of neurosciences, ku leuven']
laquatra24_interspeech	['orozco-arroyave3, sabato marco siniscalchi2,4', 'kore university of enna, italy 2norwegian university of science and technology, norway', 'university of antioquia, colombia 4universita degli studi di palermo, italy']
zhang24f_interspeech	['speech & language sciences, newcastle university, uk', 'school of foreign languages, tianjin university, china', 'department of communication sciences and disorders, temple university, usa']
maselli24_interspeech	['fonds wetenschappelijk onderzoek - vlaanderen, belgium', 'universiteit gent, belgium', 'bantugent, belgium', 'universite de mons, belgium']
kim24g_interspeech	['korea advanced institute of science and technology, south korea']
taherian24_interspeech	['the ohio state university, usa', 'meta reality labs research, usa']
selvakumar24_interspeech	['lg electronics, toronto ai lab, canada']
dekel24_interspeech	['ibm research']
zhou24b_interspeech	['institute of automation, chinese academy of sciences, china 2school of artificial intelligence, university of chinese academy of', 'sciences, china 3department of automation, tsinghua university, china']
chochlakis24_interspeech	['university of southern california, usa', 'aws ai labs, usa']
wang24n_interspeech	['google']
huang24b_interspeech	['dept. of electrical and electronic engineering,', 'the hong kong polytechnic university, hong kong sar, china']
um24b_interspeech	['school of electrical engineering, kaist, daejeon, republic of korea']
li24j_interspeech	['department of electrical and computer engineering, university of illinois', 'beckman institute for advanced science and technology, university of illinois', 'department of computer science, university of illinois']
johnson24_interspeech	['jpmorgan chase & co. machine learning center of excellence, usa']
lai24_interspeech	['dexian, usa', 'university of california, berkeley, usa']
aziz24_interspeech	['school of computer science and engineering', 'the hebrew university of jerusalem, israel']
wu24e_interspeech	['department of engineering, university of cambridge, cambridge, uk', 'department of electronic engineering, tsinghua university, beijing, china']
pankov24_interspeech	['matveeva1', 'huawei technologies, russia 2itmo university, russia 3hse, russia 4spbu, russia 5huawei noah ark lab, china']
chi24_interspeech	['the centre for speech technology research, university of edinburgh, united kingdom']
robertson24_interspeech	['university of toronto, canada']
han24_interspeech	['apple inc.']
huang24c_interspeech	['university of massachusetts amherst, united states', 'google inc., united states']
huang24d_interspeech	['google llc, usa']
chien24b_interspeech	['toyota technological institute at chicago, usa', 'ai at meta, usa']
gupta24_interspeech	['ibm research']
kang24b_interspeech	['aws ai labs']
seide24_interspeech	['meta, usa']
ho24_interspeech	['hitachi, ltd., japan']
shejwalkar24_interspeech	['google']
chen24h_interspeech	['university of california san diego, usa', 'adobe research, usa']
yang24g_interspeech	['google llc, mountain view, ca, u.s.a.']
jiang24_interspeech	['cave3, marilyn ladewig4, rus heywood1, jordan r green2', 'google research 2mgh-ihp 3language and cognition ucl 4cpunlimited']
jukic24_interspeech	['nvidia, usa']
zheng24_interspeech	['it innovation and research center, huawei technologies, china']
zhong24_interspeech	['guangdong provincial key laboratory of intelligent information processing, shenzhen key', 'laboratory of media security, shenzhen university, china. 2state key laboratory of multimodal', 'artificial intelligence systems, institute of automation,chinese academy of sciences, china']
hou24_interspeech	['aws ai labs, usa']
guo24b_interspeech	['interactive robot research team, guardian robot project, riken, japan', 'graduate school of engineering science, osaka university, japan', 'advanced telecommunications research institute international, japan']
yang24h_interspeech	['indiana university, usa', 'adobe research, usa', 'university of illinois at urbana-champaign, usa']
li24k_interspeech	['school of electronic and information engineering, south china university of technology, guangzhou, china']
xin24b_interspeech	['school of ece, peking university, shenzhen, china']
yang24i_interspeech	['national sun yat-sen university, taiwan']
liou24_interspeech	['cheng2, hsiang-feng chuang2, wei-yu chen2', 'national sun yat-sen university, taiwan 2advanced technology laboratory, chunghwa telecom', 'laboratories, taipei, taiwan']
li24l_interspeech	['national engineering research center of speech and language information processing,', 'university of science and technology of china, hefei, p.r.china']
gu24_interspeech	['auditory cognition and computational acoustics lab', 'moe key lab of artificial intelligence, ai institute', 'department of computer science and engineering, shanghai jiao tong university, shanghai, china']
kim24h_interspeech	['hyundai motor group, seoul, korea']
li24m_interspeech	['department of mathematics, school of science, university of science and technology, liaoning, anshan, china', 'school of public policy, cornell university, ithaca, ny, usa.', 'department of artificial intelligence and computer science, yeshiva university, new york, ny, usa']
li24n_interspeech	['institute of linguistics, china academy of social sciences (cass)', 'corpus and computational linguistics center, institute of linguistics, cass']
hirschkind24_interspeech	['thiebaut, colin sinclair, kyle spence, charles shang, zoe abrams, morgan mcguire', 'roblox, united states']
nakagome24_interspeech	['line works corporation, japan', 'naver cloud corporation, south korea']
guan24_interspeech	['department of automation, university of science & technology of china (ustc), hefei, china', 'ai labs, unisound ai technology co. ltd, beijing, china', 'beijing iplustek co., ltd, beijing, china']
lin24d_interspeech	['national taiwan university, taiwan', 'university of edinburgh, united kingdom']
chen24i_interspeech	['school of physics and electronic engineering, jiangsu normal university, xuzhou, china']
ochi24_interspeech	['graduate school of informatics, kyoto university, kyoto, japan']
gupta24b_interspeech	['laval university, canada', 'mila-quebec ai institute, canada,', 'concordia university, canada', 'universite de montreal, canada', 'canada cifar ai chair']
ando24_interspeech	['ntt corporation, japan']
liu24c_interspeech	['meta, menlo park, ca, usa']
paissan24b_interspeech	['fondazione bruno kessler, italy', 'mila-quebec ai institute, canada 3concordia university, canada', 'university of illinois at urbana-champaign, usa 5laval university, canada']
wang24o_interspeech	['shanghai engineering research center of intelligent education and bigdata,', 'shanghai normal university, shanghai, china', 'unisound ai technology co., ltd., beijing, china']
wang24p_interspeech	['university of electronic science and technology of china', 'the hong kong polytechnic university']
kong24_interspeech	['deezer research, france', 'nantes universite, ecole centrale nantes, cnrs, ls2n, umr 6004']
ahn24b_interspeech	['korea advanced institute of science and technology, south korea', 'samsung research, south korea']
mai24_interspeech	['school of electronic and information engineering, south china university of technology, china', 'school of future technology, south china university of technology, china']
wang24q_interspeech	['moe key lab of artificial intelligence, ai institute, shanghai jiao tong university, china', 'key lab of speech acoustics and content understanding, institute of acoustics, cas, china', 'university of chinese academy of sciences, china 4alibaba group']
truong24b_interspeech	['nanyang technological university, singapore', 'national university of singapore, singapore', 'institute for infocomm research (i2r), a⋆star, singapore', 'the hong kong polytechnic university, hong kong']
zhao24_interspeech	['college of computer science, inner mongolia university, china', 'college of computer science and technology, inner mongolia minzu university, china']
huang24e_interspeech	['department of computer science and information engineering,', 'national cheng kung university, tainan, taiwan']
lin24e_interspeech	['tianjin key laboratory of cognitive computing and application, college of intelligence and', 'computing, tianjin university, tianjin, china', 'graduate school of engineering, the university of tokyo, tokyo, japan', 'huiyan technology (tianjin) co., ltd, tianjin, china', 'shenzhen institute of advanced technology, chinese academy of science, shenzhen, china']
hu24_interspeech	['school of foreign languages, tianjin university, china', 'research centre for language, cognition, and neuroscience, department of chinese and bilingual', 'studies, the hong kong polytechnic university, hong kong sar, china']
harkonen24_interspeech	['fano labs, hong kong sar, china']
lee24g_interspeech	['korea advanced institute of science and technology, republic of korea']
shah24_interspeech	['cvit, kohli centre for intelligent systems, iiit hyderabad, india', 'tcs research, pune, india']
liu24d_interspeech	['inst. of electrical and computer engineering, national yang ming chiao tung university, taiwan']
kim24i_interspeech	['kim1', 'department of electrical and computer engineering and inmc,', 'seoul national university, seoul, south korea']
meng24b_interspeech	['the university of new south wales, australia']
ma24_interspeech	['key laboratory of brain health intelligent evaluation and intervention (beijing institute of', 'technology), ministry of education, beijing', ', china', 'school of medical technology, beijing institute of technology, beijing', ', china', 'school of information and electronics, beijing institute of technology, beijing', ', china', 'glam – the group on language, audio, & music, imperial college london, uk', 'chi – chair of health informatics, mri, technical university of munich, germany', 'educational physiology laboratory, graduate school of education, the university of tokyo, japan']
chen24j_interspeech	['nercms, school of computer science, wuhan university', 'hubei key laboratory of multimedia and network communication engineering', 'guangdong oppo mobile telecommunications corp., china.']
kawamura24_interspeech	['ly corp., japan']
chen24k_interspeech	['zeng2, jianhua tao3, lv zhao1, cunhang fan1,∗', 'school of computer science and technology, anhui university, china 2 institute of automation,', 'chinese academy of sciences, china 3 department of automation, tsinghua university, china']
xing24_interspeech	['school of computer science and technology, xinjiang university, china', 'tsinghua university, china']
jung24b_interspeech	['korea advanced institute of science and technology, south korea']
kashiwagi24_interspeech	['sony group corporation, japan', 'carnegie mellon university, usa']
li24o_interspeech	['the chinese university of hong kong', 'nanyang technological university;', 'national research council candada']
tsunoo24_interspeech	['sony group corporation, japan', 'carnegie mellon university, usa']
jin24d_interspeech	['samsung research, south korea']
kurihara24_interspeech	['nhk (japan broadcasting corporation), japan']
li24p_interspeech	['beijing institute of technology, china', 'tsinghua university, china']
xu24b_interspeech	['school of artificial intelligence, university of chinese academy of sciences, beijing, china', 'institute of automation, chinese academy of sciences, beijing, china', 'department of automation, tsinghua university, beijing, china', 'qiyuan laboratory, beijing, china']
futami24_interspeech	['sony group corporation, japan', 'carnegie mellon university, usa']
cai24_interspeech	['national engineering research center of speech and language information processing, university', 'of science and technology of china, china 2ict cluster, singapore institute of technology,', 'singapore 3the australian national university, australia']
korotkova24_interspeech	['justai, russia', 'higher school of economics, russia', 'school of computer science & robotics, tomsk polytechnic university, russia']
zezario24_interspeech	['national taiwan university', 'academia sinica,', 'southern university of science and technology']
xu24c_interspeech	['narayanan1', 'university of southern california, usa', 'boston university, usa']
zusag24_interspeech	['nyra health']
pineiromartin24_interspeech	['gtm research group, atlanttic research center, university of vigo, vigo, spain', 'balidea consulting & programming s.l., santiago de compostela, spain', 'dfki gmbh, speech and language technology lab, berlin, germany']
yan24b_interspeech	['speech and hearing research center, school of intelligence science and technology, peking', 'university, china 2national biomedical imaging center, college of future technology, peking', 'university, china 3national key laboratory of general artificial intelligence, china']
fan24_interspeech	['school of computer science and technology, anhui university, china', 'institute of automation, chinese academy of sciences, china']
chen24l_interspeech	['speech lab, alibaba group, hangzhou, china', 'university of science and technology of china, hefei, china']
spiesberger24_interspeech	['chi – chair of health informatics, mri, technical university of munich, germany', 'chair of embedded intelligence for health care and wellbeing, university of augsburg, germany', 'department of psychology, university of tuebingen, germany', 'department of neonatology, university of zurich, switzerland', 'department of special education, ludwigsburg university of education, germany', 'glam – group on language, audio, & music, imperial college london, uk', 'idea – center for research on individual development and adaptive education of children at', 'risk, frankfurt am main, germany', 'dzpg – german center for mental health']
zhou24c_interspeech	['netease yidun ai lab, hangzhou, china']
svenssonlundmark24_interspeech	['lund university, sweden']
huang24f_interspeech	['johns hopkins university, usa', 'xiaomi corp., china']
li24q_interspeech	"[""northwestern polytechnical university, xi'an, china""]"
lin24f_interspeech	['school of data science, the chinese university of hong kong, shenzhen, china', 'shenzhen research institute of big data, china', 'department of electrical and computer engineering, national university of singapore, singapore', 'machine listening lab, university of bremen, germany']
chen24m_interspeech	['college of computer science, inner mongolia university, china', 'inner mongolia key laboratory of mongolian information processing technology']
lun24_interspeech	['department of information and communications engineering, aalto university, finland']
zhao24b_interspeech	['college of computer science, inner mongolia university, china']
yin24_interspeech	['adsplab, school of ece, peking university, china', 'arc lab, tencent pcg']
wan24_interspeech	['university of science and technology of china, china', 'iflytek research, china']
kanagawa24_interspeech	['ntt corporation, japan']
wu24f_interspeech	['fudan university, china', 'ping an technology, china']
edlund24_interspeech	['kth royal institute of technology, sweden', 'swedish agency for accessible media (mtm), sweden', 'university of helsinki, finland', 'bielefeld university, germany']
wang24r_interspeech	['atr', 'riken', 'kobe university, japan']
kando24_interspeech	['the university of tokyo, japan', 'keio university, japan']
zhao24c_interspeech	['key laboratory of universal wireless communications, ministry of education, beijing university', 'of posts and telecommunications(bupt), beijing, china', 'fanvil link technology co., ltd, shenzhen, china']
lin24g_interspeech	"['department of electrical and computer engineering, national university of singapore, singapore', ""huawei noah's ark lab"", 'school of data science, shenzhen research institute of big data, the', 'chinese university of hong kong, shenzhen, china']"
ma24b_interspeech	['moe key lab of artificial intelligence, x-lance lab, shanghai jiao tong university, china', 'department of computer science, university of sheffield, united kingdom', 'institute of science and technology for brain-inspired intelligence, fudan university, china']
li24r_interspeech	['moe key lab of artificial intelligence, ai institute, x-lance lab, shanghai jiao tong', 'university, china', 'aispeech ltd, china']
lee24h_interspeech	['naver cloud, south korea', 'kaist, south korea']
lebourdais24_interspeech	['lium, le mans university, le mans, france', 'irit, toulouse, france', 'ids, telecom paris, palaiseau, france 4vivolab, university of zaragoza, spain']
zhou24d_interspeech	['shenzhen transsion holdings co., ltd, shanghai branch, china']
valente24_interspeech	['almawave s.p.a., voice engineering lab, italy']
fujita24b_interspeech	['ntt corporation, japan']
liu24e_interspeech	['moe key lab of artificial intelligence, ai institute, x-lance lab, department of computer', 'science and engineering, shanghai jiao tong university, shanghai, china', 'tencent ai lab, shenzhen, china']
hoscilowicz24_interspeech	['janicki3', 'samsung r&d institute poland, warsaw, poland', 'university of warsaw, poland', 'warsaw university of technology, poland']
elie24_interspeech	['lel, ppls, the university of edinburgh; edinburgh, scotland, united kingdom', 'faculty of arts; university of helsinki; helsinki, finland']
zhang24g_interspeech	['key laboratory of universal wireless communications, ministry of education', 'beijing university of posts and telecommunications, beijing, china', 'fanvil link technology co., ltd, shenzhen, china']
almudevar24_interspeech	['miguel1, eduardo lleida1', 'vivolab, aragon institute for engineering research (i3a), university of zaragoza, spain', 'lium, le mans university, le mans france', 'ltci, telecom paris, institut polytechnique de paris, palaiseau, france']
raissi24_interspeech	['machine learning and human language technology group, rwth aachen university, germany', 'apptek gmbh, germany', '⋆denotes equal contribution']
tulchynska24_interspeech	['hebrew university of jerusalem, israel', 'university of namibia, namibia', 'kiel university, germany']
nayak24_interspeech	['language ai r&d,', 'samsung research institute-bangalore, india']
dibratto24_interspeech	['dept. of humanities, university of naples federico ii, italy', 'dept. of electrical engineering and information technology, university of naples federico ii, italy', 'urban/eco research center, italy']
yue24_interspeech	['the university of sydney, australia 2macquarie university, australia 3university of york, uk']
trachu24_interspeech	['department of computer engineering, faculty of engineering, chulalongkorn university', 'center of excellence in computational molecular biology, chulalongkorn university']
paturi24_interspeech	['aws ai labs']
chiu24_interspeech	['national tsing hua university, taiwan', 'academia sinica, taiwan']
jiang24b_interspeech	['wang3, xunying liu2, feng tian1,4†', 'institute of software, chinese academy of sciences', 'the chinese university of hong kong', 'shenzhen institute of advanced technology, cas,4university of chinese academy of sciences']
nayak24b_interspeech	['language ai r&d,', 'samsung research institute-bangalore, india']
tan24_interspeech	['harbin institute of technology (shenzhen), shenzhen, china', 'peng cheng laboratory, shenzhen, china', 'guangzhou university, guangzhou, china', 'zhejiang university of science and technology, hangzhou, china']
flynn24_interspeech	['department of computer science, the university of sheffield, united kingdom']
khaertdinov24_interspeech	['maastricht university, the netherlands']
yang24j_interspeech	['key lab of speech acoustics and content understanding, institute of acoustics, cas, china', 'university of chinese academy of sciences, china']
flynn24b_interspeech	['department of computer science, the university of sheffield, united kingdom']
fagniart24_interspeech	['huberlant3, myriam piccaluga1 & kathy huet1', 'language sciences and metrology unit, umons, mons, belgium', 'ulb - universite libre de bruxelles, brussels, belgium', 'functional rehabilitation center « comprendre et parler », brussels, belgium', 'fund for scientific research (f.r.s.–fnrs), belgium']
gao24c_interspeech	['university of science and technology of china, china 2beijing aishell technology co., ltd.,', 'china 3beijing polytechnic, china 4duke kunshan university, china 5georgia institute of', 'technology, usa']
chang24_interspeech	['department of computer science and information engineering,', 'national cheng kung university, tainan, taiwan']
bai24_interspeech	['school of artificial intelligence, beijing university of posts and telecommunications, china']
li24s_interspeech	['meituan']
song24_interspeech	['moe key lab of artificial intelligence, ai institute', 'x-lance lab, department of computer science and engineering,', 'shanghai jiao tong university, shanghai, china', 'tencent ai lab, usa']
hu24b_interspeech	['radboud university, the netherlands', 'utrecht university, the netherlands']
xie24b_interspeech	['national engineering research center of speech and language information processing,', 'university of science and technology of china, hefei, china. 2the australian national university,', 'australian. 3ict cluster, singapore institute of technology, singapore.']
oneata24_interspeech	['politehnica bucharest, romania', 'stellenbosch university, south africa']
kummervold24_interspeech	['national library of norway']
ortizperez24_interspeech	['department of computer technology, university of alicante, alicante, spain', 'department of software and computing systems, university of alicante, alicante, spain']
mariotte24_interspeech	['lium, institut claude chappe, le mans universite, france', 'laum ia-gs umr cnrs 6613, le mans universite, france']
gong24_interspeech	['aimpower. 5nankai university. 6wenet open source community', 'university of science and technology of china. 8duke kunshan university']
ranjan24_interspeech	['tcs research, tata consultancy services limited, india']
rahou24_interspeech	['irit, universite de toulouse, cnrs, toulouse inp, ut3, toulouse, france']
kanagawa24b_interspeech	['ntt corporation, japan']
hu24c_interspeech	['nanyang technological university, singapore', 'university of aberdeen, uk', 'university of science and technology of china, china']
chen24n_interspeech	['qifu technology, china']
wu24h_interspeech	['college of computer science, inner mongolia university, china', 'lenovo, beijing, china']
wang24s_interspeech	['nankai university, china', 'university of wollongong, australia']
zanonboito24_interspeech	['naver labs europe, france 2university of edinburgh, uk']
kim24j_interspeech	['yu†', 'university of seoul, republic of korea']
porjazovski24_interspeech	['aalto university, finland']
martindonas24_interspeech	['fundacion vicomtech, basque research and technology alliance (brta), san sebastian, spain', 'dept. signal theory, telematics and communications and citic, universidad de granada, spain']
tanaka24_interspeech	['ntt corporation, japan']
rezackova24_interspeech	['new technologies for the information society (ntis) and 2department of cybernetics,', 'faculty of applied sciences, university of west bohemia, pilsen, czech republic']
guillaume24_interspeech	['lacito, cnrs, universite sorbonne nouvelle, f-94800, villejuif, france', 'llf, cnrs, universite paris-cite, f-75013, paris, france']
lee24i_interspeech	['university of trento, italy', 'naver labs europe, france', 'fondazione bruno kessler, italy']
cheng24_interspeech	['institute of neuroinformatics, university of zurich and eth zurich', 'reality labs research, meta']
saget24_interspeech	['lium, le mans university, france']
huckvale24_interspeech	['speech, hearing and phonetic sciences, university college london, uk']
baroudi24_interspeech	['universite de toulon, aix marseille univ, cnrs, lis, toulon, france', 'irit, universite de toulouse, cnrs, toulouse inp, ut3, toulouse, france']
gong24b_interspeech	['auditory cognition and computational acoustics lab', 'moe key laboratory of artificial intelligence, ai institute', 'department of computer science and engineering, shanghai jiao tong university, shanghai, china', 'antgroup, shanghai, china']
li24t_interspeech	['northwestern polytechnical university, china', 'tencent youtu lab, china']
gong24c_interspeech	['wang1,∗, jianwu dang1, marc tessier3, aidan pine3, korin richmond4, junichi yamagishi2', 'tianjin key laboratory of cognitive computing and application,', 'college of intelligence and computing, tianjin university, tianjin, china', 'national institute of informatics, japan 3national research council canada', 'the centre for speech technology research, university of edinburgh', 'national institute of information and communications technology, japan']
meng24c_interspeech	['the chinese university of hong kong, hong kong sar, china']
igarashi24_interspeech	['tachibana2, hiroshi saruwatari1', 'the university of tokyo, japan', 'ly corp., japan', 'keio university, japan']
li24u_interspeech	['nerc-slip, university of science and technology of china, hefei, china']
demir24_interspeech	['friedrich-alexander-universitat erlangen-nurnberg, germany']
kim24k_interspeech	['department of electronic engineering, hanyang university, seoul, republic of korea']
schrufer24_interspeech	['audeering gmbh, germany', 'chi – chair of health informatics, mri, technical university of munich, germany', 'glam – the group on language, audio, & music, imperial college london, london, uk']
anderer24_interspeech	['karlsruhe university of applied sciences, germany', 'karlsruhe institute of technology, germany', 'university of hohenheim, germany']
xue24b_interspeech	['beijing university of posts and telecommunications, beijing, china']
gosztolya24_interspeech	['hun-ren–szte research group on artificial intelligence, szeged, hungary', 'university of szeged, institute of informatics, szeged, hungary']
tang24_interspeech	['tencent ethereal audio lab, tencent, china', 'center for speech and language technologies, bnrist, tsinghua university, china']
naderi24_interspeech	['magimai.-doss1', 'idiap research institute, martigny, switzerland', 'unidistance suisse, brig, switzerland']
charuau24_interspeech	['gipsa-lab, univ. grenoble-alpes, cnrs, grenoble inp, france', 'lead, cnrs, universite de bourgogne, france']
miyazaki24_interspeech	['cyberagent, inc., japan', 'tokyo metropolitan university, japan']
gosztolya24b_interspeech	['hun-ren–szte research group on artificial intelligence, szeged, hungary', 'university of szeged, institute of informatics, szeged, hungary', 'hun-ren research center for linguistics, budapest, hungary', 'elte e¨otv¨os lorand university, dept. of applied linguistics and phonetics, budapest, hungary', 'university of szeged, department of psychiatry, szeged, hungary']
kalabakov24_interspeech	['hasso plattner institute, university of potsdam, germany 2audeering gmbh, germany 3mri,', 'technical university of munich, germany 4imperial college, uk 5munich center for machine', 'learning, germany']
polzehl24_interspeech	['dahlem3, sebastian m¨oller1,2', 'speech and language technology, german research center for artificial intelligence (dfki)', 'quality and usability lab, technische universitat berlin', 'university hospital wurzburg']
giroud24_interspeech	['mrc cognition and brain sciences unit, university of cambridge, uk']
andrusenko24_interspeech	['nvidia', 'university of london, uk']
zhong24b_interspeech	['beijing language and culture university, china']
zhao24d_interspeech	['tsinghua university, china', 'university of cambridge, united kingdom']
wang24t_interspeech	['department of speech, music, and hearing, kth royal institute of technology']
gosztolya24c_interspeech	['hun-ren–szte research group on artificial intelligence, szeged, hungary', 'university of szeged, institute of informatics, szeged, hungary', 'research center for linguistics, elrn, budapest, hungary', 'elte e¨otv¨os lorand university, dept. of applied linguistics and phonetics, budapest, hungary', 'university of szeged, department of psychiatry, szeged, hungary']
benamor24_interspeech	"[""laboratoire informatique d'avignon, ea 4128, avignon universite, france"", 'inria, defense&security, france']"
popescu24_interspeech	['lisn, france', 'cnrs, france', 'universite paris saclay, france']
lin24h_interspeech	['school of electronic information, sichuan university, china', 'school of software, yunnan university, china', '∗authors contributed equally to this work.']
liu24f_interspeech	['national engineering research center of speech and language information processing,', 'university of science and technology of china, hefei, p r. china', 'interdisciplinary research center for linguistic sciences,', 'university of science and technology of china, hefei, p r. china']
karan24_interspeech	['department of electrical and electronic engineering,', 'stellenbosch university, stellenbosch, south africa']
sadekova24_interspeech	"[""huawei noah's ark lab, moscow, russia""]"
rajkhowa24_interspeech	['indian institute of technology, dharwad, india']
shams24_interspeech	['adapt research centre', 'sfi centre for research training in digitally-enhanced reality (d-real),', 'school of computer science, university college dublin, ireland']
hovsepyan24_interspeech	['idiap research institute, centre du parc, rue marconi 19, ch-1920 martigny, switzerland']
chowdhury24_interspeech	['solventum, usa']
qian24_interspeech	['alta institute, machine intelligence lab, department of engineering, cambridge university, uk']
vanniekerk24_interspeech	['e&e engineering, stellenbosch university, south africa', 'ubisoft la forge, montreal, canada']
mohamed24_interspeech	['university of edinburgh, united kingdom']
xue24c_interspeech	['beijing university of posts and telecommunications, beijing, china']
plaquet24_interspeech	['irit, universite de toulouse, cnrs, toulouse inp, ut3, toulouse, france']
gupta24c_interspeech	['fraunhofer iis, erlangen, germany.']
masumura24_interspeech	['ntt corporation, japan']
li24v_interspeech	['wang1, xurong xie4, helen meng1, xunying liu1', 'the chinese university of hong kong', 'national research council canada', 'the hong kong', 'polytechnic university', 'institute of software, chinese academy of sciences']
pan24_interspeech	['mitsubishi electric research laboratories (merl), cambridge, ma, usa', 'waseda university, tokyo, japan']
li24w_interspeech	['nercms, school of computer science, hubei luojia laboratory, wuhan university, china', 'hubei key laboratory of multimedia and network communication engineering, wuhan', 'university, china']
moschopoulos24_interspeech	['samsung r&d institute uk (sruk), united kingdom', 'centre for research and technology hellas, greece', 'pragma iot sa, hellas, greece']
muller24c_interspeech	['orange innovation, france', 'irisa, university of rennes, france']
lin24i_interspeech	['national taiwan university, taiwan', 'national tsing hua university, taiwan']
dineley24_interspeech	"['matcham2, johnny downs1, richard j dobson1,3, thomas f quatieri4, nicholas cummins1,5', ""institute of psychiatry, psychology and neuroscience, king's college london, london, uk"", 'school of psychology, university of sussex, falmer, uk', 'institute of health informatics, university college london, london, uk', 'mit lincoln laboratory, lexington, ma, usa', 'thymia, london, uk']"
amiri24_interspeech	['idiap research institute, switzerland', 'ecole polytechnique federale de lausanne, switzerland']
kuan24_interspeech	['graduate institute of communication engineering, national taiwan university, taiwan']
yang24k_interspeech	['department of computer science', 'university of oxford, uk']
wu24i_interspeech	['department of computer science and information engineering, national taiwan normal university']
qian24b_interspeech	['kth royal institute of technology']
loddo24_interspeech	['utrecht university, the netherlands']
khurana24_interspeech	['mitsubishi electric research laboratories (merl), cambridge, ma, usa', 'lium, le mans universite, france']
goria24_interspeech	"['thymia limited, london, uk', ""institute of psychiatry, psychology and neuroscience, king's college london, uk""]"
blockmedin24_interspeech	['lalilo by renaissance learning', ' rue du faubourg saint martin', ' paris, france', 'irit, universite de toulouse, cnrs, toulouse inp, ut3, toulouse, france']
cauzinille24_interspeech	['aix-marseille university, universite de toulon, cnrs, france', 'cornell university, ithaca, ny, usa', 'universiti malaysia sabah (ums), kota kinabalu, sabah, malaysia']
gerczuk24_interspeech	['chair of embedded intelligence for health care & wellbeing, university of augsburg, germany', 'chi – chair of health informatics, mri, tu munich, germany', 'district hospital augsburg, germany', 'german center for mental health, munich, germany', 'glam – group on language, audio, & music, imperial college, uk']
rolland24_interspeech	['inesc-id, lisbon, portugal', 'instituto superior tecnico, universidade de lisboa, portugal']
rolland24b_interspeech	['inesc-id, lisbon, portugal', 'instituto superior tecnico, universidade de lisboa, portugal']
seki24_interspeech	['the university of tokyo, japan', 'keio university, japan']
benway24_interspeech	['university of maryland, college park, md, usa', 'syracuse university, syracuse, ny, usa']
stein24_interspeech	['institute of linguistics / 2department of english language and linguistics, institute of english and', 'american studies, faculty of arts and humanities, heinrich heine university dusseldorf, germany', 'department of linguistics, university of florida']
koudounas24_interspeech	['♣politecnico di torino, turin, italy ♢san feliciano hospital, rome, italy', '♡scdu otorinolaringoiatria, head neck cancer unit, ospedale san giovanni bosco, turin, italy', '♠dipartimento di oncologia, universita degli studi di torino, turin, italy']
nam24b_interspeech	['korea advanced institute of science and technology, south korea', 'naver cloud corporation, south korea', 'carnegie mellon university, usa']
koriyama24_interspeech	['cyberagent, japan']
ewert24_interspeech	['machine listening lab (mll), university of bremen, germany', 'department of electrical and computer engineering, national university of singapore, singapore', 'sds, sribd, the chinese university of hong kong, shenzhen, china', 'cognitive systems lab (csl), university of bremen, germany']
hughes24_interspeech	['university of sheffield, united kingdom']
laperriere24_interspeech	['lia - avignon universite, france', 'lisn - cnrs/universite paris-saclay, france']
kealey24_interspeech	['universite de sherbrooke, sherbrooke, qc, canada', 'google research, cambridge, ma, usa']
bando24_interspeech	['national institute of advanced science and technology (aist), japan', 'carnegie mellon university, usa']
cheng24b_interspeech	['google llc, usa']
daoudi24_interspeech	['inria-bordeaux, france - 2 ent dep. univ. hospital of bordeaux (uhb), france - 3 dep. neurology for neurodegenerative', 'diseases, uhb - 4 dep. neurosciences & clinical pharmacology, univ. hospital of toulouse (uht), france - 5 ent dep., uht.']
arya24_interspeech	['indian institute of technology jammu, india']
barnhill24_interspeech	['friedrich-alexander-universitat erlangen-nurnberg, pattern recognition lab, erlangen, germany', 'technical university of applied sciences amberg-weiden,', 'department of electrical engineering, media and computer science, amberg, germany']
fernandezlopez24_interspeech	['petridis1,2, shiwei liu5, maja pantic1,2', 'meta ai, uk', 'imperial college london, uk', 'university of surrey', 'eindhoven university of technology', 'university of oxford']
tanner24_interspeech	['dodsworth4, erik thomas4', 'university of glasgow, united kingdom 2mcgill university, canada', 'university of oregon, united states 4north carolina state university, united states']
kim24l_interspeech	['laboratoire de phonetique et phonologie (cnrs & u sorbonne nouvelle), france']
wang24u_interspeech	['glam, department of computing, imperial college london, uk', 'centre for vision, speech, and signal processing (cvssp), university of surrey, uk']
choi24b_interspeech	['carnegie mellon university 2toyota technological institute at chicago', 'national institute of advanced industrial science and technology (aist)']
hutiri24_interspeech	['delft university of technology, the netherlands', 'sony ai, switzerland']
mcghee24_interspeech	['alta institute, department of engineering, university of cambridge, uk']
wei24_interspeech	['action.ai, london, uk']
uro24_interspeech	['french national institute of audiovisual (ina), paris, france. 2universite paris saclay, cnrs,', 'lisn, orsay, france. 3lium, le mans universite, france']
liu24g_interspeech	"[""university (npu), xi'an, china"", 'shanghai jiao tong university, shanghai, china']"
phan24_interspeech	['hilden2, mikko kurimo1', 'aalto university, finland', 'university of helsinki, finland', 'university of jyvaskyla, finland']
hutin24_interspeech	['university of louvain, institute for language and communication, belgium']
gessinger24_interspeech	['adapt centre, university college dublin, ireland', 'language science and technology, saarland university, saarbrucken, germany']
borsdorf24_interspeech	['machine listening lab (mll), university of bremen, germany', 'alibaba group, singapore', 'sds, sribd, the chinese university of hong kong, shenzhen, china', 'department of electrical and computer engineering, national university of singapore, singapore', 'cognitive systems lab (csl), university of bremen, germany']
bahrman24_interspeech	['ltci, telecom paris, institut polytechnique de paris, france', 'mitsubishi electric research laboratories (merl), usa']
li24x_interspeech	['aws ai labs']
samptur24_interspeech	['belur3, atchayaram nalini3, prasanta kumar ghosh2', 'computer science and engineering, pes university, india', 'electrical engineering, indian institute', 'of science, india', 'national institute of mental health and neurosciences, india']
elie24b_interspeech	['devauchelle2,3', 'the university of edinburgh, uk 2ina, france 3universite paris saclay, cnrs, lisn']
gao24d_interspeech	['centre for language studies, radboud university nijmegen, netherlands']
watkins24_interspeech	['university of amsterdam, the netherlands']
chen24o_interspeech	['graduate institute of communication engineering, national taiwan university', 'department of computer science and information engineering, national taiwan university']
yu24b_interspeech	['queen mary university of london, uk']
chen24p_interspeech	['graduate institute of communication engineering, national taiwan university', 'department of computer science and information engineering, national taiwan university']
dang24_interspeech	['applied sciences group, microsoft corp, usa']
adigwe24_interspeech	['the centre for speech technology research, university of edinburgh, united kingdom']
peng24b_interspeech	['shakeel2, kwanghee choi1, jiatong shi1, xuankai chang1, jee-weon jung1, shinji watanabe1', 'carnegie mellon university, usa', 'honda research institute japan, japan']
shinoda24_interspeech	['ntt corporation, japan']
ghaffarzadegan24_interspeech	['bosch center for artificial intelligence']
weise24_interspeech	['schuster3, elmar noeth2, bjoern heismann2, andreas maier2, seung hee yang1', 'speech & language processing lab. friedrich-alexander-universitat erlangen-nurnberg, germany', 'pattern recognition lab. friedrich-alexander-universitat erlangen-nurnberg, germany', 'department of otorhinolaryngology, head and neck surgery. ludwig-maximilians university, munich, germany', 'gita lab, faculty of engineering. universidad de antioquia, medellin, colombia']
aldeneh24_interspeech	['apple, usa', 'carnegie mellon university, usa']
erickson24_interspeech	['haskins labs', ' universite paris saclay, cnrs, lisn', ' lund university', ' universidade federal', 'do parana', ' universidade federal do rio de janeiro', ' university of southern denmark', ' cnpq']
pahuja24_interspeech	['machine listening lab (mll), university of bremen, germany 2cognitive systems lab (csl),', 'university of bremen, germany 3national university of singapore, singapore 4school of data', 'science, the chinese university of hong kong, shenzhen, china']
leem24_interspeech	['the university of texas at dallas, usa 2boston university, usa', 'harvard university, usa 4san francisco state university, usa']
koudounas24b_interspeech	['†politecnico di torino, turin, italy']
bhattacharya24_interspeech	['department of computer science, columbia university, usa']
goncalves24_interspeech	['department of electrical and computer engineering, the university of texas at dallas, usa', 'laboratory for analytic sciences, north carolina state university, usa']
naini24_interspeech	['department of electrical and computer engineering, the university of texas at dallas, usa', 'laboratory for analytic sciences, north carolina state university, usa']
liu24h_interspeech	['roblox, united states']
dumpala24_interspeech	['vector institute and dalhousie university, canada.', 'microsoft inc.', 'imperial college, uk']
leivaditi24_interspeech	['university of groningen, the netherlands']
parnamaa24_interspeech	['microsoft corporation']
gupta24d_interspeech	['apple inc.']
zhang24h_interspeech	['carnegie mellon university, usa 2shanghai jiao tong university, china 3ly corp., japan', 'waseda university, japan 5meta, usa 6technische universitat braunschweig, germany']
saijo24_interspeech	['mitsubishi electric research laboratories (merl), ma, usa 2waseda university, tokyo, japan']
hu24d_interspeech	['nagoya university, japan']
mote24_interspeech	['department of electrical and computer engineering, the university of texas at dallas']
botelho24_interspeech	['trancoso1,2', 'inesc-id, portugal. 2instituto superior tecnico, univeristy of lisbon, portugal. 3cognitive', 'systems lab (csl), university of bremen, germany']
salman24_interspeech	['department of electrical and computer engineering, the university of texas at dallas']
shakeel24_interspeech	['honda research institute japan co., ltd., saitama, japan', 'carnegie mellon university, pittsburgh, usa']
liu24i_interspeech	['rwth aachen university, germany', 'delft university of technology, netherlands']
mosner24_interspeech	['peng1, jan cernocky1', 'universite de lorraine, cnrs, inria, loria, f-54000 nancy, france']
ravenscroft24_interspeech	['department of computer science, the university of sheffield, united kingdom', 'solventum, usa']
hsieh24b_interspeech	['department of computer science, university of illinois at urbana-champaign, il, usa', 'school of computer science and electrical engineering, handong global university, korea']
zhang24i_interspeech	['shanghai jiao tong university, china', 'carnegie mellon university, usa', 'waseda university, japan']
sun24c_interspeech	['department of computer science, university of sheffield, uk', 'centre for vision, speech and signal processing (cvssp), university of surrey, uk']
chung24_interspeech	['dept. of electrical & electronic engineering, yonsei university, south korea']
teleki24_interspeech	['texas a&m university, usa']
garcia24_interspeech	['speech processing and transmission lab., electrical engineering department, university of chile', 'msp lab, department of electrical and computer engineering, the university of texas at dallas']
yadav24_interspeech	['aalborg university, denmark', 'pioneer center for ai, denmark']
houston24_interspeech	['aws ai labs, usa']
nguyen24_interspeech	['rossi3, quan hung tran3, trung bui3, thien huu nguyen1', 'department of computer science, university of oregon, usa 2aws ai labs, usa 3adobe', 'research, usa']
perez24_interspeech	['university of michigan, usa']
klein24_interspeech	['pindrop, atlanta, ga, usa']
boeddeker24_interspeech	['paderborn university, germany']
pirlogeanu24_interspeech	['zevo tech, romania', 'politehnica bucharest, romania']
bras24_interspeech	['multimedia computing group, delft university of technology, the netherlands']
phung24_interspeech	['jp morgan chase & co., usa', 'columbia university, usa']
bayestehtashk24_interspeech	['skyworks solutions, inc., usa']
tuttosi24_interspeech	['aucouturier2, angelica lim1', 'school of computing science1, dept. of linguistics3, simon fraser university, canada', 'universite de franche-comte, supmicrotech, cnrs, institut femto-st2, france']
baade24_interspeech	['the university of texas at austin, the united states of america']
friedrichs24_interspeech	['department of computational linguistics, university of zurich, switzerland', 'institute of biology, university of neuchâtel, switzerland', 'linguistic research infrastructure, university of zurich, switzerland', 'faculty of psychology and educational sciences, university of geneva, switzerland', 'department of linguistics and english language, lancaster university, uk', 'department of anthropology, university of miami, usa']
pascu24_interspeech	['politehnica bucharest, romania', 'bitdefender, romania', 'technical university of cluj-napoca, romania']
shon24_interspeech	['asapp, usa 2carnegie mellon university, usa 3toyota technological institute at chicago, usa']
zulfikar24_interspeech	['sarnie2, lisa nowinski2, nataliya kosmyna1, paige townsend2,4, sophia yuditskaya3, tanya talkar3,', 'utkarsh oggy sarawgi∗∗1, christopher mcdougle2, thomas quatieri3, pattie maes1, maria mody2,4', 'mit media lab, usa 2mgh lurie center for autism, usa', 'mit lincoln lab, usa 4mgh martinos center for biomedical imaging, usa']
janiczek24_interspeech	['zoom video communications, united states of america']
jing24b_interspeech	['chair of embedded intelligence for health care & wellbeing, university of augsburg, germany', 'chi – chair of health informatics, mri, technical university of munich, germany', 'glam – group on language, audio, & music, imperial college london, uk']
neumann24_interspeech	['modality.ai, inc., san francisco, ca, usa', 'university of california, san francisco, san francisco, ca, usa']
eskimez24_interspeech	['microsoft corporation, usa']
suzuki24_interspeech	['ntt corporation, japan']
xiao24b_interspeech	['petridis2,3, mykola pechenizkiy1, maja pantic2,3, decebal constantin mocanu1,5, shiwei liu7', 'eindhoven university of technology', 'meta ai, uk', 'imperial college london', 'university of twente', 'university of luxembourg', 'university of surrey', 'university of oxford']
chaudhary24_interspeech	['cse department and infosys centre for ai, iiit delhi, india', 'centre for vision, speech and signal processing, university of surrey, uk']
bai24b_interspeech	['applied sciences group, microsoft corporation', 'university of california, berkeley']
lux24_interspeech	['university of stuttgart, germany', 'fraunhofer institute for integrated circuits iis, erlangen, germany', 'university of groningen, the netherlands']
wang24v_interspeech	['microsoft corporation, usa']
bott24_interspeech	['university of stuttgart, germany']
yen24_interspeech	['georgia institute of technology, u.s.a', 'universita degli studi di palermo, italy', 'norwegian university of science and technology, norway']
labrak24_interspeech	['lia - avignon university, france', 'zenidoc, france', 'nantes universite, ecole centrale nantes, cnrs, ls2n, umr 6004, f-44000 nantes, france']
jung24c_interspeech	['carnegie mellon university, usa', 'apple, usa']
pan24b_interspeech	['microsoft, one microsoft way, redmond, usa']
wang24w_interspeech	['google llc']
feng24b_interspeech	['university of southern california, usa', 'amazon, usa']
anderson24_interspeech	['edinburgh napier university, uk', 'verint systems ltd, usa']
barreraaltuna24_interspeech	['university of south florida, usa', 'sungkyunkwan university, south korea']
fan24b_interspeech	['dept. of electrical and computer engineering, university of california, los angeles, u.s.a']
jung24d_interspeech	['carnegie mellon university, usa', 'national institute of informatics, japan', 'eurecom, france', 'pindrop, usa', 'korea advanced institute of science and technology, south korea']
ni24_interspeech	['southeast university, china', 'zhejiang lab, china']
ma24c_interspeech	['bacchiani2', 'google deepmind, usa', 'google deepmind, japan']
demopoulos24_interspeech	['university of california, san francisco', 'modality.ai, inc., san francisco']
wang24x_interspeech	['nankai university, china']
palaskar24_interspeech	['apple']
zhang24j_interspeech	['national institute of informatics, tokyo, japan 2sokendai, kanagawa, japan', 'national institute of information and communications technology, kyoto, japan', 'digital security department, eurecom, france']
zhang24k_interspeech	['harbin institute of techonlogy, shenzhen']
tomita24_interspeech	['the university of tokyo', 'kobe gakuin university']
xi24_interspeech	['national engineering laboratory for speech and language information processing,', 'university of science and technology of china, hefei, china.', 'the australian national university. 3ict cluster, singapore institute of technology, singapore.']
liu24j_interspeech	['national institute of informatics, tokyo, japan', 'sokendai, kanagawa, japan 3singapore institute of technology, singapore']
kim24m_interspeech	['department of electrical and electronic engineering, yonsei university, south korea', 'idlab, ghent university - imec, ghent, belgium']
gholami24_interspeech	['soc cellular & multimedia lab r&d', 'samsung semiconductor inc., san diego, ca, usa']
kothare24_interspeech	['modality.ai, inc., san francisco, ca, usa 2university medical center utrecht, utrecht,', 'netherlands 3university of california, san francisco, san francisco, ca, usa']
yang24l_interspeech	['the chinese university of hong kong, hong kong sar, china']
xiaowang24_interspeech	['school of information science, beijing language and culture university', 'institute of intelligent language learning, beijing language and culture university']
ahn24c_interspeech	['apple']
halpern24_interspeech	['rebernik3, sebastiaan de visscher4, max witjes4, martijn wieling3, defne abur3, tomoki toda1', 'nagoya university, japan 2netherlands cancer institute, the netherlands', 'university of groningen, the netherlands 4university medical center groningen, the netherlands']
huang24g_interspeech	['hubei key laboratory of smart internet technology, school of electronic information and', 'communication, huazhong university of science and technology,', 'wuhan, china']
singh24c_interspeech	['university of eastern finland, finland', 'institute for advancing intelligence, tcg crest, india', 'academy of scientific and innovative research (acsir), india']
zhao24e_interspeech	['institute of linguistics, chinese academy of social sciences, china. 2department of chinese', 'language and literature, fudan university, china. 3college of foreign languages and literature,', 'fudan university, china. 4institute of modern languages and linguistics, fudan university, china.', 'corresponding author:']
baihaqi24_interspeech	['nara institute of science and technology, japan', 'guardian robot project, riken, japan']
kumar24_interspeech	['department of artificial intelligence and computer science, yeshiva university, new york, ny, usa', 'school of public policy, cornell university, ithaca, ny, usa.']
khanagha24_interspeech	['meta inc. 1 hacker way. menlo park, ca 94025. usa']
siriwardena24_interspeech	['espy-wilson1, andrea fanelli2', 'university of maryland college park, md, usa', 'dolby laboratories, ca, usa']
hussein24_interspeech	['clsp & 2hltcoe, johns hopkins university, usa 3xiaomi corp., china']
wang24y_interspeech	"[""department of electrical and computer engineering, queen's university, kingston, canada"", 'department of signal theory, telematics and communications, university of granada, spain', 'demant a/s, smoerum, denmark', 'department of electronic systems, aalborg university, aalborg, denmark']"
hoang24_interspeech	['department of computer science and engineering, michigan state university, usa', 'department of neurology, massachusetts general hospital, harvard medical school, usa']
shang24_interspeech	['huawei translation service center, beijing, china']
li24y_interspeech	['school of computer science and communication engineering, jiangsu university', 'school of computer science, carnegie mellon university']
rittergutierrez24_interspeech	['nanyang technological university, singapore 2institute for infocomm research (i2r), singapore', 'national taiwan university, taiwan 4asus intelligent cloud services, taiwan 5speech lab of', 'damo academy, alibaba group, singapore']
hai24_interspeech	['electrical and computer engineering, johns hopkins university, baltimore, md, usa', 'massachusetts institute of technology, cambridge, ma, usa', 'myshell.ai, usa']
tang24b_interspeech	['hangzhou huacheng network technology, china']
joseph24_interspeech	['samsung research, bangalore']
guo24c_interspeech	['college of information science and electronic engineering, zhejiang university, china']
bae24_interspeech	['samsung research, seoul, republic of korea', 'samsung research', '∗equal contribution']
talkar24_interspeech	['linus health, boston, ma, usa 2aural analytics, scottsdale, az, usa']
cho24b_interspeech	['seoul national university (snu), republic of korea', 'supertone inc., republic of korea', 'korea advanced institute of science and technology (kaist), republic of korea']
kang24c_interspeech	['apple']
kim24n_interspeech	['department of artificial intelligence, hanyang university, seoul, republic of korea', 'department of electronic engineering, hanyang university, seoul, republic of korea']
zhang24l_interspeech	['tianjin university, china', 'tianjin medical university, china']
a24_interspeech	['college of engineering trivandrum, india', 'government engineering college barton hill, india', 'apj abdul kalam technological university, india']
buddi24_interspeech	['ognjen (oggi) rudovic2, ahmed hussen abdelaziz2, saurabh adya2', 'the university of texas at austin, usa 2apple, usa']
choi24c_interspeech	['department of electronic engineering, hanyang university, seoul, republic of korea']
mohapatra24_interspeech	['northwestern university, usa', 'worcester polytechnic institute, usa']
li24z_interspeech	['school of artificial intelligence, beijing university of posts and telecommunications, china']
chen24q_interspeech	['audiocc lab, cs dept, shanghai jiao tong university, shanghai, china', 'national institute of informatics, tokyo, japan', 'national institute of information and communications technology, kyoto, japan']
wang24z_interspeech	['school of computer science and technology, xinjiang university, urumqi 830017, china', 'xinjiang key laboratory of signal detection and processing, urumqi 830017, china', 'department of electronic engineering, tsinghua university, beijing 100084, china']
meng24d_interspeech	['google llc., usa']
pan24c_interspeech	['institute for infocomm research (i2r), agency for science, technology and research (a⋆star),', 'singapore']
onda24_interspeech	['graduate school of engineering, the university of tokyo, japan']
seong24_interspeech	['department of electronic engineering, hanyang university, seoul, republic of korea']
mehta24_interspeech	['ctr for laryngeal surgery and voice rehab., mass. general hospital, boston, massachusetts, usa']
li24aa_interspeech	['cyberagent, inc., japan']
lin24j_interspeech	['school of computer science, wuhan university, wuhan, china', 'china mobile research institute, beijing, china', 'suzhou municipal key laboratory of mutimodal intelligent systems,', 'duke kunshan university, kunshan, china']
saif24_interspeech	['rensselaer polytechnic institute, troy, ny, usa', 'ibm research ai, t j. watson research center, yorktown heights, ny, usa']
nie24_interspeech	['university of texas at dallas, usa', 'university of southern california, usa', 'university of birmingham, uae']
shi24c_interspeech	['guangdong provincial key laboratory of intelligent information processing, college of', 'electronics and information engineering, shenzhen university, shenzhen', ', china', 'acoustics lab., school of physics and optoelectronics, south china university of technology,', 'guangzhou', ', china']
wang24aa_interspeech	['microsoft, usa']
saeki24_interspeech	['the university of tokyo, japan.', 'carnegie mellon university, usa. 3keio university, japan.']
zhu24_interspeech	['school of computer science and technology, anhui university, hefei 230601, china,', 'department of automation, tsinghua university, china,', 'beijing national research center for information science and technology,tsinghua university']
shih24b_interspeech	['electrical engineering, national taiwan university, taiwan', 'meta ai, usa']
zhao24f_interspeech	['tsinghua university, china', 'shenzhen research institute of big data, china', 'university of cambridge, united kingdom']
oura24_interspeech	['graduate school of human sciences, waseda university, saitama, japan', 'faculty of science and engineering, waseda university, tokyo, japan']
yang24m_interspeech	['netease yidun ai lab, hangzhou, china']
song24b_interspeech	['moe key lab of artificial intelligence, ai institute, x-lance lab,', 'shanghai jiao tong university, china', 'bytedance 3microsoft, one microsoft way, redmond, usa']
xu24d_interspeech	['shenzhen international graduate school, tsinghua university, shenzhen, china', 'tencent ai lab', 'the chinese university of hong kong, hong kong sar, china']
yin24b_interspeech	['national yang ming chiao tung university, taiwan', 'academia sinica, taiwan']
roesler24_interspeech	['zhang1, nikhil sukhdev1, kolja wilms1, anusha badathala2,4, sandrine istas5, steve ruhmel3, bryan', 'hansen3, madeline hannan3, david henley3, arthur wallace2,4, ira shoulson1, david', 'suendermann-oeft1, vikram ramanarayanan1,2,4', 'modality.ai, inc., san francisco, ca, usa. 2san francisco veterans affairs health care system,', 'san francisco, ca, usa. 3janssen research and development, llc., nj, usa. 4university of', 'california, san francisco, san francisco, ca, usa. 5icon strategic solutions, icon plc., belgium']
kusunoki24_interspeech	['department of communications and computer engineering, waseda university, tokyo, japan']
szekely24_interspeech	['division of speech, music and hearing, kth royal institute of technology, sweden', 'department of linguistics cognitive science, university of delaware, usa']
kim24o_interspeech	['choi3, moa lee3, han-gil moon3', 'department of artificial intelligence, hanyang university, seoul, republic of korea', 'hanyang university department of electronic engineering, seoul, republic of korea', 'samsung electronics, suwon, republic of korea']
take24_interspeech	['the university of tokyo, japan', 'keio university, japan', 'national institute of advanced industrial science and technology (aist), japan']
li24ba_interspeech	"[""northwestern polytechnical university, xi'an, china"", 'school of data science, the chinese university of hong kong,', 'shenzhen (cuhk-shenzhen), china', 'the chinese university of hong kong, hong kong sar, china', 'shanghai mobvoi information technology co., ltd']"
heo24_interspeech	['audio ai lab., nc research, ncsoft corp., republic of korea']
wu24j_interspeech	['cas key laboratory of human-machine intelligence-synergy systems, shenzhen institute of', 'advanced technology, chinese academy of sciences, china', 'university of chinese academy of sciences, china', 'guangdong-hong kong-macao joint laboratory of human-machine intelligence-synergy', 'systems, china']
xiong24_interspeech	['school of electrical, computer and energy engineering, arizona state university, tempe, usa', 'college of health solutions, arizona state university, tempe, usa']
tannander24_interspeech	['kth royal institute of technology', 'swedish agency for accessible media']
wu24k_interspeech	['kachinthaya1, tavish mishra1, bohan yu1, alan w black1, rikky muller∗∗1, gopala krishna', 'anumanchipalli∗∗1', 'university of california, berkeley']
nguyen24b_interspeech	['institute for infocomm research (i2r), a*star, singapore', 'industrial university of ho chi minh city, vietnam']
li24ca_interspeech	['laboratoire de phonetique et phonologie (cnrs & sorbonne nouvelle, paris, france)', 'laboratoire parole et langage (cnrs & universite aix-marseille, aix-en-provence, france)']
noroozi24_interspeech	['nvidia, usa']
dang24b_interspeech	['graduate school of informatics, nagoya university', 'school of informatics, daido university', 'department of neurology, nagoya university graduate school of medicine', 'department of health science, faculty of psychological and physical science, aichi gakuin university', 'department of neurosurgery, nagoya university graduate school of medicine', 'department of clinical research education, nagoya university graduate school of medicine']
li24da_interspeech	['♠laboratory of speech and intelligent information processing, institute of acoustics, cas, china', '† university of chinese academy of sciences, china']
mehta24b_interspeech	['speech, music and hearing, kth royal institute of technology, sweden', 'independent researcher']
sun24d_interspeech	['graduate school of engineering, the university of tokyo']
li24ea_interspeech	['dolby laboratories', 'school of information science and engineering, southeast university, china']
udupa24_interspeech	['electrical engineering department, indian institute of science (iisc), bangalore-560012, india', 'navana tech (nt), mumbai-400001, india']
galvez24_interspeech	['nvidia, usa', 'university of london, uk']
weirich24_interspeech	['friedrich-schiller-university, jena', 'leibniz center for general linguistics, berlin']
eungi24_interspeech	['grad. school of artificial intelligence and 2dept. of electrical engineering, postech, korea', 'ensc, bordeaux inp, france', 'krafton, korea', 'inst. for convergence research and education in advanced technology, yonsei university, korea']
chen24r_interspeech	['university of science and technology of china, hefei, china', 'anhui provincial hospital, hefei, china']
wan24b_interspeech	['wang∗1,2', 'cas key laboratory of behavioral science, institute of psychology', 'department of psychology,', 'university of the chinese academy of sciences', 'beijing union university', ' jiangsu university of', 'science and technology', 'university of science and technology of china']
shen24c_interspeech	['aix marseille univ, cnrs, lpl, aix-en-provence, france', 'institute for language, communication and the brain, aix marseille university, france']
shu24_interspeech	['tianjin key laboratory of cognitive computing and application, tianjin university, china', 'baidu, inc., china 3kyoto university, japan 4huiyan technology (tianjin) co., ltd, china', 'shenzhen institute of advanced technolog, chinese academy science, china']
chen24s_interspeech	['beijing institute of computer technology and application']
kye24_interspeech	['university of washington']
song24c_interspeech	['national university of singapore, singapore', 'school of data science, shenzhen research institute of big data,', 'the chinese university of hong kong, shenzhen, guangdong', ', p.r. china']
li24fa_interspeech	['school of foreign studies, nanjing university of science and technology, china', 'department of language science and technology, universitat des saarlandes, germany']
meyer24_interspeech	['institute for natural language processing, university of stuttgart, germany']
wang24ba_interspeech	['dept. of systems engineering & engineering management, the chinese university of hong kong', 'stanley ho big data decision analytics research centre, the chinese university of hong kong', 'department of psychology, the chinese university of hong kong', '∗equal contributions']
gu24b_interspeech	['school of computer science and technology, harbin institute of technology, harbin, china']
haider24_interspeech	['acoustics research institute, austrian academy of sciences, austria', 'nantes universite, ecole centrale nantes, cnrs, ls2n, france', 'university of vienna, faculty of mathematics, austria']
sheikh24_interspeech	['mohamed bin zayed university of artificial intelligence, abu dhabi, united arab emirates']
coulange24_interspeech	['laboratory of linguistics and didactics of foreign and mother tongues (lidilem), university grenoble alpes, france', 'cnrs, institute of engineering, grenoble computer science laboratory (lig), university grenoble alpes, france', 'spoken language processing laboratory (slpl), doshisha university, japan']
mogridge24_interspeech	['speech and hearing group, dept. of computer science, university of sheffield, uk']
lim24_interspeech	['university of seoul, republic of korea']
he24_interspeech	['graduate school of informatics, nagoya university, japan', 'information technology center, nagoya university, japan']
fang24_interspeech	['institute of linguistics, chinese academy of social sciences']
gothi24_interspeech	['centre for machine intelligence and data science, iit bombay', 'department of electrical engineering, iit bombay']
xie24c_interspeech	['school of ece, peking university, china']
hao24_interspeech	['china mobile research institute, beijing, china']
omine24_interspeech	['kyushu university, japan']
leung24_interspeech	['speech and hearing (spandh), dept. of computer science, the university of sheffield, uk']
moussa24_interspeech	['it security infrastructures lab, friedrich-alexander university of erlangen-nurnberg, germany']
hao24b_interspeech	['china mobile research institute, beijing, china']
li24ga_interspeech	['key laboratory of urban land resources monitoring and simulation,', 'ministry of natural resources, china', 'department of electrical and electronic engineering,', 'southern university of science and technology, shenzhen, china', 'college of computer science, inner mongolia university, china']
monteiro24_interspeech	['priberam, alameda d afonso henriques 41', '-123 lisboa, portugal']
wesolek24_interspeech	['leibniz-centre general linguistics, germany 2 humboldt-universitat zu berlin, germany', 'university of wroclaw, poland']
gudmalwar24_interspeech	['sony research india pvt. ltd., bangalore, india', 'indraprastha institute of information technology (iiit), delhi, india']
vegarodriguez24_interspeech	['univ. grenoble alpes, cnrs, grenoble inp, gipsa-lab', ' grenoble, france', 'brasilia university, brasilia, brazil.']
yoon24b_interspeech	['yonsei university, republic of korea', 'hyundai, republic of korea']
xu24e_interspeech	['moe key lab of artificial intelligence x-lance lab, shanghai jiao tong university, china', 'centre for vision, speech and signal processing (cvssp), university of surrey, uk']
wang24ca_interspeech	['liu1, yongwei li1, jianhua tao4,5, xin qi1,2, yi lu1,2, shuchen shi6', 'institute of automation, chinese academy of sciences 2school of artificial intelligence, university of chinese academy of', 'sciences 3 school of information and communication engineering, communication university of china 4 department of', 'automation, tsinghua university 5 beijing national research center for information science and technology, tsinghua university', 'shanghai polytechnic university']
shi24d_interspeech	['university of science and technology of china, hefei, china']
xu24f_interspeech	['moe key lab of artificial intelligence x-lance lab, shanghai jiao tong university, china', 'institute of intelligent computing, alibaba group, china']
sahipjohn24_interspeech	['sony research india pvt. ltd., bangalore, india', 'indraprastha institute of information technology (iiit), delhi, india']
xie24d_interspeech	['moe key lab of artificial intelligence x-lance lab,', 'department of computer science and engineering ai institute,', 'shanghai jiao tong university, shanghai, china']
kinnunen24_interspeech	['university of eastern finland, finland', 'university of oulu, finland', 'national institute of informatics, japan']
shi24e_interspeech	['school of computer science and technology, harbin institute of technology, china', 'center for speech and language technologies, bnrist, tsinghua university, china', 'school of artificial intelligence, beijing university of posts and telecommunications, china', 'huawei technologies co., ltd. china', '∗corresponding authors:']
yusuf24b_interspeech	['bogazici university, turkey']
liu24k_interspeech	['department of electronic engineering, the chinese university of hong kong', 'gvoice, tencent']
xu24g_interspeech	['department of systems engineering and engineering management,', 'the chinese university of hong kong, hong kong sar, china', 'centre for perceptual and interactive intelligence (cpii) limited, hksar, china']
schubert24_interspeech	['mobile dialog systems, iikt, otto von guericke university, magdeburg, germany', 'leibniz-centre general linguistics (zas), germany']
kim24p_interspeech	['korea electronics technology institute, south korea']
hodoshima24_interspeech	['department of information and telecommunication engineering, tokai university']
behera24_interspeech	['reliance jio aicoe, hyderabad, india']
ge24_interspeech	['school of communication and information engineering, nanjing university of posts and telecommunications, p r. china', 'chi – chair of health informatics, mri, technische universitat munchen, germany', 'glam – group on language, audio, & music, imperial college london, u k.']
li24ha_interspeech	['moe key lab of artificial intelligence x-lance lab', 'shanghai jiao tong university, shanghai, china', 'institute of intelligent computing, alibaba group, china']
miodonska24_interspeech	"['faculty of biomedical engineering, silesian university of technology, zabrze, poland', ""medical facility 'therapy' – center for health and human development, ruda sl ˛aska, poland""]"
hu24e_interspeech	['college of information science and engineering, xinjiang university, urumqi, china', 'department of electronic engineering, tsinghua university, beijing, china', 'key laboratory of signal detection and processing, xinjiang, urumqi, china']
seong24b_interspeech	['department of electronic engineering, hanyang university, seoul, republic of korea', 'department of artificial intelligence application, hanyang university, seoul, republic of korea']
zhao24g_interspeech	['college of computer and information engineering, tianjin normal university, tianjin, china', 'college of computer science, zhejiang university, china', 'chair of embedded intelligence for health care and wellbeing, university of augsburg, germany', 'glam – group on language, audio, & music, imperial college london, uk']
maji24_interspeech	['rekhi centre of excellence for the science of happiness, iit kharagpur, india', 'department of electrical engineering', 'b c roy technology hospital, iit kharagpur, india']
hao24c_interspeech	['university of groningen, the netherlands']
liu24l_interspeech	['department of electronic engineering, the chinese university of hong kong', 'gvoice, tencent']
mohapatra24b_interspeech	['department of electrical and computer engineering, university of british columbia, canada', 'college of arts, media and design, northeastern university, boston, usa']
bandekar24_interspeech	['electrical engineering department, indian institute of science (iisc), bangalore-560012, india']
si24_interspeech	['school of electronic and information engineering, south china university of technology,', 'guangzhou, china']
rabatin24_interspeech	['meta, usa']
dong24_interspeech	['zhou1,2', 'faculty of information engineering and automation, kunming university of science and', 'technology, china 2yunnan key laboratory of artificial intelligence, china']
jiang24c_interspeech	['qian2, jia liu1,3, pingyi fan1,∗', 'tsinghua university, china 2shanghai jiao tong university, china', 'huakong ai plus, china']
manhtienanh24_interspeech	['vinbigdata, vietnam', 'hanoi university of science and technology, vietnam']
taylor24_interspeech	['department of language and linguistic science, university of york, york, uk', 'audiolab, school of physics, engineering and technology, university of york, york, uk']
zhang24m_interspeech	"[""northwestern polytechnical university, xi'an, china"", 'bytedance, china']"
shi24f_interspeech	['qi2,6, xuefei liu2, yukun liu6, yongwei li2, zhiyong wang2,6, xiaopeng wang2,6', 'school of computer and information engineering, institute for artificial intelligence, shanghai polytechnic university', 'institute of automation, chinese academy of sciences 3department of automation, tsinghua university', 'beijing national research center for information science and technology, tsinghua university 5tianjin university', 'school of artificial intelligence, university of chinese academy of sciences']
wu24l_interspeech	['department of system engineering and engineering management,', 'the chinese university of hong kong, hksar, china', 'centre for perceptual and interactive intelligence limited, hksar, china']
hojo24_interspeech	['toyohashi university of technology, japan', 'national insitute of technology, anan college, japan', 'nippon telegraph and telephone corporation, japan']
wells24_interspeech	['the centre for speech technology research, university of edinburgh, united kingdom', 'national institute of informatics, japan 3national research council canada, canada']
vinnikov24_interspeech	['microsoft']
li24ia_interspeech	['department of electronic engineering, tsinghua university, beijing 100084, china']
cai24b_interspeech	['shenzhen international graduate school, tsinghua university, shenzhen, china', 'the chinese unviersity of hong kong, hong kong sar, china', 'peng cheng lab, shenzhen, china']
sungbin24_interspeech	['dept. of electrical engineering and 2grad. school of artificial intelligence, postech, korea', 'krafton, korea', 'institute for convergence research and education in advanced technology, yonsei university, korea']
wang24da_interspeech	['kunming university of science and technology, china', 'yunnan key laboratory of artificial intelligence, china']
kim24q_interspeech	"['sogang univ.', 'hallym univ.', ""sungshin women's univ., republic of korea,"", 'university of wisconsin-madison, wi, usa']"
chien24c_interspeech	['inst. of electrical and computer engr., national yang ming chiao tung university, taiwan', 'dept. of electrical and electronic engr., hong kong polytechnic university, hong kong sar']
li24ja_interspeech	['school of computer science and technology, xinjiang university, urumqi, china', 'xinjiang key laboratory of multi-lingual information technology, urumqi, china', 'department of electronic engineering, tsinghua university, beijing, china']
wu24m_interspeech	['university of tsukuba, japan']
luz24_interspeech	['usher institute, medical school', 'school of health in social science', 'school of engineering, university of edinburgh, uk', 'department of psychology, carnegie mellon university', 'communication sciences & disorders, university of delaware, usa', 'miin wu school of computing national cheng kung university', 'department of neurology, cardinal tien hospital, taipei, taiwan']
lee24j_interspeech	['hanyang university, seoul, republic of korea', 'department of electronic engineering', 'department of artificial intelligence application']
wang24ea_interspeech	['department of electronic engineering, tsinghua university, beijing 100084, china', 'international school, jinan university, guangzhou', ', china', 'beijing sinovoice technology co.,ltd, china']
goel24_interspeech	['sbilab, indraprastha institute of information technology delhi (iiit-d), india', 'mirae ai systems pvt. ltd.']
kim24r_interspeech	['department of electronic engineering, hanyang university, seoul, republic of korea']
meghanani24_interspeech	['speech and hearing research group', 'department of computer science, the university of sheffield, united kingdom']
latif24_interspeech	['trusted networks lab, queensland university of technology, australia', 'glam – group on language, audio, & music, imperial college london, uk', 'chi – chair of health informatics, mri, techincal university of munich, germany']
yoon24c_interspeech	['korea advanced institute of science and technology (kaist), republic of korea', 'university of illinois at urbana-champaign, usa']
paraskevopoulos24_interspeech	['institute for speech and language processing, athena research center, athens, greece']
zhang24n_interspeech	['the university of new south wales, australia', 'national university of singapore, singapore', 'sds, sribd, the chinese university of hong kong, shenzhen, china', 'astri, hong kong', 'university of science and technology beijing, china']
kalluri24_interspeech	['vijayasenan2, sriram ganapathy1', 'leap lab, electrical engineering, iisc, bangalore', 'department of e&c, nitk, surathkal', 'iiit', 'dharwad', 'iit dharwad, india.']
freixes24_interspeech	['alias-pujol', 'her - human-environment research, c/sant joan de la salle', '', ' barcelona - la salle - url']
gao24e_interspeech	['shenzhen international graduate school, tsinghua university, shenzhen, china', 'kunlun skywork technology co., beijing, china', 'peng cheng lab, shenzhen, china']
wang24fa_interspeech	['shenzhen research institute of big data', 'school of data science,', 'the chinese university of hong kong, shenzhen (cuhk-shenzhen), guangdong, china', 'auditory cognition and computational acoustics lab, shanghai jiao tong university, shanghai, china', 'tencent ai lab, shenzhen,guangdong, china', ' wenet open source community']
yang24n_interspeech	['laboratoire de phonetique et phonologie (cnrs & sorbonne nouvelle), paris']
guan24b_interspeech	['school of informatics, xiamen university, china', 'school of electronic science and engineering, xiamen university, china', 'graduate school of informatics, kyoto university, japan', 'kuaishou technology, china', 'nankai university, china']
wang24ga_interspeech	['institute of automation, chinese academy of sciences 2 school of artificial intelligence, university of chinese academy of', 'sciences 3 school of information and communication engineering, communication university of china 4 department of', 'automation, tsinghua university 5 beijing national research center for information science and technology, tsinghua university', 'shanghai polytechnic university']
chen24t_interspeech	['the chinese university of hong kong, hong kong sar, china', 'shenzhen international graduate school, tsinghua university, shenzhen, china', 'vocal engineering technologies limited, hong kong sar, china']
chen24u_interspeech	"[""northwestern polytechnical university, xi'an, china"", 'du xiaoman financial, china']"
pelloin24_interspeech	['french national institute of audiovisual (ina), paris, france', 'french digital communication regulatory authority (arcom), paris, france']
zhou24e_interspeech	['vonk4, zoe ezzes4, zachary miller4, maria tempini4, jiachen lian2†, gopala anumanchipalli2†', 'zhejiang university, china', 'university of california, berkeley', 'harvard university', 'university of california, san francisco']
ning24_interspeech	"[""northwestern polytechnical university, xi'an, china"", 'fuxi ai lab, netease inc., hangzhou, china', 'shenzhen research institute of big data,', 'the chinese university of hong kong, shenzhen (cuhk-shenzhen), china']"
huang24h_interspeech	['mavlyutov3, sravya popuri3', 'national taiwan university,', 'the chinese university of hong kong', 'ai at meta']
guo24d_interspeech	"[""northwestern polytechnical university, xi'an, china"", 'school of data science, the chinese university of hong kong,', 'shenzhen (cuhk-shenzhen), china']"
zhao24h_interspeech	['bytedance inc. 2peking university, china']
yang24o_interspeech	['wang1,2,∗', 'shenzhen institute of advanced technology, chinese academy of sciences, china', 'guangdong-hong kong-macao joint laboratory of human-machine intelligence-synergy', 'systems, china', 'division of speech and hearing sciences, university of hong kong, china', 'department of rehabilitation medicine, the eighth affiliated hospital of sun yat-sen university,', 'china']
lu24d_interspeech	['feng-chia university artificial intelligence research center, taichung', 'department of information engineering and computer science, feng-chia university, taichung']
kunmei24_interspeech	['national university of singapore']
li24ka_interspeech	['huawei translation services center']
choi24d_interspeech	['department of electronic engineering', 'hanyang university, seoul, republic of korea']
lee24k_interspeech	['hanyang university, seoul, republic of korea,', 'department of electronics engineering1, department of artificial intelligence application2']
chang24b_interspeech	['watanabe1, yossi adi2, xie chen3, qin jin4', 'carnegie mellon university, usa', 'the hebrew university of jerusalem, israel', 'shanghai jiao tong university, china', 'renmin university of china, china']
su24_interspeech	['xiaomi inc., beijing, china', 'shenzhen international graduate school, tsinghua university, china']
lin24k_interspeech	['institute of linguistics, academia sinica', 'national taiwan university']
wang24ha_interspeech	['nerc-slip, university of science and technology of china (ustc), china', 'department of electrical and electronic engineering, the hong kong polytechnic university,', 'hong kong']
li24la_interspeech	['institute of artificial intelligence, xiamen university, china', 'school of electronic science and engineering, xiamen university, china', 'school of informatics, xiamen university, china']
feng24c_interspeech	['korea advanced institute of science and technology, south korea']
zou24_interspeech	['ping an technology', 'coupang', 'georgia institute of technology']
watanabe24_interspeech	['graduate school of informatics, nagoya university, japan', 'information technology center, nagoya university, japan']
cui24_interspeech	['department of electronic engineering, tsinghua university, china', 'vanke school of public health, tsinghua university, china', 'institute for healthy china, tsinghua university, china', 'cambridge university engineering department, uk']
yeh24_interspeech	['inst. of electrical and computer engineering, national yang ming chiao tung university, taiwan']
aimaiti24_interspeech	['silamu1,2∗', 'school of computer science and engineering, xinjiang university, urumqi, china', 'xinjiang key laboratory of multi-lingual information technology, urumqi, china']
baskar24_interspeech	['google inc., usa']
kadkhodaieelyaderani24_interspeech	['solventum health information systems, usa', 'solventum health information systems, ireland']
geng24_interspeech	['school of foreign languages tianjin university']
lai24b_interspeech	['school of computer science and technology, xinjiang university, urumqi, china', 'xinjiang key laboratory of multi-lingual information technology, urumqi, china', 'school of cyber security, guangdong polytechnic normal university, guangzhou, china']
zhao24i_interspeech	['laboratory of language sciences, peking university, china', 'department of chinese language and literature, peking university, china']
ghosh24b_interspeech	['university of maryland, college park, usa']
doukhan24_interspeech	['lepape2, geraldine van hille2, cecile meadel3, marlene coulomb-gully4', 'ina, france 2arcom, france 3carism, france 4lerass, france']
gaur24_interspeech	['ramabhadran', 'google, u.s.a']
rameau24_interspeech	['belisle-pipon5, vardit ravitsky6, maria powell7, alistair johnson8, david dorr9, philip', 'payne10, micah boyer11, stephanie watts11, ruth bahr12, frank rudzick13, jordan-lerner-', 'ellis14, shaheen awan15, don bolser16, bridge2ai-voice consortium, yael bensoussan11', 'department of otolaryngology-head and neck surgery, weill cornell medicine, new york,', 'new york, usa', 'mcgovern institute, massachusetts institute of technology, boston, massachusetts, usa', 'institute for computational biomedicine, weill cornell medicine, new york, new york,', 'usa', 'englander institute for precision medicine, weill cornell medicine, new york, new york,', 'usa', 'faculty of health sciences, simon-fraser university, vancouver, british columbia, canada', 'hasting center, garrison, new york, usa', 'department of otolaryngology-head & neck surgery, vanderbilt university medical center,', 'nashville, tennessee, usa', 'division of biostatistics, hospital for sick children, toronto, ontario, canada', 'department of medical informatics, school of medicine, oregon health & science', 'university, portland, oregon, usa', 'institute for informatics, washington university in st louis, st louis, missouri, usa', 'department of otolaryngology- head & neck surgery, university of south', 'florida, tampa, florida, usa. 12 department of communication sciences &', 'disorders, university of south florida, tampa, florida, usa. 13faculty of', 'computer science, dalhousie university, calgary, manitoba canada', 'department of laboratory medicine and pathobiology, university of toronto, toronto,', 'ontario, canada', 'department of communication sciences & disorders, university of central florida, orlando,', 'florida, usa', '. department of physiological sciences, university of florida, gainesville, florida, usa', 'interspeech 2024', '-5 september 2024, kos, greece', '.21437/interspeech.2024-1926']
zhang24o_interspeech	['department of electronic engineering, shanghai jiao tong university, shanghai, china', 'tencent video cloud, shanghai, china']
chang24c_interspeech	['graduate institute of communication engineering, national taiwan university, taiwan', 'department of electrical engineering, national taiwan university, taiwan', 'meta ai, usa']
kato24_interspeech	['ricoh, japan']
niu24b_interspeech	['school of computer science and technology, xinjiang university, urumqi 830017, china', 'xinjiang key laboratory of signal detection and processing, urumqi 830017, china', 'department of electronic engineering, tsinghua university, beijing 100084, china']
tian24_interspeech	['carnegie mellon university, usa', 'toyota technological institute at chicago, usa']
zaheera24_interspeech	['national institute of technology patna, india', 'indian institute of information technology dharwad, india']
niu24c_interspeech	['east china university of science and technology, china']
qi24_interspeech	['key laboratory of child development and learning science (southeast university),', 'ministry of education, nanjing 210096, china', 'school of biological science and medical engineering, southeast university, china']
wang24ia_interspeech	['key laboratory of child development and learning science of ministry of education, school of', 'biological science and medical engineering, southeast university, china']
lu24e_interspeech	['key laboratory of child development and learning science of ministry of education, southeast', 'university, china 2glam - the group on language, audio, & music, imperial college london, uk']
bitterman24_interspeech	['orcam technologies ltd, israel', 'bar ilan university, israel', 'yale university, usa']
xu24h_interspeech	['northwestern polytechnical university, xi”an, china', 'alibaba group, china']
wang24ja_interspeech	['key laboratory of child development and learning science of ministry of education, school of', 'biological science and medical engineering, southeast university, china']
schwartz24_interspeech	['bar-ilan university, israel']
li24ma_interspeech	['campus fryslˆan, university of groningen, the netherlands', 'center for language and cognition, university of groningen, the netherlands']
papadimitriou24_interspeech	['department of electrical & computer engineering, university of thessaly, volos, greece']
udupa24b_interspeech	['spire lab, electrical engineering, indian institute of science, india', 'carnegie mellon university, usa']
zheng24c_interspeech	['university of illinois urbana-champaign', 'department of electrical and computer engineering']
birkholz24_interspeech	['institute of acoustics and speech communication, tu dresden, germany']
le24_interspeech	['zalo ai, vietnam', 'university of science, vietnam', 'vietnam national university, ho chi minh city']
hoang24b_interspeech	['hanoi university of science and technology, vietnam']
tran24b_interspeech	['trang nguyen1', 'hanoi university of science and technology, vietnam', 'naver corporation, korea']
yadav24b_interspeech	['indraprastha institute of information technology (iiit) delhi, india', 'microsoft research']
nilsson24_interspeech	['zenke1,4', 'friedrich miescher institute for biomedical research, switzerland', 'gn audio, denmark,', 'technical university of denmark, denmark', 'university of basel, switzerland, ∗equal contributions']
sigurgeirsson24_interspeech	['∗, eddie l ungless', '†', '∗the centre for speech technology research, university of edinburgh, scotland', '†school of informatics, university of edinburgh, scotland']
ibrahim24_interspeech	['abdul-mageed1,2,4', 'mohamed bin zayed university of artificial intelligence, uae', 'invertible ai, uae', 'idiap,', 'switzerland', 'university of british columbia, canada']
blatt24_interspeech	['saarland university, saarland informatics campus, germany']
li24na_interspeech	['shenzhen international graduate school, tsinghua university, shenzhen, china', 'tencent, shenzhen, china', 'the chinese university of hong kong, hong kong sar, china']
raybarman24_interspeech	['centre for linguistic science & technology', 'department of humanities & social sciences,', 'mehta family school of data science & artificial intelligence', 'indian institute of technology guwahati, guwahati-781039, india']
phukan24_interspeech	['narayani2, arun balaji buduru1, rajesh sharma1,3', 'iiit-delhi, india', 'reliance jio aicoe, hyderabad, india', 'university of tartu, estonia', '*equal contribution']
wu24n_interspeech	['georgia institute of technology, usa', 'stony brook university, usa']
yang24q_interspeech	['supertone inc., republic of korea', 'elevenlabs inc., usa']
liu24m_interspeech	['institute for infocomm research (i2r), agency for science, technology and research (a⋆star), singapore', 'department of electrical and computer engineering, national university of singapore, singapore', 'national institute of informatics, tokyo, japan', 'fortemedia singapore, singapore', 'school of data science, shenzhen research institute of big data, the chinese university of hong kong, shenzhen, china']
pistor24_interspeech	['university of bern, switzerland']
chaudhary24b_interspeech	['infosys centre for ai & department of cse, iiit delhi, india']
casanova24_interspeech	['nvidia', ' coqui.ai', ' cantina.ai', ' voize gmbh']
chen24v_interspeech	['college of computer science, inner mongolia university, china', 'inner mongolia key laboratory of mongolian information processing technology']
kulshreshtha24_interspeech	['aws ai labs, usa']
vitale24_interspeech	['dieti, university of naples federico ii, italy', 'faculty of education - free university of bozen, italy', 'interdepartmental research center urban/eco, university of naples federico ii, italy']
favaro24_interspeech	['department of electrical and computer engineering, the johns hopkins university, baltimore, md,', 'usa']
sasindran24_interspeech	['department of electronic systems engineering', 'indian institute of science, bengaluru, india']
kc24_interspeech	['government engineering college barton hill, india', 'college of engineering trivandrum, india', 'apj abdul kalam technological university, india']
gudmundsson24_interspeech	['centre for industrial electronics, university of southern denmark, sonderborg, denmark', 'centre for languages and literature, lund university, lund, sweden', 'haskins labs, yale university, new haven, usa']
jakhar24_interspeech	['samsung research, bangalore']
english24_interspeech	['sfi centre for research training in digitally-enhanced reality (d-real), ireland', 'adapt', 'research centre, school of computer science, university college dublin, ireland', 'adapt', 'research centre, school of computer science and statistics, trinity college dublin, ireland']
deoliveira24_interspeech	['universitat hamburg, signal processing']
kelley24_interspeech	['ensta paris, ip paris, france,', 'center for advanced intelligence project, riken, japan,', 'ltci, telecom paris, ip paris, france,', 'graduate school of engineering, kyoto university, japan,']
maurya24_interspeech	['the centre for speech technology research, university of edinburgh, united kingdom']
stafylakis24_interspeech	['athens university of economics and business, greece', 'omilia - conversational intelligence, athens, greece']
loiacono24_interspeech	"['university of turin, italy 2university of granada, spain', ""lfsag - laboratorio di fonetica sperimentale 'arturo genre', university of turin, italy""]"
ng24_interspeech	['arizona state university, usa', 'university of wisconsin-madison, usa']
nishihara24_interspeech	['department of computer science, nagoya institute of technology, japan', 'the centre for speech technology research, university of edinburgh, united kingdom', 'national research council canada, canada']
ebbers24_interspeech	['mitsubishi electric research laboratories, cambridge, ma, usa']
nafea24_interspeech	['nakov1', 'mohamed bin zayed university of artificial intelligence, uae', 'invertible ai']
khokhlov24_interspeech	['speech technology center, saint petersburg, russia']
deluca24_interspeech	['linguistic research infrastructure (liri), university of zurich, switzerland', 'department of computational linguistics, university of zurich, switzerland']
wu24o_interspeech	['department of electrical and computer engineering, university of british columbia, canada']
cronenberg24_interspeech	['universite paris cite, france', 'cnrs, universite paris-saclay, laboratoire interdisciplinaire des sciences du numerique, france']
gusev24_interspeech	['fluentaai, wilmington, usa']
wu24p_interspeech	['speech processing and machine learning laboratory, national taiwan university', 'graduate institute of communication engineering, national taiwan university']
coffey24_interspeech	['psl university, laboratoire de sciences cognitives et de psycholinguistique (ens, ehess,', 'cnrs, dec), france', 'tampere university, unit of computing sciences, finland', 'university of zurich, institute of evolutionary medicine (iem), switzerland']
murzaku24_interspeech	['stony brook university, usa', 'department of computer science', 'department of linguistics', 'institute for advanced computational science']
wagner24_interspeech	['technische hochschule nurnberg georg simon ohm', 'intel labs']
tapo24_interspeech	['rochester institute of technology, usa', 'boston college, usa', 'university of florida, usa']
abdullah24_interspeech	['language science and technology, saarland university, germany', 'saarland informatics campus, germany']
liu24n_interspeech	"[""northwestern polytechnical university, xi'an, china"", 'bytedance, china']"
pereztoro24_interspeech	['schuster4, elmar noth1, juan rafael orozco-arroyave1,2, andreas maier1', 'pattern recognition lab. friedrich-alexander-universitat erlangen-nurnberg, germany', 'gita lab, faculty of engineering. universidad de antioquia, medellin, colombia', 'speech & language processing lab. friedrich-alexander-universitat erlangen-nurnberg, germany', 'department of otorhinolaryngology, head and neck surgery. ludwig-maximilians university, munich, germany']
yakovlev24_interspeech	['id r&d inc., new york, usa']
maciejewski24_interspeech	['hltcoe and 2clsp, johns hopkins university, usa']
wagner24b_interspeech	['technische hochschule nurnberg georg simon ohm', 'friedrich-alexander-universitat erlangen-nurnberg', 'intel labs']
omahony24_interspeech	['university of edinburgh, uk', 'kth royal institute of technology, stockholm, sweden']
xu24i_interspeech	['university of illinois urbana-champaign, il, usa', 'reality labs research at meta, wa, usa']
baumann24_interspeech	['technische hochschule nurnberg georg simon ohm, germany', 'intel labs, germany']
zhong24c_interspeech	['tang2, fengjie zhu2', 'the centre for speech technology research, university of edinburgh, united kingdom', 'department of ai technology, transsion, china']
baumann24b_interspeech	['elmar n¨oth3, tobias bocklet1,4', 'technische hochschule nurnberg, germany', 'ludwig-maximilians university, germany', 'friedrich-alexander-universitat erlangen-nurnberg, germany', 'intel labs, germany']
mousavi24_interspeech	['subakan6,2,1, mirco ravanelli1,2,5', 'concordia university, canada 2mila - quebec ai institute, canada 3avignon universite, france', 'telecom paris, france 5universite de montreal, canada 6universite laval, canada']
woszczyk24_interspeech	['imperial college london, uk', 'taibah university, saudi arabia']
nguyen24c_interspeech	['department of computer science, university of oregon, usa 2aws ai labs, usa 3zoom, usa', 'amazon agi, usa']
elbanna24_interspeech	['speech and hearing bioscience and technology, harvard medical school, ma, usa', 'idiap research institute, martigny, switzerland', 'ecole polytechnique federale de lausanne, switzerland']
kwon24_interspeech	"['department of speech, language, and hearing sciences, the university of texas at austin, usa', 'department of neurology, dell medical school, the university of texas at austin, usa', 'department of computer science, the university of texas at austin, usa', ""jack h miller magnetoencephalography center, helen devos children's medical center, usa""]"
li24oa_interspeech	['toronto metropolitan university, canada', 'shenzhen key laboratory of ubiquitous data enabling, tsinghua shenzhen international graduate', 'school, tsinghua university, china']
mihajlik24_interspeech	['dept. of telecommunications and media informatics, budapest university of technology and', 'economics', 'hun-ren hungarian research centre for linguistics, hungary', 'signal processing and speech communication laboratory, graz university of technology, austria']
looney24_interspeech	['pindrop inc. london, uk']
pandey24_interspeech	['meta platforms inc., usa']
mumtaz24_interspeech	['university of konstanz, germany']
huang24i_interspeech	['university of southern california, usa']
yuan24_interspeech	['carnegie mellon university, united states']
sayeed24_interspeech	['mohamed bin zayed university of artificial intelligence']
sanguedolce24_interspeech	['department of computing, imperial college london, uk', 'department of electrical and electronic engineering, imperial college london, uk', 'department of brain sciences, imperial college london, uk', 'imperial college healthcare nhs trust, london, uk']
yarga24_interspeech	['department of electrical and computer engineering, universite de sherbrooke, sherbrooke, qc,', 'canada']
wang24ka_interspeech	['moro-velazquez2,3', 'dept. of applied mathematics and statistics, the johns hopkins university, baltimore, usa 2 dept.', 'of electrical and computer engineering, the johns hopkins university, baltimore, usa 3 center for', 'language and speech processing, the johns hopkins university, baltimore, usa']
prasad24_interspeech	['idiap research institute, martigny, switzerland', 'brno university of technology, brno, czech republic', 'armasuisse science and technology, thun, switzerland']
kim24s_interspeech	['asapp, usa', 'toyota technological institute at chicago, usa', 'carnegie mellon university, usa']
lee24l_interspeech	['university of pennsylvania', 'university of potsdam']
fan24c_interspeech	['stanford university, usa', 'howard hughes medical institute at stanford university, usa']
ortiztandazo24_interspeech	['ens, psl research university, ehess, cnrs, france', 'univ. grenoble alpes, cnrs, grenoble inp, gipsa-lab, france', 'aix-marseille univ., cnrs, lis, france', 'meta ai']
srivastava24_interspeech	['university of chicago 2 carnegie mellon university']
meyer24b_interspeech	['eth zurich', 'disney entertainment and espn technology', 'disneyresearch|studios']
morozova24_interspeech	['department of comparative language science, university of zurich, switzerland', 'institute of work and organizational psychology (ipto), university of neuchâtel, switzerland', 'center for the interdisciplinary study of language evolution (isle), university of zurich']
escobargrisales24_interspeech	['elmar n¨oth2, tobias bocklet3, adolfo m garcia4, juan rafael orozco-arroyave1,2', 'gita lab, faculty of engineering, university of antioquia udea, medellin, colombia', 'pattern recognition lab. friedrich-alexander universitat, erlangen, germany', 'technische hochschule nurnberg georg simon ohm, nuremberg, germany', 'cognitive neuroscience center, universidad de san andres, buenos aires, argentina']
fathan24_interspeech	['computer research institute of montreal (crim)', 'montreal, canada']
krishnan24_interspeech	['spoken language systems group, saarland university, germany']
zheng24d_interspeech	['cambridge university engineering dept., trumpington st., cambridge, cb2 1pz u.k', 'department of electronic engineering, tsinghua university']
reitsema24_interspeech	['leiden university centre for linguistics, leiden university, the netherlands', 'university of amsterdam, the netherlands']
kang24d_interspeech	['massachusetts institute of technology']
li24pa_interspeech	['department of electrical and computer engineering, university of rochester, rochester, ny, usa', 'department of computer science, university of rochester, rochester, ny, usa']
shahin24_interspeech	['the university of new south wales, sydney, new south wales, australia']
takagi24_interspeech	['toyohashi university of technology, japan', 'nippon telegraph and telephone, japan']
jain24_interspeech	['university of california, berkeley, united states']
premananth24_interspeech	['university of maryland college park, usa', 'university of maryland school of medicine, usa']
phukan24b_interspeech	['iiit-delhi, india,', 'university of tartu, estonia']
lovelace24_interspeech	['cornell university, usa', 'asapp inc., usa', 'character ai, usa']
ariasvergara24_interspeech	['pattern recognition lab. friedrich-alexander university, erlangen, germany,', 'massachusetts general hospital - harvard medical school, boston, ma, usa,', 'department of radiology and biomedical imaging, yale university, new haven, ct, usa', 'university of maryland, baltimore, md, usa,', 'johns hopkins university, baltimore, md, usa,', 'department of otorhinolaryngology, ludwig-maximilians university, munich, germany']
kodali24_interspeech	['department of information and communications engineering, aalto university, finland.', 'signal analysis and interpretation laboratory (sail), university of southern california, usa.']
kadambi24_interspeech	['arizona state university, usa', 'university of wisconsin-madison, usa']
xu24j_interspeech	['university of york, uk', 'university of oxford, uk', 'oxford wave research, uk', 'netherlands forensic institute, netherlands']
zang24_interspeech	['university of rochester, rochester, ny, usa 2carnegie mellon university, pittsburgh, pa, usa', 'nagoya university, nagoya, japan 4renmin university of china 5timedomain.ai, beijing, china']
liu24o_interspeech	['center for robust speech systems (crss), the university of texas at dallas, usa']
mujtaba24_interspeech	['michigan state university', 'friends: the national association of young people who stutter']
chan24_interspeech	['department of linguistics, university of pennsylvania, usa']
shi24g_interspeech	['carnegie mellon university', ' national taiwan university', ' stanford university,', 'toyota technological institute at chicago']
leduc24_interspeech	['university of toronto, canada 2university health network, canada', 'college of william and mary, united states 4university of cincinnati, united states', 'indiana state university, united states 6fpt software ai center, vietnam']
shi24h_interspeech	['carnegie mellon university', ' meta ai']
bukhari24_interspeech	['carnegie mellon university']
best24_interspeech	['universite de toulon, aix marseille universite, cnrs, lis, toulon, france']
smith24_interspeech	['mcgill university, canada']
afonja24_interspeech	['cispa helmholtz center for information security 2intron health 3universite de lorraine, cnrs, inria, loria, f-54000 nancy,', 'france 4university of minnesota - twin cities, usa 5african masters of machine intelligence, aims/ammi', 'ai saturdays lagos ∗masakhane nlp']
kumar24b_interspeech	['k. sinha4, shrikanth narayanan1, krishna s nayak1', 'university of southern california, united states 2siemens medical solutions, united states inc. 3', 'city university of new york college of staten island, new york, united states 4 keck school of', 'medicine, university of southern california, united states']
shao24_interspeech	['center for language and speech processing, johns hopkins university, baltimore, md, usa', 'tencent ai lab, bellevue, wa, usa']
kroll24_interspeech	['cisco systems, usa']
netzorg24_interspeech	"['anumanchipalli1', 'university of california, berkeley, usa', ""alyssa's voice training, usa 3sumianvoice, australia 4transvoicelessons, usa""]"
veliche24_interspeech	['meta ai, usa']
shao24b_interspeech	['khudanpur1', 'center for language and speech processing, johns hopkins university, baltimore, md, usa', 'tencent ai lab, bellevue, wa, usa', 'xiaomi corp., beijing, china']
akani24_interspeech	['aix-marseille univ, cnrs, lis umr7020, marseille, france', 'enedis, marseille, france', 'international laboratory on learning systems - ills - irl cnrs, montreal, canada']
ogun24_interspeech	['oladimeji3,∗, tejumade afonja4,5,∗, kayode olaleye6,∗, naome a etori7,∗, tosin adewumi8,∗', 'universite de lorraine, cnrs, inria, loria, f-54000 nancy, france 2intron health 3amazethu research 4cispa helmholtz', 'center for information security 5ai saturdays lagos 6data science for social impact group, university of pretoria 7university of', 'minnesota - twin cities, usa 8lulea university of technology ∗masakhane nlp']
niu24d_interspeech	['university of michigan, usa 2independent researcher']
liang24_interspeech	['the university of texas at austin, usa']
ahn24d_interspeech	['university of washington, usa', 'university of zurich, switzerland']
colgiu24_interspeech	['western university, canada', 'the city university of new york, usa', 'university of wisconsin-madison, usa']
lin24l_interspeech	['university of massachusetts boston, ma, usa', 'university of north carolina, chapel hill, nc, usa']
prajwal24_interspeech	['vgg, university of oxford']
tang24c_interspeech	['renmin university of china', ' carnegie mellon university']
changawala24_interspeech	['dalhousie university, canada', 'vector institute, canada']
puvvada24_interspeech	['dhawan, somshubra majumdar, elena rastorgueva, zhehuai chen, vitaly lavrukhin, jagadeesh', 'balam, boris ginsburg', 'nvidia, santa clara, ca, usa']
yuan24b_interspeech	['school of computer science and technology, xinjiang university, china', 'school of artificial intelligence, beijing university of posts and telecommunications, china', 'center for speech and language technologies, bnrist, tsinghua university, china', 'school of computer science and technology, harbin institute of technology, china']
wang24la_interspeech	['school of computing, national university of singapore, singapore']
heuser24_interspeech	['miller3, miguel jette3', 'university of pennsylvania, usa', 'university of oregon, usa', 'rev.com, usa']
tavernor24_interspeech	['university of michigan, usa']
kalyan24_interspeech	['iit bombay']
liu24p_interspeech	['inner mongolia university, hohhot, china 2 zhejiang university, china', 'shenzhen research institute of big data, school of data science,', 'the chinese university of hong kong, shenzhen (cuhk-shenzhen), china', 'national university of singapore, singapore']
zhang24p_interspeech	['college of computer science and technology, nanjing university of aeronautics and astronautics,', 'nanjing, china']
kim24t_interspeech	['dot inc., seoul, republic of korea', 'language technologies institute, carnegie mellon university, pittsburgh, usa']
liu24q_interspeech	['university of british columbia, canada']
tokac24_interspeech	['department of linguistics, northwestern university, evanston, il, usa']
feng24d_interspeech	['nagoya university, japan']
heuser24b_interspeech	['university of pennsylvania, usa']
delafuente24_interspeech	['stanford university']
ma24d_interspeech	"['xu1, huan zhao1, binbin zhang4, lei xie1,∗', ""school of computer science, northwestern polytechnical university, xi'an, china"", 'shenzhen research institute of big data', 'school of data science,', 'the chinese university of hong kong, shenzhen (cuhk-shenzhen), china', 'wenet open source community, china']"
dumpala24b_interspeech	['sri harsha dumpala1,2,', 'katerina dikaios3,', 'abraham nunes1,', 'frank rudzicz1,2,', 'rudolf uher1,4,', 'sageev oore1,2']
chen24w_interspeech	['college of computer science, inner mongolia university, china', 'inner mongolia key laboratory of mongolian information processing technology']
baser24_interspeech	['department of electrical and computer engineering, the university of texas at austin, usa', 'department of electrical and electronics engineering, bogazici university, turkey']
shi24i_interspeech	['nagoya university, japan', 'hainan university, china']
morrison24_interspeech	['northwestern university, us']
mcneill24_interspeech	['cuny graduate center, new york, ny, usa', 'brooklyn college, brooklyn, ny, usa']
wu24q_interspeech	['renmin university of china', ' tencent ai lab', ' carnegie mellon university,']
terhiija24_interspeech	['indian institute of technology guwahati, india']
ma24e_interspeech	"[""school of computer science, northwestern polytechnical university, xi'an, china"", 'ximalaya inc, china']"
kyung24_interspeech	['department of electronic engineering, hanyang university, seoul, republic of korea', 'department of artificial intelligence, hanyang university, seoul, republic of korea']
shechtman24_interspeech	['ibm research']
kim24u_interspeech	['seoul national university, south korea']
cheng24c_interspeech	['university of massachusetts lowell, usa']
chen24x_interspeech	['nagoya university, japan']
zhang24q_interspeech	['school of computer and communication engineering, university of science and technology beijing, beijing 100083, china', 'ustb-eeasytech joint lab of artificial intelligence, university of science and technology beijing, beijing 100083, china', 'eeasy technology company ltd., zhuhai 519000, china']
li24qa_interspeech	['moe key lab of artificial intelligence, ai institute, x-lance lab, department of computer', 'science and engineering, shanghai jiao tong university, china', 'shenzhen research institute of big data, cuhk-shenzhen, china']
javed24_interspeech	['ai4bharat, indian institute of technology madras, india']
demaere24_interspeech	['the brain in action laboratory, university of lethbridge, lethbridge, ab, canada', 'speech development lab, university of lethbridge, lethbridge, ab, canada', 'canadian center for behavioral neuroscience, university of lethbridge, lethbridge, ab, canada', 'corresponding author:']
heitkaemper24_interspeech	['google llc, u.s.a.']
lee24m_interspeech	['department of electronic engineering, hanyang university, seoul, republic of korea']
ng24b_interspeech	['university of washington, usa']
prabhu24_interspeech	['department of computer science, indian institute of technology bombay, mumbai, india', 'language technologies institute, carnegie mellon university, pittsburgh, pa, usa']
gao24f_interspeech	['graduate school of informatics, kyoto university, kyoto, japan']
duan24_interspeech	['hunan provincial key lab on bioinformatics, school of computer science and engineering,', 'central south university, changsha, china', 'xinjiang engineering research center of big data', 'and intelligent software, school of software, xinjiang university, wulumuqi, china']
kaneko24_interspeech	['ntt corporation, japan']
ryu24_interspeech	['graduate school of artificial intelligence, postech, south korea', 'department of computer science and engineering, postech, south korea', 'aixplain inc., los gatos, ca, usa']
kim24v_interspeech	['ringle, republic of korea', 'school of computing, kaist, republic of korea', 'university of minnesota, us']
chang24d_interspeech	['carnegie mellon university 2delft university of technology 3university of california, berkeley']
bhogale24_interspeech	['indian institute of technology madras, india 2ai4bharat, india 3sarvam ai, india']
aluru24_interspeech	['speech processing lab, ltrc, iiit hyderabad, india', 'department of artificial intelligence, vidya jyothi institute of technology, india']
atkins24_interspeech	['kepkowski1,2', 'macquarie university, australia', 'apate.ai']
ratsep24_interspeech	['university of tartu, estonia']
mallela24_interspeech	['speech processing lab, ltrc, iiit hyderabad, india', 'department of artificial intelligence, vidya jyothi institute of technology, india']
lv24_interspeech	"[""northwestern polytechnical university, xi'an, china"", 'iqiyi inc., chengdu, china']"
lin24m_interspeech	['school of informatics, xiamen university, china', 'school of electronic science and engineering, xiamen university, china', 'department of chinese language and literature, xiamen university, china', 'beijing shell shell technology co. ltd, china']
sharma24_interspeech	['electrical engineering, indian institute of science (iisc), bangalore-560012, india', 'rewa engineering college, rewa, madhya pradesh-486002, india']
anand24_interspeech	['ai4bharat, indian institute of technology, madras, india']
tang24d_interspeech	['department of electronic engineering, tsinghua university', 'cambridge university engineering department', 'bytedance']
srinivasavaradhan24_interspeech	['ai4bharat, indian institute of technology madras, india']
tan24b_interspeech	['nara institute of science and technology, japan', 'japan advanced institute of science and technology, japan']
tammen24_interspeech	['ntt corporation, japan', 'carl von ossietzky universitat oldenburg, germany']
lu24f_interspeech	['institute of automation, chinese academy of sciences 2school of artificial intelligence, university of chinese academy of', 'sciences 3school of information and communication engineering, communication university of china 4department of automation,', 'tsinghua university 5 beijing national research center for information science and technology, tsinghua university 6shanghai', 'polytechnic university']
prabhu24b_interspeech	['indian institute of technology bombay, mumbai, india', 'indian institute of science, bangalore, india.']
osman24_interspeech	['virginia commonwealth university, united states', 'realiz.ai, united states']
vakirtzian24_interspeech	['anastasopoulos3,5', 'department of informatics, national and kapodistrian university of athens 2ilsp, athena r.c.', 'archimedes ai unit, athena r.c. 4university of patras, greece 5george mason university, usa']
li24ra_interspeech	['yale university, usa']
ciaperoni24_interspeech	['aalto university, finland', 'athena r.c., greece', 'kth royal institute of technology, sweden', 'university of copenhagen, denmark']
kalda24_interspeech	['tallinn university of technology, estonia', 'irit, universite de toulouse, cnrs, toulouse, france', 'universite de toulon, aix marseille univ, cnrs, lis, toulon, france']
tan24c_interspeech	['national university of singapore, singapore']
wang24ma_interspeech	['school of artificial intelligence, beijing university of posts and telecommunications, china', 'center for speech and language technologies, bnrist, tsinghua university, china']
zhou24f_interspeech	['school of artificial intelligence, beijing university of posts and telecommunications, china', 'center for speech and language technologies, bnrist, tsinghua university, china', 'huawei technologies co., ltd., china']
sukhadia24_interspeech	['qatar computing research institute, hbku, qatar']
tao24b_interspeech	['department of electronic engineering', 'department of educational psychology', 'the chinese university of hong kong']
deheerkloots24_interspeech	['institute for logic, language and computation, university of amsterdam; the netherlands']
kulkarni24_interspeech	['idiap, switzerland', 'mbzuai, uae', 'erisha labs, india', 'universite de lorraine, cnrs, loria, nancy, france', 'inesc-id, ist, universidade de lisboa, portugal']
braun24_interspeech	['technische hochschule nurnberg', 'technische hochschule rosenheim, germany', 'klinik fur psychiatrie und psychotherapie, universitatsklinik der paracelsus medizinischen', 'privatuniversitat, klinikum nurnberg, germany', 'kst institut gmbh, bad emstal, germany']
li24ta_interspeech	['school of artificial intelligence, beijing university of posts and telecommunications, china', 'center for speech and language technologies, bnrist, tsinghua university, china']
do24_interspeech	['graduate school of ai, postech, south korea', 'department of computer science and engineering, postech, south korea']
mittal24_interspeech	['ibm research', 'iit bombay']
okamoto24_interspeech	['national institute of information and communications technology, japan', 'kobe university, japan', 'nagoya university, japan']
jiang24d_interspeech	"[""northwestern polytechnical university, xi'an, china"", 'xiaomi ai lab, beijing, china']"
chen24y_interspeech	['center for speech and language technologies, bnrist, tsinghua university, china', 'beijing university of posts and telecommunications, china']
chakraborty24_interspeech	['centre for linguistic science and technology, indian institute of technology guwahati, india', 'department of assamese, gauhati university, india']
liu24r_interspeech	['inner mongolia university, hohhot, china']
lodagala24_interspeech	['indian institute of technology madras, india']
park24b_interspeech	['chungnam national university, republic of korea', 'electronics and telecommunications research institute, republic of korea']
sun24e_interspeech	['nankai university, tianjin, china', 'university of leicester, leicester, united kingdom']
ta24_interspeech	['viettel ai, viettel group, vietnam', 'hanoi university of science and technology, vietnam', 'thuyloi university, vietnam']
neelabh24_interspeech	['cognitive science lab, international institute of information technology, hyderabad, india']
hartanto24_interspeech	['tokyo institute of technology, japan', 'nara institute of science and technology, japan']
ta24b_interspeech	['viettel ai, viettel group, vietnam', 'hanoi university of science and technology, vietnam', 'thuyloi university, vietnam']
jia24_interspeech	['tianjin university, china', 'institute of computing and intelligence, harbin institute of technology (shenzhen), china']
arai24_interspeech	['sophia univ. (japan)', 'kyoto univ. (japan)']
gourav24_interspeech	['oracle corporation, india']
mohan24_interspeech	['happy prime inc', 'northeastern university', 'mercury speech and language', 'university of', 'victoria, canada']
mika24_interspeech	['uhura bionics', 'human interactivity and language lab, faculty of psychology, university of warsaw', 'samovar, telecom sudparis, institut polytechnique de paris']
akarsh24_interspeech	['international institute of information technology hyderabad, india']
okamoto24b_interspeech	['national institute of information and communications technology, japan']
peirolilja24_interspeech	['barcelona supercomputing center (bsc), spain', 'centre de llenguatge i computacio (clic), universitat de barcelona, spain']
francis24_interspeech	['division of speech, music and hearing, kth royal institute of technology, stockholm, sweden']
rohmatillah24_interspeech	['inst. of electrical and computer engineering, national yang ming chiao tung university, taiwan']
chaudhuri24_interspeech	['buduru', 'iiit-delhi,india', '*equal contributors']
koshal24_interspeech	['sharma1,3', 'iiit-delhi, india', 'ggsipu new delhi, india', 'university of tartu, estonia', '*equal contribution']
v24_interspeech	['international institute of information technology hyderabad, india', 'independent researcher']
chen24z_interspeech	['doctor4, tughrul arslan3, amir hussain2', 'college of mechanical and electrical engineering, anhui jianzhu university, hefei, china', 'school of computing, engineering and the built environment, edinburgh napier university, uk', 'school of engineering, the university of edinburgh, uk', 'school of computer science and electronic engineering, university of essex, u.k.']
anway24_interspeech	['hussain1', 'edinburgh napier university, edinburgh, uk 2university of nottingham, hearing sciences,', 'nottingham, uk ∗(joint first authors)']
kumar24c_interspeech	['observe.ai, india']
jain24b_interspeech	['ggsipu, new delhi, india', 'iiit-delhi, india', 'university of tartu, estonia', '*equal contribution']
morrone24_interspeech	['almawave s.p.a., voice engineering lab, italy']
schade24_interspeech	['bielefeld university, germany']
possamaidemenezes24_interspeech	['institute of acoustics and speech communication, technische universitat dresden, germany']
ward24b_interspeech	['university of texas at el paso, usa']
ryumina24_interspeech	['st. petersburg federal research center of the russian academy of sciences, st. petersburg, russia', 'itmo university, st. petersburg, russia']
mundra24_interspeech	['buduru', 'iiit-delhi, india', '*equal contribution']
sharma24b_interspeech	['iiit-delhi, india', 'university of tartu, estonia', '*equal contribution']
lameris24_interspeech	['division of speech, music & hearing, kth royal institute of technology, stockholm']
tsao24_interspeech	['ezai, taiwan', 'national taiwan normal university, taipei, taiwan']
koilakuntla24_interspeech	['observe.ai, india']
obukhov24_interspeech	['constructor technology, schaffhausen, switzerland']
masson24_interspeech	['school of computer science, university college dublin, ireland', 'sfi centre for research training in digitally-enhanced reality, ireland', 'sfi research centre for ai-driven digital content technology, ireland']
pages24_interspeech	['irit, universite de toulouse, cnrs, toulouse inp, ut3, toulouse, france']
liu24s_interspeech	['it innovation and research center, huawei technologies']
sirigiraju24_interspeech	['speech processing lab, ltrc, iiit hyderabad, india - 500032,', 'raj reddy center for technology and society, iiit hyderabad, india - 500032']
yap24_interspeech	['tan tock seng hospital, singapore', 'singapore institute of technology, singapore']
aiba24_interspeech	['graduate school of engineering, the university of tokyo, japan']
chen24aa_interspeech	['department of educational psychology and counseling, national taiwan normal university', 'department of computer science and information engineering, national taiwan normal', 'university']
sridaran24_interspeech	['all india institute of speech and hearing, mysore, karnataka, india', 'jain (deemed-to-be university), bengaluru, karnataka, india']
masudakatsuse24_interspeech	['kindai university,  2tokyo gakugei university']
preston24_interspeech	['syracuse university, syracuse, ny, usa', 'university of maryland, college park, md, usa', 'shenandoah university, winchester, va, usa', 'speechlink, syracuse, ny, usa']
yoder24_interspeech	['university of illinois urbana-champaign, united states of america']
phan24b_interspeech	['aalto university, finland', 'university of helsinki, finland', 'university of jyvaskyla, finland']
akhtar24_interspeech	['school of computer science, upes, dehradun, india', 'iiit-delhi, india,', 'carl, isrc, scei, ulster university', '*equal contribution']
phukan24c_interspeech	['iiit-delhi, india', 'ggsipu new delhi, india', 'bit mesra, india', 'isrc, ulster university, uk', 'university of tartu, estonia, *equal contribution']
