paper_id	affiliations
xiao25_interspeech	['the university of melbourne, australia', 'fortemedia singapore, singapore']
horiguchi25_interspeech	['ntt, inc., japan']
xiao25b_interspeech	['the university of melbourne, australia', 'fortemedia singapore, singapore', 'nanyang technological university , singapore', 'national university of singapore, singapore']
xiao25c_interspeech	['the university of melbourne, australia', 'fortemedia singapore, singapore']
zhang25_interspeech	['ahmed1, julien epps1', 'the university of new south', 'johns hopkins university', 'nanyang technological university,']
li25_interspeech	['chen1, mingyu cui1, shujie hu1, xunying liu1', 'the chinese university of hong kong, china', 'department of electronic engineering, tsinghua university, china']
pei25_interspeech	['brainchip, usa']
muller25_interspeech	['bukkapatnam3, karla pizzi5,6, alexander wagner1, philip sperl1', 'fraunhofer aisec, germany 2wroclaw university of science and technology, poland', 'resemble ai, usa 4technical university of cluj-napoca, romania', 'neodyme ag, germany 6tu munich, germany,']
chi25_interspeech	['apple', 'carnegie mellon university', 'meta']
chi25b_interspeech	['apple', 'meta']
whetten25_interspeech	"[""laboratoire informatique d'avignon, avignon universite, france"", 'thales six, france', 'samsung ai center cambridge, united kingdom', ""laboratoire d'informatique de grenoble, universite grenoble alpes, france""]"
zhao25_interspeech	['laboratory of language sciences, peking university, china', 'department of chinese language and literature, peking university, china']
jiang25_interspeech	['tongyi lab, alibaba group, china']
kim25_interspeech	['massachusetts institute of technology, usa', 'seoul national university hospital, south korea;', 'doctor diary, south korea', 'google research, usa', 'independent researcher']
chen25_interspeech	"['shanghai university, china', 'new york university, usa', ""xi'an jiaotong liverpool university, china"", 'hithink royalflush ai research institute, china']"
pan25_interspeech	['tongyi lab, alibaba group, singapore', 'national university of singapore, singapore']
getman25_interspeech	['department of lnformation and communications engineering, aalto university, finland', 'finnish national audiovisual institute (kavi), finland']
kim25b_interspeech	['meta ai, uk', 'imperial college london, uk']
yang25_interspeech	['beijing university of technology']
ai25_interspeech	"['shanghai university, china', 'new york university, usa', ""xi'an jiaotong-liverpool university, china""]"
lyu25_interspeech	['school of computing and data science, the university of hong kong']
chen25b_interspeech	['department of linguistics, the ohio state university, usa', 'department of computer science and engineering, the ohio state university, usa', 'amazon, usa']
zhu25_interspeech	['school of communications and information engineering, chongqing university of posts and', 'telecommunications, chongqing, china', 'college of engineering, design and physical science, brunel university, london ub8 3ph, u.k.']
ding25_interspeech	['department of electrical and electronic engineering, southern university of science and', 'technology, shenzhen, china']
hu25_interspeech	['baidu inc., shenzhen, china']
xu25_interspeech	['beijing institute of technology, china', 'tencent ai lab, beijing, china', 'institute of automation, chinese academy of sciences, china', 'university of california, berkeley, usa', 'tencent ai lab, seattle, usa']
inoue25_interspeech	['school of data science, the chinese university of hong kong, shenzhen, china', 'school of intelligence science and technology, nanjing university, suzhou, china', 'shenzhen research institute of big data, shenzhen, china', 'department of ece, national university of singapore, singapore']
liu25_interspeech	['metze1', 'meta, united states']
niizumi25_interspeech	['ntt communication science laboratories, ntt corporation, japan']
yan25_interspeech	['center for biomed-x research, academy for advanced interdisciplinary studies, peking', 'university, china', 'speech and hearing research center, school of intelligence science and', 'technology, peking university, china', 'national key laboratory of general artificial intelligence,', 'china']
ross25_interspeech	['ukri cdt in natural language processing, the university of edinburgh, united kingdom', 'ukri cdt in speech and language technologies, the university of sheffield, united kingdom', 'centre for speech technology research, the university of edinburgh, united kingdom']
hsieh25_interspeech	['graduate program of multimedia systems and intelligent computing,', 'national cheng kung university, tainan, taiwan']
botelho25_interspeech	['inesc-id, portugal', 'instituto superior tecnico, university of lisbon, portugal', 'prhlt research center, universitat politecnica de valencia, spain']
amoniyan25_interspeech	['department of linguistics, university of pittsburgh, united states']
lin25_interspeech	['school of computer science, wuhan university, china', 'huawei technology co., ltd, china,']
combei25_interspeech	['technical university of cluj-napoca, romania', 'university “politehnica” bucharest, romania', 'fraunhofer aisec, germany']
bentum25_interspeech	['centre for language studies, radboud university, netherlands', 'department of communication and cognition, tilburg university, netherlands']
kuhne25_interspeech	['department of electronic systems, aalborg university, denmark', 'oticon a/s, copenhagen, denmark']
cappellazzo25_interspeech	['imperial college london, uk', 'meta ai, uk', 'fondazione bruno kessler, italy']
chen25c_interspeech	['great ormond street institute of child health, university college london, uk', 'laboratory of language sciences, peking university, china', 'department of chinese language and literature, peking university, china']
lee25_interspeech	['kaist, republic of korea']
sadok25_interspeech	['inria, universite grenoble alpes cnrs, ljk, france', 'lmssc, conservatoire national des arts et metiers, paris, france', 'apc, french-german research institute of saint-louis, france', '*equal contribution']
ye25_interspeech	['donders institute for brain, cognition and behaviour, radboud university, the netherlands', 'max planck institute for psycholinguistics, the netherlands']
gutscher25_interspeech	['signal processing and speech communication laboratory, graz university of technology, austria', 'austrian research institute for artificial intelligence, vienna, austria']
horiguchi25b_interspeech	['ntt, inc., japan']
wu25_interspeech	['shanghai artificial intelligence laboratory, china', 'department of electronic engineering, tsinghua university, china', 'vanke school of public health, tsinghua university, china', 'department of engineering, university of cambridge, uk']
funk25_interspeech	['institute for german linguistics, friedrich schiller university jena, germany']
yang25b_interspeech	['the university of tokyo, japan', 'university of augsburg, germany', 'chi, tum, germany;', 'beijing institute of technology, china', 'kobe university, japan', 'glam, icl, uk']
ng25_interspeech	['college of computing and data science, nanyang technological university, singapore', 'miromind, singapore', 'tongyi speech lab, alibaba group, singapore']
sudo25_interspeech	['honda research institute japan, japan', 'carnegie mellon university, usa']
xu25b_interspeech	['department of music ai and music it, central conservatory of music, china', 'school of intelligence science and technology, peking university, china']
weirich25_interspeech	['friedrich-schiller-university jena, germany, institute for german linguistics']
vlasenko25_interspeech	['idiap research institute, martigny, switzerland']
cumani25_interspeech	['rohdin2', 'politecnico di torino, italy', 'brno university of technology, czechia', 'audias, universidad autonoma de madrid, spain']
cumani25b_interspeech	['politecnico di torino, italy']
xu25c_interspeech	['nvidia corporation, u.s.a.']
raut25_interspeech	['university of colorado boulder, usa', 'national aeronautics and space administration, usa']
kommineni25_interspeech	['bishop4, catherine lord5, sudarsana kadiri1, shrikanth narayanan1', 'signal analysis and interpretation laboratory, university of southern california, usa', 'school of', 'psychology, korea university, korea', 'center for autism research excellence, boston university,', 'usa', 'department of psychiatry, university of california san francisco, usa', 'semel institute of', 'neuroscience and human behavior, university of california los angeles, usa']
ghosh25_interspeech	['artificial intelligence lab, otto-von-guericke-university, germany', 'school of computer science, university of birmingham, england']
yazawa25_interspeech	['institute of humanities and social sciences, university of tsukuba, japan', 'school of languages and communication, kobe university, japan']
gu25_interspeech	['acoustic lab, aalto university, espoo, finland', 'school of data science, the chinese university of hong kong, shenzhen, china']
kim25c_interspeech	['department of electrical engineering, yonsei university, seoul, south korea']
hu25b_interspeech	"['jin1', 'zhejiang university, china', ""huawei noah's ark lab, china""]"
ravenscroft25_interspeech	['connexai, united kingdom']
bhattacharya25_interspeech	['department of computer science, columbia university, usa', 'the peddie school, usa']
kang25_interspeech	['massachusetts institute of technology, usa', 'meta, usa']
heo25_interspeech	['university of california, santa cruz, usa', 'meta reality labs research, usa']
kwok25_interspeech	['digital trust centre, nanyang technological university, singapore', 'college of computing and data science, nanyang technological university, singapore']
kwok25b_interspeech	['college of computing and data science, nanyang technological university, singapore']
lepagnol25_interspeech	['universite paris-saclay, cnrs, lisn, france', 'sciam, france']
pawlowski25_interspeech	['samsung r&d, poland', 'warsaw university of technology, poland']
maran25_interspeech	['donders centre for cognition, nijmegen, the netherlands']
zhuang25_interspeech	['ping an technology, china']
patman25_interspeech	['university of cambridge', 'university of york']
ducorroy25_interspeech	['callyope, france']
lepage25_interspeech	['epita research laboratory (lre), france']
wang25_interspeech	['research center, elm company, ksa']
ren25_interspeech	['institute of automation, chinese academy of sciences, beijing, china', 'school of artificial intelligence, university of chinese academy of sciences, beijing, china', 'tencent ai lab, beijing, china', 'tencent ai lab, seattle, usa']
park25_interspeech	['school of computer science, university of sheffield, ukuniversity of sheffield, uk']
kim25d_interspeech	['puzzleai, south korea']
yao25_interspeech	['northwestern polytechnical university, china', 'nanyang technological university, singapore']
wen25_interspeech	['samsung r&d institute china-beijing, china', 'samsung research, samsung electronics, south korea']
zhao25b_interspeech	['college of computer science, inner mongolia university, china']
tian25_interspeech	['hithink royalflush ai research institute, hangzhou, china', 'tmcc, college of computer science, nankai university, tianjin, china']
parsons25_interspeech	['department of electronic systems, ntnu, norway', 'telenor research and innovation, telenor, norway']
wang25b_interspeech	['research center, elm company, ksa', 'concordia university, canada', 'mila, canada']
pan25b_interspeech	['department of information science and technology, kyushu university, japan', 'department of computer science, the university of tokyo, japan', 'everestai, ximalaya inc., china']
ljubesic25_interspeech	['department of knowledge technologies, jozef stefan institute, slovenia', 'faculty of computer and information science, university of ljubljana, slovenia', 'institute of contemporary history, ljubljana, slovenia']
jung25_interspeech	['korea advanced institute of science and technology, south korea']
itani25_interspeech	['university of washington, usa', 'sesame ai, usa']
shao25_interspeech	['department of automation, shanghai jiao tong university, china']
loweimi25_interspeech	['centre for medical informatics, usher institute, university of edinburgh, uk']
yuen25_interspeech	['department of language science and technology, universitat des saarlandes', 'department of linguistics, macquarie university', 'speech communication group, research laboratory of electronics, mit']
zhao25c_interspeech	"['cvetkovic3', 'electronic information school, wuhan university, wuhan, china', 'wuhan university shenzhen research institute, wuhan university, shen zhen, china', ""king's college london, london, uk"", ""ciaic, northwestern polytechnical university, xi'an, shaanxi, china"", 'inrs-emt, university of quebec, montreal, canada']"
lu25_interspeech	['school of informatics, xiamen university, china', 'school of electronic science and engineering, xiamen university, china']
zeng25_interspeech	['dalhousie university, canada', 'vector institute, canada']
chang25_interspeech	['mit csail, usa', 'meta ai, usa']
ariga25_interspeech	['the university of tokyo, japan']
oh25_interspeech	['interdisciplinary program in ai, seoul national university, south korea', 'department of french language education, seoul national university, south korea', 'department of linguistics, seoul national university, south korea']
oh25b_interspeech	['interdisciplinary program in ai, seoul national university, south korea', 'department of french language education, seoul national university, south korea', 'department of linguistics, seoul national university, south korea']
goswami25_interspeech	['the university of tokyo, japan', 'riken, japan']
li25b_interspeech	['south china university of technology, china', 'speech lab, alibaba group, china', 'pazhou lab, china']
yang25c_interspeech	['beijing university of technology']
sung25_interspeech	"['department of computer sciences, university of wisconsin-madison, usa', 'department of speech pathology and audiology, hallym university, republic of korea', ""department of english language and literature, sungshin women's university, republic of korea"", 'department of computer science and engineering, sogang university, republic of korea']"
halim25_interspeech	['university of melbourne, australia']
hannan25_interspeech	['schedl3,5, mubashir noman2', 'university of trento, italy', 'mohamed bin zayed university of artificial intelligence, u.a.e.', 'johannes kepler university linz, austria', 'imt lucca, italy', 'linz institute of technology, ai lab, austria']
ankita25_interspeech	['department of ece, nit patna, india', 'computer science department, iit patna, india']
luan25_interspeech	['beijing university of posts and telecommunications, china', 'china merchants research institute', 'of advance technology, china', 'zhejiang university, china', 'harbin institute of technology,', 'china', 'qingdao university, china', 'fuxi ai lab, netease, china']
murata25_interspeech	['cyberagent, japan']
murata25b_interspeech	['cyberagent, japan', 'nagoya university, japan']
liang25_interspeech	['department of electronic engineering, tsinghua university, china', 'zhili college, tsinghua university, china', 'shanghai jiao tong university, china']
hermes25_interspeech	['laboratoire de phonetique et phonologie, umr 7018, universite sorbonne nouvelle, cnrs,', 'paris, france', 'praxiling, umr 5267, universite de montpellier paul-valery, cnrs, montpellier, france', 'psychological sciences research institute/ions, universite catholique de louvain, belgium']
wang25c_interspeech	['nanjing polytechnic institute, nanjing, china', 'institute of linguistics, chinese academy of social sciences, china']
du25_interspeech	['university of chinese academy of social sciences, china', 'institute of linguistics, chinese academy of social sciences, china']
zhang25b_interspeech	['university of chinese academy of social sciences, china', 'institute of linguistics, chinese academy of social sciences, china']
saladukha25_interspeech	['embedded voice input team, yandex, belarus', 'embedded voice input team, yandex, serbia', 'embedded voice input team, yandex, russia']
liu25b_interspeech	['meta, menlo park, ca, usa']
bolanos25_interspeech	['departamento de computacion, fceyn, uba, argentina', 'instituto de investigacion en ciencias de la computacion (icc), conicet-uba, argentina']
tao25_interspeech	['beijing university of technology, beijing, china', 'shanghai branch of the southwest institute of electronics and telecommunication technology of', 'china, shanghai, china']
liang25b_interspeech	['zou*1', 'guangdong provincial key laboratory of ultra high definition immersive media technology,', 'shenzhen graduate school, peking university, china', 'south china university of technology,', 'china']
chen25d_interspeech	['shenzhen international graduate school, tsinghua university, china', 'huawei technologies co., ltd., china']
harmsen25_interspeech	['centre for language studies, radboud university, the netherlands']
sun25_interspeech	['the centre for speech technology research, the university of edinburgh, uk']
kando25_interspeech	['graduate school of information science and technology, the university of tokyo, japan', 'faculty of science and technology, keio university, japan']
huang25_interspeech	['centre for digital music, queen mary university of london, uk', 'music.ai, usa']
peng25_interspeech	['nerc-slip, university of science and technology of china, hefei, china']
niebuhr25_interspeech	['centre for industrial electronics, university of southern denmark, soenderborg, dk']
kim25e_interspeech	['dept. of cse, korea university, republic of korea', 'new york university, usa']
higuchi25_interspeech	['department of communications and computer engineering, waseda university, japan']
blaschke25_interspeech	['plank1,2', 'mainlp, cis, lmu munich, germany', 'munich center for machine learning, germany;', 'bayerischer rundfunk, germany']
lu25b_interspeech	['national engineering research center of speech and language information processing,', 'university of science and technology of china, hefei, p r. china']
yu25_interspeech	['national taiwan normal university, taiwan', 'national chi nan university, taiwan', 'realtek semiconductor corp., taiwan']
kuan25_interspeech	['graduate institute of communication engineering, national taiwan university, taiwan']
gong25_interspeech	['auditory cognition and computational acoustics lab, moe key lab of ai, ai institute', 'school of computer science, shanghai jiao tong university, shanghai, china', 'antgroup, shanghai, china']
novitasari25_interspeech	['ibm tokyo research lab, tokyo, japan']
you25_interspeech	['school of data science, the chinese university of hong kong, shenzhen, china', 'school of intelligence science and technology, nanjing university, suzhou, china', 'shenzhen research institute of big data, shenzhen, china', 'auditory cognition and computational acoustics lab, shanghai jiao tong university, shanghai,', 'china,']
novitasari25b_interspeech	['ibm tokyo research lab, tokyo, japan']
singh25_interspeech	['center for language & speech processing, johns hopkins university, baltimore, md, usa', 'hlt center of excellence, johns hopkins university, baltimore, md, usa']
benway25_interspeech	['electrical and computer engineering, university of maryland - college park, usa', 'speech-language-hearing sciences, university of minnesota - twin cities, usa', 'communication sciences and disorders, syracuse university, usa']
visser25_interspeech	['electrical and electronic engineering, stellenbosch university, south africa']
cai25_interspeech	['amsterdam center for language and communication, university of amsterdam, the netherlands']
oneata25_interspeech	['speed lab, politehnica bucharest, romania', 'electrical and electronic engineering, stellenbosch university, south africa', 'clcg, university of groningen, the netherlands']
takagi25_interspeech	['nagoya institute of technology, japan']
xu25d_interspeech	['alibaba digital media entertainment group, beijing, china']
shiota25_interspeech	['tokyo metropolitan university, japan', 'keio university, japan', 'the university of tokyo, japan']
xu25e_interspeech	['deng1, xunying liu1', 'the chinese university of hong kong, hong kong sar, china', 'national research council canada, canada']
tseng25_interspeech	['department of computer science, university of texas at austin, usa']
li25c_interspeech	['college of computer science, inner mongolia university, china', 'college of electronic and information engineering, inner mongolia university, china']
pan25c_interspeech	['school of information science and technology, southeast university, china', 'advanced computing and storage laboratory', ' laboratories, huawei technologies co. ltd.,', 'institute of high performance computing, a*star, singapore', 'taizhou school of clinial medicine, nanjing medical university, china']
trachu25_interspeech	['department of computer engineering, faculty of engineering, chulalongkorn university, thailand', 'university of southern california, los angeles, usa']
meng25_interspeech	['school of computer science and technology, xinjiang university, china', 'school of intelligence science and technology, xinjiang university, china', 'xinjiang key laboratory of signal detection and processing, china', 'department of electronic engineering, tsinghua university, china']
lee25b_interspeech	['department of computer science and engineering, korea university, south korea']
dutta25_interspeech	['learning and extraction of acoustic patterns (leap) lab, electrical engineering, indian institute', 'of science, bangalore, india', 'shiv nadar university, chennai, india']
alip25_interspeech	['tianjin key laboratory of cognitive computing and application, college of intelligence and', 'computing, tianjin university, china', 'department of electrical and computer engineering, national university of singapore, singapore', 'shenzhen institute of advanced technology, chinese academy of sciences, guangdong, china']
huang25b_interspeech	['faculty of electrical engineering and computer science, ningbo university, china', 'college of digital technology and engineering, ningbo university of finance and economics,', 'china']
xiang25_interspeech	['hithink research, zhejiang, china', 'electrical engineering department, tsinghua university, beijing, china']
kim25f_interspeech	['department of artificial intelligence, sogang university, republic of korea', 'department of electronic engineering, sogang university, republic of korea']
jung25b_interspeech	['samsung research, seoul, south korea']
r25_interspeech	['iiit hyderabad, india', 'iiser bhopal, india', 'university of bath, uk']
okabe25_interspeech	['data science laboratories, nec corporation, japan']
suda25_interspeech	['national institute of advanced industrial science and technology (aist), japan', 'keio university, japan', 'the university of tokyo, japan']
li25d_interspeech	['college of computer science, inner mongolia university, china']
yuan25_interspeech	"[""noah's ark lab, huawei, china"", 'consumer business group, huawei, china']"
ahn25_interspeech	['school of electrical engineering, kaist, republic of korea']
zhuo25_interspeech	['x-lance lab, school of computer science, moe key lab of artificial intelligence,', 'shanghai jiao tong university, shanghai innovation institute, china', 'tencent ai lab, usa']
lemaguer25_interspeech	['university of helsinki, finland', 'orange research, france', 'irisa, universite bretagne sud, france', 'sigmedia group, school of engineering, trinity college dublin, ireland']
su25_interspeech	['department of communication engineering, national taipei university, taiwan', 'college of electrical engineering and computer science, national taipei university, taiwan']
levkovitch25_interspeech	['kleijn2, eliya nachmani1', 'google research', 'google deepmind']
kawanishi25_interspeech	['graduate school of engineering, tohoku university, japan', 'ntt communication science laboratories, japan']
hsiao25_interspeech	['national taiwan university, taiwan']
bijoy25_interspeech	['department of lnformation and communications engineering, aalto university, finland']
kumar25_interspeech	['department of electrical engineering, indian institute of science, bangalore, india']
kim25g_interspeech	['intelligent robot laboratory, university of seoul, republic of korea', 'oregon state university, usa', 'soongsil university, republic of korea']
yadav25_interspeech	['department of electronic systems, aalborg university, denmark', 'pioneer centre for artificial intelligence, denmark', 'department of informatics and telecommunications , national and kapodistrian university of', 'athens, greece']
gao25_interspeech	['tencent wxg chengdu, audio and speech signal processing oteam', 'tencent ai lab, audio and speech signal processing oteam']
huang25c_interspeech	['chao-han huck yang1, yu tsao3, yu-chiang frank wang1, hung-yi lee2, szu-wei fu1', 'nvidia, taiwan', 'natinoal taiwan university, taiwan', 'academia sinica, taiwan']
stucki25_interspeech	['centre for artificial intelligence, zhaw, switzerland']
kang25b_interspeech	['nc ai co., ltd, republic of korea', 'sogang university, republic of korea']
turavecino25_interspeech	['amazon, agi']
kamper25_interspeech	['electrical and electronic engineering, stellenbosch university, south africa', 'ubisoft la forge, montreal, canada']
fernandez25_interspeech	['tubingen ai center, university of tubingen, germany', 'reality labs research, meta, uk', 'reality labs research, meta, spain']
masztalski25_interspeech	['samsung r&d institute poland,', 'agh university of krakow, poland']
biswas25_interspeech	['oci speech, oracle cloud infrastructure']
yang25d_interspeech	['nercms, school of computer science, wuhan university, china', 'hubei key laboratory of multimedia and network communication engineering, china', 'guangdong oppo mobile telecommunications corp., china']
makishima25_interspeech	['ntt corporation, japan']
makishima25b_interspeech	['ntt corporation, japan']
ormaechea25_interspeech	['department of translation technology, university of geneva, switzerland', 'univ. grenoble alpes, cnrs, grenoble inp, lig, france']
yoon25_interspeech	['lg ai research, seoul, republic of korea', 'yonsei university, seoul, republic of korea']
marmor25_interspeech	['mathematics and computer science faculty, weizmann institute of science, israel', 'hadassah medical organization, israel', 'ivrit.ai, israel']
hiruta25_interspeech	['solvance llc, japan', 'the asahi shimbun company, japan']
vaessen25_interspeech	['institute for computing and information science, radboud university, the netherlands', 'human media interaction, university of twente, the netherlands', 'netherlands institute for sound and vision, the netherlands']
zhao25d_interspeech	['school of computing, national university of singapore, singapore']
woszczyk25_interspeech	['imperial college london, uk', 'taibah university, saudi arabia']
wu25b_interspeech	['bosch center for artificial intelligence, usa', 'music and audio research laboratory, new york university, usa']
li25e_interspeech	['zhan2, zhizheng wu1', 'school of data science, the chinese university of hong kong, shenzhen, china', 'baidu inc., shenzhen, china']
naseem25_interspeech	['al-khawarizmi institute of computer science (kics), university of engineering and', 'technology, lahore, pakistan']
stan25_interspeech	['technical university of cluj-napoca, romania', 'university “politehnica” bucharest, romania']
dai25_interspeech	['nerc-slip, university of science and technology of china, hefei, china']
su25b_interspeech	['milm plus, xiaomi inc., china']
rouas25_interspeech	['atienza3, giovanni ansaloni3', 'labri cnrs umr 5800, univ. bordeaux, bordeaux inp, france', 'cesi lineact ur 7527, nancy, france', 'embedded systems laboratory (esl), epfl, switzerland']
altwlkany25_interspeech	['faculty of science, university of sarajevo, bosnia and herzegovina', 'infobip, sarajevo, bosnia and herzegovina', 'infobip, zagreb, croatia']
birkholz25_interspeech	['institute of acoustics and speech communication, tu dresden, germany']
sharma25_interspeech	['department of electrical engineering, indian institute of science (iisc), india', 'center for artificial intelligence and robotics (cair), drdo, india']
han25_interspeech	['burget']
sun25b_interspeech	['department of electronic engineering, tsinghua university, china', 'ira a fulton schools of engineering, arizona state university, united states']
tanner25_interspeech	['department of english language and linguistics, university of glasgow, united kingdom', 'department of linguistics, mcgill university, canada', 'department of english, north carolina state university, united states', 'school of law, duke university, united states']
harrington25_interspeech	['kelly2, david van der vloed3', 'department of language and linguistic science, university of york, united kingdom', 'oxford wave research, united kingdom', 'netherlands forensic institute, netherlands']
miniconi25_interspeech	['lium, university of le mans, france']
schuster25_interspeech	['department of electrical engineering, media and computer science, technical university of', 'applied sciences amberg-weiden, germany', 'technological institute for applied artificial intelligence gmbh, weiden, germany']
hamann25_interspeech	['university of amsterdam, the netherlands']
gu25b_interspeech	['auditory cognition and computational acoustics lab', 'moe key lab of artificial intelligence, ai institute', 'school of computer science, shanghai jiao tong university, shanghai, china', 'sjtu paris elite lnstitute of technology, shanghai jiao tong university, shanghai, china']
fan25_interspeech	['department of electrical and computer engineering, university of illinois, usa', 'beckman institute for advanced science and technology, university of illinois, usa', 'department of human development and family studies, university of illinois, usa']
pepino25_interspeech	['instituto de investigacion en ciencias de la computacion (icc), conicet-uba, argentina', 'departamento de computacion, fceyn, universidad de buenos aires (uba), argentina']
zhou25_interspeech	['franceschini1', 'bloomberg, usa', 'wenet open source community, china']
li25f_interspeech	['mortensen1', 'carnegie mellon university, usa', 'fau erlangen-nurnberg, germany', 'universidad de', 'antioquia, columbia', 'tu delft, the netherlands', 'fortemedia, singapore']
huo25_interspeech	['department of linguistics, university of toronto, canada', 'department of computer science, university of toronto, canada', 'department of french, university of toronto, canada']
goebiowska25_interspeech	['department of artificial intelligence, wroclaw university of science and technology, poland']
cumlin25_interspeech	['department of information science and engineering, kth royal institute of technology, sweden', 'hcltech, sweden', 'google llc, usa']
escobargrisales25_interspeech	['garcia3, yamile bocanegra4 , leonardo moreno5,elmar n¨oth 6, juan rafael orozco-arroyave1,6', 'gita lab, university of antioquia udea', 'faculty of engineering, universita degli studi di', 'palermo', 'cnc, universidad de san andres', 'gna lab, universidad de antioquia', 'hospital pablo', 'tobon uribe', 'lme lab, friedrich-alexander universitat.']
gao25b_interspeech	['department of applied mathematics and statistics, the johns hopkins university, baltimore, usa', 'department of electrical and computer engineering, the johns hopkins university, baltimore, usa']
reuter25_interspeech	['fraunhofer institute for digital media technology, division hearing, speech and audio', 'technology, oldenburg, germany', 'department of text, speech and audio, bundeskriminalamt, wiesbaden, germany']
elkheir25_interspeech	['speech and language technology, dfki, germany', 'quality and usability lab, technical university of berlin, germany', 'ai team, gretchen ai, germany']
asali25_interspeech	['electrical and computer engineering school, ben gurion university of the negev, israel', 'electrical engineering school, afeka the academic college of engineering in tel aviv, israel', 'avignon university, lia, france']
pendyala25_interspeech	['department of electrical and computer engineering, university of wisconsin-madison, usa']
biswas25b_interspeech	['worcester polytechnic institute, usa']
lin25b_interspeech	['meta, usa']
bn25_interspeech	['amazon, usa']
doan25_interspeech	['soongsil university, seoul, republic of korea']
szalay25_interspeech	['dept. of electrical engineering and telecommunications, university of new south wales, australia', 'dept. of speech pathology, university of sydney, australia', 'dept. of linguistics, macquarie university, australia']
raokoluguri25_interspeech	['ding∗1, sofia kostandian2, he huang1, nikolay karpov#2, jagadeesh balam1, vitaly lavrukhin1,', 'yifan peng4, sara papi5, marco gaido5, alessio brutti5, boris ginsburg1', 'nvidia, usa', 'nvidia, armenia', 'nvidia, germany', 'carnegie mellon university, usa', 'fondazione bruno kessler (fbk), italy']
wan25_interspeech	['audio innovation technology department, anker inc, china', 'school of computer science, beijing university of posts and telecommunications, china']
sun25c_interspeech	['tmcc, college of computer science, nankai university, tianjin, china', 'hithink royalflush ai research institute, zhejiang, china', 'university of exeter, exeter, united kingdom']
kong25_interspeech	['milm plus, xiaomi inc., china', 'kongyuxiang1, cuifan, guoliyong, dinkelheinrich, fanlichun1, zhangjunbo1,']
zhang25c_interspeech	['tencent youtu lab, china', 'institute of computing technology, chinese academy of sciences, china']
zhang25d_interspeech	['milm plus, xiaomi inc., china', 'amazon.com, inc., china']
park25b_interspeech	['song1,3', 'naver cloud, republic of korea', 'school of industrial and management engineering, korea university, republic of korea', 'artificial intelligence institute, seoul national university, republic of korea']
ram25_interspeech	['university of texas at austin, usa', 'california state university, east bay, usa', 'university of', 'california, berkeley, usa', 'bespokelabs.ai, usa']
liu25c_interspeech	['inner mongolia university, hohhot, china', 'center for language and speech processing, johns hopkins university, usa', 'ltl, carnegie mellon university, usa', 'sribd, school of data science, the chinese university of hong kong, shenzhen, china', 'department of ece, national university of singapore, singapore']
fang25_interspeech	['south china university of technology, china', 'voiceai technologies, china', 'pazhou lab, china']
lee25c_interspeech	['naver cloud, south korea', 'nhn, south korea', 'yale university, usa']
lee25d_interspeech	['signal analysis and interpretation laboratory, university of southern california, usa', 'chi – chair of health informatics, technical university of munich, germany', 'department of linguistics, university of southern california, usa']
zheng25_interspeech	['hasegawa-johnson1, pan-pan jiang4, aadhrik kuila2, colin lea5, bob macdonald4, gautam', 'mantena5, venkatesh ravichandran3, leda sari6, katrin tomanek7, chang d yoo9, chris zwilling1', 'uiuc', 'microsoft', 'amazon', 'google', 'apple', 'meta, usa7cdli, uk8inha university', 'kaist, kr']
xiong25_interspeech	['school of electrical, computer and energy engineering, arizona state university, usa', 'college of health solutions, arizona state university, usa']
le25_interspeech	['auditory cognition and computational acoustics lab', 'moe key lab of artificial intelligence, ai institute', 'school of computer science, shanghai jiao tong university, shanghai, china', 'honor device co, ltd, china']
wu25c_interspeech	['graduate school of fundamental science and engineering, waseda university, japan', 'faculty of innovation engineering, macau university of science and engineering, china sar', 'key laboratory of brain health intelligent evaluation and intervention (beijing institute of', 'technology), ministry of education, beijing, china', 'school of medical technology, beijing institute of technology, beijing, china', 'school of economics and management, north china electric power university, beijing, china', 'glam – the group on language, audio, & music, imperial college london, uk', 'chi – chair of health informatics, technical university of munich, germany', 'educational physiology laboratory, graduate school of education, the university of tokyo, japan']
setoguchi25_interspeech	['chiba institute of technology, japan']
li25g_interspeech	['shenzhen international graduate school, tsinghua university, china', 'pengcheng laboratory, china', 'independent researcher, china']
kim25h_interspeech	['dept. of electrical and electronic eng., yonsei university, replulic of korea', 'samsung research, samsung electronics, replulic of korea']
onda25_interspeech	['the university of tokyo, japan', 'national institute of advanced industrial science and technology (aist), japan', 'kyoto university, japan']
mun25_interspeech	['department of linguistics, seoul national university, republic of korea', 'department of french language education, seoul national university, republic of korea']
zhang25e_interspeech	['acoustics and vibration research centre, department of mechanical and mechatronics', 'engineering, university of auckland, new zealand']
onda25b_interspeech	['the university of tokyo, japan', 'national institute of advanced industrial science and technology (aist), japan', 'kyoto university, japan']
lee25e_interspeech	['department of intelligence and information, seoul national university', 'interdisciplinary program in artificial intelligence, seoul national university', 'artificial intelligence institute, seoul national university, republic of korea']
onda25c_interspeech	['the university of tokyo, japan', 'sony group corporation, japan', 'carnegie mellon university, usa']
qian25_interspeech	['alta institute, department of engineering, university of cambridge, uk']
mori25_interspeech	['contreras2, koichiro yoshino4,2,1', 'nara institute of science and technology, japan', 'guardian robot project, riken, japan;', 'national institute of informatics, japan', 'tokyo institute of technology, japan']
jeon25_interspeech	['gsai, postech, south korea', 'cse, postech, south korea']
martin25_interspeech	['univ. de lorraine, cnrs, inria, loria, f-54000 nancy, france', 'labri cnrs umr 5800, univ. bordeaux, bordeaux inp, france']
mori25b_interspeech	['nara institute of science and technology, japan', 'guardian robot project, riken, japan', 'tokyo institute of technology, japan']
wu25d_interspeech	['pandey3', 'graduate institute of communication engineering, national taiwan university, taiwan', 'reality labs research, meta, uk', 'reality labs research, meta, usa']
yang25e_interspeech	"[""school of computer science and technology, xi'an jiaotong university, china"", 'college of computing and data science, nanyang technological university, singapore']"
wang25d_interspeech	['key laboratory of universal wireless communicationsministry of education, beijing university', 'of posts and telecommunications(bupt), beijing, china', 'fanvil link technology co., ltd, shenzhen, china']
geng25_interspeech	['graduate school of engineering, the university of tokyo, japan']
lu25c_interspeech	['graduate institute of communication engineering, national taiwan university, taiwan']
kim25i_interspeech	['school of industrial and management engineering, korea university, republic of korea']
zuo25_interspeech	['dept. of electrical and electronic engineering, the hong kong polytechnic university, hong kong', 'sar']
xu25f_interspeech	['shenzhen international graduate school, tsinghua university, shenzhen, china', 'tencent ai lab, china', 'the chinese university of hong kong, hong kong sar, china']
jin25_interspeech	['samsung research, korea']
hou25_interspeech	['auditory cognition and computational acoustics lab', 'moe key lab of artificial intelligence, ai institute', 'department of computer science and engineering, shanghai jiao tong university, shanghai, china,']
zhao25e_interspeech	['college of computer science, inner mongolia university, china', 'department of computer science and engineering, southern university of science and', 'technology, china']
cheng25_interspeech	['fish audio, santa clara, ca, usa', 'carnegie mellon university, pittsburgh, pa, usa', 'huazhong university of science and technology, wuhan, hubei, china', 'nanjing university of information science and technology, nanjing, jiangsu, china']
yamashita25_interspeech	['hitachi, litd., japan']
niu25_interspeech	['school of computer science and engineering, northeastern university, shenyang 110819, china']
nguyen25_interspeech	['institute for infocomm research (i2r), a*star, singapore']
li25h_interspeech	['department of electrical and electronic engineering, the hong kong polytechnic university,', 'hong kong sar']
geng25b_interspeech	['beijing university of posts and telecommunications, china']
gao25c_interspeech	['centre for language studies, radboud university, the netherlands']
ohnaka25_interspeech	['nara institute of science and technology, japan', 'ly corporation, japan']
lin25c_interspeech	['graduate institute of communication engineering, national taiwan university, taiwan', 'independent researcher, taiwan']
white25_interspeech	['department of linguistics, macquarie university, australia']
lo25_interspeech	['linguistics and english language, lancaster university, united kingdom', 'linguistics and english language, university of manchester, united kingdom']
oconnorrussell25_interspeech	['adapt centre, school of engineering, trinity college dublin, ireland']
hartuv25_interspeech	['the school of computer science and engineering', 'the hebrew university of jerusalem, israel']
han25b_interspeech	['department of intelligence and information, seoul national university, republic of korea', 'supertone inc., republic of korea', 'artificial intelligence institute, seoul national university, republic of korea']
nguyen25b_interspeech	['karlsruhe institute of technology, germany', 'carnegie mellon university, usa']
luo25_interspeech	['national taiwan university, taiwan']
zhao25f_interspeech	['tongyi lab, alibaba group, singapore']
gaznepoglu25_interspeech	['international audio laboratories erlangen, fau erlangen-nurnberg, germany', 'fraunhofer institute for integrated circuits (iis), erlangen, germany', 'department of data science, fau erlangen-nurnberg, germany', 'department of electrical and electronics engineering, trinity college dublin, ireland']
nam25_interspeech	['prairieschooner inc., pangyo, republic of korea']
lahtinen25_interspeech	['signal processing research centre, tampere university, finland', 'language studies, tampere university, finland']
liu25d_interspeech	['college of computer science, inner mongolia university, china']
vieting25_interspeech	['machine learning and human language technology group, rwth aachen university, germany', 'apptek gmbh, germany']
damianos25_interspeech	['speech and language processing group, national technical university of athens, greece', 'institute for language and speech processing, athena research center, greece']
cavalcanti25_interspeech	['kth royal institute of technology, sweden', 'pontifical catholic university of sao paulo, brazil', 'stockholm university, sweden']
chen25e_interspeech	['liang2, zhen-hua ling1,2, jiahong yuan1,2∗', 'national engineering research center of speech and language information processing, university', 'of science and technology of china, hefei, p r. china', 'interdisciplinary research center for linguistic sciences, university of science and technology of', 'china, hefei, p r. china']
hu25c_interspeech	['hangzhou institute for advanced study, university of chinese academy of sciences, china']
gao25d_interspeech	['speech team, tongyi lab, alibaba group']
wang25e_interspeech	['institute for infocomm research (i2r), agency for science, technology and research (a⋆star),', 'singapore']
tienkamp25_interspeech	['hoekzema1, katharina polsterer1, hedwig sekeres1, rob van son5,6, martijn wieling1, max witjes2,', 'sebastiaan de visscher2, defne abur1', 'clcg, university of groningen, the netherlands', 'university medical center groningen, the', 'netherlands', 'lpp, cnrs/sorbonne nouvelle, france', 'bcls, vrije universiteit brussel, belgium,', 'university of amsterdam, the netherlands', 'netherlands cancer institute, the netherlands']
chen25f_interspeech	['tongyi speech lab, alibaba group, china']
zhou25b_interspeech	['lidilem, universite grenoble-alpes, grenoble, france', 'atilf, universite de lorraine, cnrs, nancy, france', 'ilc, universite catholique de louvain, fnrs, louvain-la-neuve, belgium']
kim25j_interspeech	['korea electronics technology institute, south korea']
huang25d_interspeech	['jiutian team, china mobile research institute, china']
parcollet25_interspeech	['samsung, ai center cambridge, united kingdom,']
hu25d_interspeech	['deng1, tianzi wang1, mingyu cui1, helen meng1, xunying liu1∗', 'the chinese university of hong kong, hong kong sar, china', 'institute of software, chinese academy of sciences, china', 'national research council canada, canada']
lee25f_interspeech	['kaist, south korea', 'samsung electronics, south korea', 'ineeji, south korea']
mun25b_interspeech	['department of linguistics, seoul national university, republic of korea', 'department of french language education, seoul national university, republic of korea']
zhang25f_interspeech	['tencent youtu lab, china']
wang25f_interspeech	['laboratory of cognitive computing and application, college of intelligence and computing,', 'tianjin university, china', 'huiyan technology (tianjin) co., ltd, tianjin, china', 'shenzhen institute of advanced technology, chinese academy of sciences, china']
rossenbach25_interspeech	['machine learning and human language technology, rwth aachen university, germany', 'institute for electronic materials ii, rwth aachen university, germany', 'apptek gmbh, aachen, germany']
rong25_interspeech	['key laboratory of modern acoustics, nanjing university, china', 'nju-horizon intelligent audio lab, horizon robotics, china']
gan25_interspeech	['dept. of electrical and electronic engineering, the hong kong polytechnic university,', 'hong kong sar']
liu25e_interspeech	['institute of artificial intelligence (teleai), china telecom, china', 'tianjin key laboratory of cognitive computing and application, college of intelligence and', 'computing, tianjin university']
hovsepyan25_interspeech	['idiap research institute, martigny, switzerland,']
peng25b_interspeech	['alibaba-ntu global e-sustainability corplab, nanyang technological university, singapore', 'college of computing and data science, nanyang technological university, singapore', 'alibaba, alibaba inc., singapore']
kakouros25_interspeech	['department of digital humanities, university of helsinki, finland']
liu25f_interspeech	['shenzhen institute of advanced technology, chinese academy of sciences, china', 'university of chinese academy of sciences, beijing, china', 'key laboratory of biomedical imaging science and system, chinese academy of sciences, china', 'faculty of data science, city university of macau, macau, china']
guzik25_interspeech	['institute of electronics, agh university of krakow, poland', 'dolby laboratories, barcelona, spain']
rittergutierrez25_interspeech	['chng1, nancy f chen2, hung-yi lee3', 'nanyang technological university, singapore', 'institute for infocomm research (i2r), singapore', 'national taiwan university, taiwan']
le25b_interspeech	['bytedance, china,', '(lexiaohuai.123, chenzhuangqi.audio, sunsiyu.319, xiaxianjun,']
tao25b_interspeech	['beijing university of technology, beijing, china', 'shanghai branch of the southwest institute of electronics and telecommunication technology of', 'china, shanghai, china']
li25i_interspeech	['hangzhou institute for advanced study, university of chinese academy of sciences, china']
chao25_interspeech	['college of computing and data science, nanyang technological university, singapore', 'alibaba-ntu global e-sustainability corplab, nanyang technological university, singapore', 'alibaba, alibaba inc., singapore']
wepner25_interspeech	['signal processing and speech communication laboratory, graz university of technology, austria']
menezes25_interspeech	['institute of acoustics and speech communication, dresden university of technology, germany', 'irit, universite de toulouse, cnrs, toulouse inp, ut3, france']
hilmes25_interspeech	['rwth aachen university, aachen, germany', 'apptek gmbh, aachen, germany']
hwang25_interspeech	['department of intelligence and information, seoul national university, republic of korea', 'artificial intelligence institute, seoul national university, republic of korea', 'department of rehabilitation medicine, seoul national university bundang hospital, republic of', 'korea']
tannander25_interspeech	['speech, music and hearing, kth royal institute of technology, sweden', 'swedish agency for accessible media, mtm, sweden']
fong25_interspeech	['department of information engineering and computer science, university of trento, italy', 'center for augmented intelligence, fondazione bruno kessler, italy']
yang25f_interspeech	['school of data science, sribd, the chinese university of hong kong, shenzhen, china', 'tencent ai lab, shenzhen, china', 'nanjing university, suzhou, china', 'x-lance lab, shanghai jiao tong university, shanghai, china', 'national university of singapore, singapore']
li25j_interspeech	['the chinese university of hong kong, hong kong sar, china', 'southern university of science and technology, shenzhen, china']
paierl25_interspeech	['signal processing and speech communication laboratory, graz university of technology, austria']
taylor25_interspeech	['babblelabs, cisco systems, inc., scotland', 'babblelabs, cisco systems, inc., germany']
han25c_interspeech	['laboratory of noise and audio research, institute of acoustics, chinese academy of sciences,', 'beijing, china', 'university of chinese academy of sciences, beijing, china', 'centre for vision, speech and signal processing (cvssp), university of surrey, guildford, uk']
bagat25_interspeech	['universite de lorraine, cnrs, inria, loria, f-54000 nancy, france']
wu25e_interspeech	['gaoling artificial intelligence, renmin university of china, china', 'carnegie mellon university, usa']
park25c_interspeech	['yip3, suranga nanayakkara1', 'augmented human lab, school of computing, national university of singapore, singapore', 'department of data science, korea university, republic of korea', 'department of healthcare redesign, alexandra hospital, singapore']
roychowdhury25_interspeech	['ericsson r&d, bangalore, india', 'iiit bangalore, india', 'bits pilani, india']
zuo25b_interspeech	['dept. of electrical and electronic engineering, the hong kong polytechnic university,', 'hong kong sar, china']
kakouros25b_interspeech	['center for machine vision and signal analysis, university of oulu, finland']
lobato25_interspeech	['head acoustics gmbh']
gimenogomez25_interspeech	['prhlt, universitat politecnica de valencia, spain', 'inesc-id, lisbon, portugal', 'instituto', 'superior tecnico, universidade de lisboa, portugal', 'laboratory of clinical pharmacology and', 'therapeutics, faculdade de medicina, universidade de lisboa, portugal', 'cns - campus', 'neurologico, torres vedras, portugal', 'alcoitao health school of sciences, santa casa da', 'misericordia de lisboa, portugal']
nam25b_interspeech	['school of electrical engineering, korea advanced institute of science and technology, south korea', 'school of computer science, university of seoul, south korea', 'language technologies institute, carnegie mellon university, united states', 'department of electrical and computer engineering, seoul national university, south korea']
sun25d_interspeech	['yu2', 'school of communications and information engineering, chongqing university of posts and', 'telecommunications, chongqing, china', 'tencent ai lab, china', 'nanjing university, nanjing, china', 'institute of acoustics, chinese academy of sciences, beijing, china']
han25d_interspeech	"[""northwestern polytechnical university, xi'an, china"", 'shanghai zeekr blue new energy technology co., ltd., china']"
postma25_interspeech	['centre for language studies, radboud university nijmegen, the netherlands']
bao25_interspeech	['college of computer science, inner mongolia university, china']
choi25_interspeech	['electronics engineering, hanyang university, republic of korea', 'samsung electronics, republic of korea', 'hyundai motor company, republic of korea']
liu25g_interspeech	['school of artificial intelligence, beijing university of posts and telecommunications, china', 'center for speech and language technologies, tsinghua university, china']
akti25_interspeech	['interactive systems lab, karlsruhe institute for technology, germany', 'carnegie mellon university, usa']
liu25h_interspeech	"[""school of physical science and engineering, tongji university, people's republic of china"", 'language technologies institute, carnegie mellon university, the united states']"
franzreb25_interspeech	['german research center for artificial intelligence, germany', 'technical university of berlin, germany']
casanova25_interspeech	['nvidia corporation, usa']
parikh25_interspeech	['centre for language studies, radboud university, the netherlands']
fang25b_interspeech	['national taiwan university, taiwan,', 'independent researcher, taiwan']
chien25_interspeech	['inst. of electrical and computer engineering, national yang ming chiao tung university, taiwan', 'institute of computer and comms. security, national yang ming chiao tung university, taiwan']
cohen25_interspeech	['the school of electrical and computer engineering, tel-aviv university, israel', 'the school of computer science and ai, tel-aviv university, israel']
yang25g_interspeech	['national taiwan university, taiwan']
lee25g_interspeech	['department of computer science and engineering, korea university, korea']
shabtay25_interspeech	['ibm research, israel', 'tel-aviv university, israel']
avidan25_interspeech	['school of electrical and computer engineering, tel aviv university, israel']
liang25c_interspeech	['school of film, xiamen university, china', 'school of journalism and communication, xiamen university, china', 'zeekr smart network center, zeekr group, china', 'school of informatics, xiamen university, china']
zalkow25_interspeech	['pia1, christian dittmar1', 'fraunhofer iis, erlangen, germany', 'international audio laboratories erlangen, germany']
phaye25_interspeech	['audio machine learning, logitech']
ou25_interspeech	['school of computer and artificial intelligence, zhengzhou university, zhengzhou, china']
dong25_interspeech	['centre for language and speech technology, radboud university nijmegen, the netherlands', 'donders institute for brain, cognition and behaviour, radboud university nijmegen, the', 'netherlands']
mcghee25_interspeech	['alta institute/mil, department of engineering, university of cambridge, uk']
yan25b_interspeech	['institute of data science, maastricht university, the netherlands', 'department of respiratory medicine, nutrim research institute of nutrition and translational', 'research in metabolism, faculty of health medicine and life sciences, maastricht university, the', 'netherlands']
li25k_interspeech	['school of electronic science and engineering, xiamen university, china', 'school of electronic information, beijing jiaotong university, china', 'school of informatics, xiamen university, china']
chen25g_interspeech	['institute of linguistics, chinese academy of social sciences']
simko25_interspeech	['department of digital humanities, university of helsinki, finland', 'lel, the university of edinburgh, scotland']
hu25e_interspeech	['nvidia, usa']
mansi25_interspeech	['imperial college london, uk']
hu25f_interspeech	['˙zelasko1, zhehuai chen1, jason li1, jagadeesh balam1, boris ginsburg1', 'nvidia, usa']
li25l_interspeech	['hong∗3', 'school of electronic science and engineering, xiamen university, china', 'school of electronic information, beijing jiaotong university, china', 'school of informatics, xiamen university, china']
elleuch25_interspeech	['lia, avignon universite, france', 'elyadata, france']
acevedo25_interspeech	['facultad de ingenieria, universidad de la republica, uruguay', 'music technology group, universitat pompeu fabra, spain', 'marl-idm, new york university, usa']
mohammadamini25_interspeech	['lium, le mans university, france']
phukon25_interspeech	['department of electrical and computer engineering, university of illinois urbana-champaign, usa']
janse25_interspeech	"['centre for language studies and 2donders institute, radboud university, the netherlands', ""radboud in'to languages, radboud university, the netherlands"", 'ikerbasque (basque science foundation) and 5laslab, university of the basque country, spain']"
hu25g_interspeech	['college of computer science, inner mongolia university, china']
kim25k_interspeech	['solventum health information systems, usa']
li25m_interspeech	['nanyang technological university, singapore', 'university of palermo, italy']
vanbemmel25_interspeech	['institute for nutrition and translational research in metabolism, maastricht university, the', 'netherlands2spaarne gasthuis, the netherlands3longfonds, the netherlands4maastricht', 'university medical center, the netherlands5radboud university nijmegen, the netherlands', 'institute of data science, maastricht university, the netherlands7care and public health research', 'institute, maastricht university, the netherlands']
chao25b_interspeech	['citi, academia sinica, taiwan', 'csie, national taiwan university, taiwan', 'nvidia,']
lameris25_interspeech	['department of speech, music & hearing, kth royal institute of technology, stockholm, sweden']
vandalen25_interspeech	['ai center cambridge, samsung, united kingdom']
hu25h_interspeech	['college of computer science, inner mongolia university, china', 'college of electronic and information engineering, inner mongolia university, china']
fang25c_interspeech	"['zhejiang university, china', ""huawei noah's ark lab, china""]"
reinders25_interspeech	['respiratory medicine, nutrim institute for nutrition and translational research in metabolism,', 'maastricht university, the netherlands 2national heart and lung institute, imperial college', 'london, london, united kingdom 3department of respiratory medicine, maastricht university', 'medical center, the netherlands4department of research and development, ciro, horn, the', 'netherlands5ki:elements gmbh, saarbrucken, germany']
ambikairajah25_interspeech	['university of new south wales, australia', 'massachusetts institute of technology, usa', 'university of melbourne, australia']
dong25b_interspeech	['centre for language and speech technology, radboud university nijmegen, the netherlands', 'donders institute for brain, cognition and behaviour, radboud university nijmegen, the', 'netherlands']
fucci25_interspeech	['department of information engineering and computer science, university of trento, italy', 'machine translation unit, fondazione bruno kessler, italy']
weizman25_interspeech	['electrical and computer engineering, ben gurion university of the negev, israel', 'electrical engineering school, afeka the academic college of engineering in tel aviv, israel', 'avignon university, lia, france']
wu25f_interspeech	['microsoft, usa']
bressensdorf25_interspeech	['institute for phonetics and speech processing, ludwig maximilians university of munich.']
cr25_interspeech	['amrita school of artificial intelligence, coimbatore, amrita vishwa vidyapeetham, india.', 'department of electronics and communication, government engineering college idukki, india.']
young25_interspeech	['school of medicine and population health, university of sheffield, united kingdom', 'school of computer science, university of sheffield, united kingdom']
wang25g_interspeech	['college of computer science, nankai university, china']
vidal25_interspeech	['departamento de computacion, fceyn, uba, argentina', 'instituto de investigacion en ciencias de la computacion (icc), conicet-uba, argentina', 'maestria de explotacion de datos y descubrimiento del conocimiento, uba, argentina']
zhang25g_interspeech	['audio information research lab, university of rochester, rochester, usa']
he25_interspeech	['graduate school of informatics, nagoya university, japan', 'ai lab, cyberagent, japan', 'information technology center, nagoya university, japan']
ashihara25_interspeech	['ntt, inc., japan']
bakkouche25_interspeech	['rees1, kai alter2, brechtje post1, julia schwarz†1', 'university of cambridge, united kingdom', 'newcastle university, united kingdom']
qi25_interspeech	['key laboratory of child development and learning science (southeast university),', 'ministry of education, nanjing 210096, china', 'school of biological science and medical engineering, southeast university, china', 'huawei translation service center, china']
karpov25_interspeech	['nvidia, armenia and usa', 'plat.ai, armenia', 'buymie, armenia']
bakkouche25b_interspeech	['university of cambridge, united kingdom']
bataev25_interspeech	['nvidia, armenia', 'nvidia, usa']
charuau25_interspeech	['sigmedia group, school of engineering, trinity college dublin, ireland']
sun25e_interspeech	['laboratoire de phonetique et phonologie, cnrs & sorbonne nouvelle, france', 'crisco/ur4255, cnrs & universite de caen normandie, france', 'laboratoire interdisciplinaire des sciences du numerique, cnrs & universite paris-saclay, france']
mai25_interspeech	['ml-labs, university college dublin, ireland']
azzouz25_interspeech	['universite de lorraine, cnrs, inria, f-54000 nancy, france', 'universite de lorraine, inserm, iadi u1254, -54000 nancy, france']
kommagouni25_interspeech	['kumar vuppala1', 'ltrc, international institute of information technology-hyderabad, india']
popescu25_interspeech	['lisn, cnrs, universite paris-saclay, france']
xiang25b_interspeech	['laboratoire de phonetique et phonologie, cnrs & sorbonne nouvelle, france']
navon25_interspeech	['aiola research, israel']
sosawelford25_interspeech	['ingenieria de sonido, universidad nacional de tres de febrero, argentina', 'cognitive neuroscience center, universidad de san andres, argentina', 'instituto de investigacion en ciencias de la computacion (icc), conicet-uba, argentina', 'departamento de computacion, universidad de buenos aires, argentina']
choi25b_interspeech	['language technologies institute, carnegie mellon university, usa']
sage25_interspeech	"['faculty of biomedical engineering, silesian university of technology, poland', ""medical facility 'therapy' – center for health and human development, poland""]"
hsieh25b_interspeech	['chiang3', 'graduate institute of communication engineering, national taiwan university, taiwan', 'graduate program of teaching chinese as a second language, national taiwan university, taiwan', 'department of communication engineering, national taipei university, taiwan']
leschanowsky25_interspeech	['fraunhofer institute for integrated circuits (iis), erlangen, germany', 'department of electrical and computer engineering, university of california, san diego, usa', 'international audio laboratories erlangen, germany']
rustagi25_interspeech	['hti lab, plaksha university, mohali, india']
aggarwal25_interspeech	['j. wendt1, ehsanul haque nirjhar2, theodora chaspari1', 'university of colorado boulder, usa', 'texas a&m university, usa']
langman25_interspeech	['nvidia, usa']
bashir25_interspeech	"[""department of electrical and computer engineering, queen's university, kingston, canada"", 'department of electronic systems, aalborg university and oticon a/s, denmark']"
byun25_interspeech	['qualcomm technologies inc., usa']
tabatabaee25_interspeech	['department of electrical and computer engineering, university of maryland college park, usa', 'department of education policy, university of maryland college park, usa']
zhu25b_interspeech	['google deepmind, new york, ny, u.s.a']
gong25b_interspeech	['columbia university, usa', 'it university of copenhagen, denmark']
wen25b_interspeech	['chuan wen, sarah verhulst']
shams25_interspeech	['mesgarani1', 'department of electrical engineering, columbia university, usa', 'the feinstein institutes for medical research, usa']
masson25_interspeech	['school of computer science, university college dublin, ireland', 'centre for research training in digitally enhanced reality, research ireland, ireland', 'institut de recherche en informatique de toulouse, universite de toulouse, france']
parikh25b_interspeech	['centre for language studies, radboud university, the netherlands']
chen25h_interspeech	['wang4, rafael mosquera5,8, sara hincapie5,8, dan jurafsky3, antonis anastasopoulos2,7, hung-yi', 'lee4, karen livescu6, shinji watanabe1', 'carnegie mellon university', 'george mason university', 'stanford university', 'national taiwan', 'university', 'ml commons', 'tti-chicago', 'archimedes, athena rc', 'factored ai,']
hsieh25c_interspeech	['institute of electrical and computer engineering, national yang ming chiao tung university,', 'taiwan', 'institute of communications engineering, national yang ming chiao tung university, taiwan', 'realtek semiconductor corp., taiwan']
fischbach25_interspeech	['research center deutscher sprachatlas, philipps-universitat marburg, germany', 'lamarr institute for ml and ai, germany', 'b-it center, university of bonn, germany']
balajishankar25_interspeech	['dept of electrical and computer engineering, university of california, los angeles, usa']
portes25_interspeech	['faculty of informatics, masaryk university, brno, czech republic']
chang25b_interspeech	['new york university, usa', 'queen mary university of london, uk', 'max planck society, germany']
meyer25_interspeech	['institute for natural language processing, university of stuttgart, germany']
christodoulidou25_interspeech	['murali4, amy smith4, lauren taylor4, joanne cleland4, anja kuschmann4', 'department of theoretical & applied linguistics, aristotle university of thessaloniki, greece', 'english language & linguistics, university of glasgow, uk', 'department of linguistics, mcgill university, canada', 'department of psychological sciences & health, university of strathclyde, uk']
smith25_interspeech	['apple']
yang25h_interspeech	['center for robust speech systems (crss), university of texas at dallas, usa', 'meta ai, usa']
berger25_interspeech	['the university of edinburgh, scotland, uk']
gomezzaragoza25_interspeech	['human-tech institute, universitat politecnica de valencia, spain', 'institute for creative technologies, university of southern california, usa']
zapata25_interspeech	['department of languages, literatures and cultures, toronto metropolitan university, canada', 'department of anthropology, university of toronto, canada']
jin25b_interspeech	['samsung research america, usa']
zhang25h_interspeech	['google deepmind, mountain view, ca, u.s.a']
hsu25_interspeech	['university of southern california, usa']
jon25_interspeech	['artificial intelligence & computer vision lab., konkuk university, south korea', 'ai engine development team, voinosis inc., south korea']
hui25_interspeech	['watson2, peter j keegan3', 'acoustics and vibration research centre, university of auckland, new zealand', 'department of electrical, computer, software engineering, university of auckland, new zealand', 'te puna w¯ananga, university of auckland, new zealand']
ong25_interspeech	['arkhangorodsky1, robin huo1,2, aman sakhardande1,4, mark hallap4, naomi nagy1, ewan', 'dunbar1,2,3', 'department of linguistics, university of toronto, canada', 'department of computer science, university of toronto, canada', 'department of french, university of toronto, canada', 'department of philosophy, university of toronto, canada']
mcallister25_interspeech	['novak5', 'communicative sciences and disorders, new york university, usa', 'music and performing arts', 'professions, new york university, usa', 'applied statistics, social science, and humanities, new', 'york university, usa', 'department of music, purdue university, usa', 'electrical and computer', 'engineering, university of cincinnati, usa']
komatsu25_interspeech	['ly corporation, tokyo, japan']
ishikawa25_interspeech	['ly corporation, japan', 'keio university, japan']
kim25l_interspeech	['department of computer science and engineering, incheon national university,', 'human-centered artificial intelligence research center, incheon national university, incheon', ', republic of korea']
peng25c_interspeech	['carnegie mellon university, united states', 'honda research institute japan, japan']
shi25_interspeech	['department of computer science, william & mary, usa']
szalay25b_interspeech	['waddington3, naeim sanaei4, sheryl foster3,4, kirrie ballard3', 'macquarie university, australia', 'university of york, uk', 'university of sydney, australia;', 'westmead hospital, australia']
sun25f_interspeech	['school of computer science, university of sheffield, sheffield, uk']
jing25_interspeech	['college of computer science and technology, xinjiang university, urumqi, china', 'bnrist, department of electronic engineering, tsinghua university, beijing, china', 'key laboratory of signal detection and processing, xinjiang, urumqi, china']
kim25m_interspeech	['artificial intelligence graduate school, unist, republic of korea']
mena25_interspeech	['armentano-oller1, rodolfo zevallos1, ivan meza2, javier hernando1,3', 'langtech lab, barcelona supercomputing center, spain', 'iimas, universidad nacional', 'autonoma de mexico, mexico', 'universitat politecnica de catalunya, spain']
moriya25_interspeech	['ntt, inc., japan']
ke25_interspeech	['department of systems engineering and engineering management, the chinese university of', 'hong kong, hong kong sar', 'department of electrical and electronic engineering, the hong kong polytechnic university,', 'hong kong sar']
hu25i_interspeech	['hithink royalflush ai research institute, zhejiang, china']
lertpetchpun25_interspeech	['university of southern california, los angeles, usa']
lee25h_interspeech	['samsung research, samsung electronics, republic of korea']
si25_interspeech	['school of electronic and information engineering, south china university of technology, guangzhou, china', 'department of statistics and data science, chung-ang university, republic of korea']
xu25g_interspeech	['narayanan1', 'viterbi school of engineering, university of southern california, usa', 'school of psychology, korea university, south korea', 'weill institute for neurosciences, university of california, san francisco, usa', 'semel institute of neuroscience and human behavior, university of california, los angeles, usa']
lin25d_interspeech	['department of electrical engineering, national tsing hua university, taiwan']
huang25e_interspeech	['auditory cognition and computational acoustics lab', 'moe key lab of artificial intelligence, ai institute', 'school of computer science, shanghai jiao tong university, china', 'national institute of informatics, japan']
hu25j_interspeech	['china mobile research institute, beijing, china', 'state key laboratory of multimedia information processing, peking university, beijing, china']
ogura25_interspeech	['kawai1', 'national institute of information and communications technology, japan', 'nagoya university, japan']
zhou25c_interspeech	['school of electronic and information engineering, south china university of technology, guangzhou, china']
chou25_interspeech	['department of electrical engineering, national tsing hua university, taiwan', 'research center for information technology innovation, academia sinica, taiwan']
jahan25_interspeech	['villalba1, mark hasegawa-johnson2, najim dehak1, laureano moro-velazquez1', 'center for language and speech processing, johns hopkins university, baltimore, md, usa', 'university of illinois urbana-champaign, champaign, il, usa']
kc25_interspeech	['government engineering college barton hill, india', 'government engineering college idukki, india', 'apj abdul kalam technological university, india']
emezue25_interspeech	['owodunni1,2,5,10, handel emezue2,7, gloria monica tobechukwu emezue2,7, nefertiti nneoma', 'emezue2,7, sewade ogun6, bunmi akinremi8, david ifeoluwa adelani3,12,13, chris pal3,9,11,13', 'lanfrica', 'naijavoices', 'mila - quebec ai institute', 'mlcollective', 'the ohio state', 'university', 'inria, france', 'alex ekwueme federal university ndufu alike ikwo, nigeria,', 'obafemi awolowo university, nigeria', 'polytechnique montreal, canada', 'newrun,', 'university of montreal, canada', 'mcgill university, canada', 'canada cifar ai chair']
dong25c_interspeech	['the hong kong university of science and technology (guangzhou), china']
guo25_interspeech	['x-lance lab, moe kay lab of artificial intelligence, school of computer science, shanghai', 'jiao tong university, china', 'jiangsu key lab of language computing, china']
tran25_interspeech	['computer science department, university of southern california, usa', 'meta ai, usa']
hao25_interspeech	['laboratory of noise and audio research, institute of acoustics, chinese academy of sciences,', 'beijing, china', 'university of chinese academy of sciences, beijing, china', 'cambridge hearing group, department of psychology, university of cambridge, cambridge, uk']
chen25i_interspeech	['the chinese university of hong kong, hong kong sar, china', 'institute of software, chinese academy of sciences, china', 'national research council canada, canada']
wu25g_interspeech	['nanjing university of aeronautics and astronautics, china', 'youtu lab, tencent, china']
kondo25_interspeech	['ntt corporation, japan']
baihaqi25_interspeech	['nara institute of science and technology, japan', 'guardian robot project, riken, japan;', 'institute of science tokyo, japan', 'kyoto institute of technology, japan']
jia25_interspeech	['department of electronic engineering, tsinghua university, china', 'beijing haitian ruisheng science technology ltd., china']
hu25k_interspeech	['tencent ai lab, beijing, china', 'tencent ai lab, seattle, usa']
xu25h_interspeech	['school of humanities and social sciences, harbin institute of technology, shenzhen', 'department of chinese and bilingual studies, the hong kong polytechnic university']
kawamura25_interspeech	['ly corporation, japan']
miyahara25_interspeech	['graduate school of science and engineering, doshisha university, japan', 'faculty of science and engineering, doshisha university, japan']
guo25b_interspeech	['department of communication sciences and disorders, northwestern university, usa']
xu25i_interspeech	['machine learning and human language technology group, rwth aachen university, germany', 'apptek gmbh, germany']
halpern25_interspeech	['wieling2, defne abur2, tomoki toda1', 'nagoya university, japan', 'clcg, university of groningen, the netherlands', 'university medical', 'center groningen, the netherlands', 'lpp, cnrs/sorbonne nouvelle, france', 'bcls, vrije', 'universiteit brussel, belgium', 'department of hno, netherlands cancer institute, the netherlands']
shi25b_interspeech	['national engineering research center of speech and language information processing,', 'university of science and technology of china, hefei, p r. china']
narain25_interspeech	['huang1, miquel espi marques1, jon huang1, carlos avendano1, shirley ren1', 'apple, usa']
lin25e_interspeech	['speech-language-hearing center, school of foreign languages, shanghai jiao tong university,', 'shanghai, china', 'national research centre for language and well-being, shanghai, china']
hai25_interspeech	['department of electrical and computer engineering, johns hopkins university, md, usa', 'ai lab, tencent americas, wa, usa']
song25_interspeech	['suzhou municipal key laboratory of multimodal intelligent systems, digital innovation research', 'center, duke kunshan university, kunshan, china', 'school of computer science, wuhan university, wuhan, china']
singh25b_interspeech	['center for language & speech processing, johns hopkins university, baltimore, md, usa', 'hlt center of excellence, johns hopkins university, baltimore, md, usa']
zhou25d_interspeech	['zheng1', 'sichuan university, china', 'college of computer studies, de la salle university, the philippines']
yin25_interspeech	['northwestern polytechnical university, china', 'speech lab, alibaba group, china', 'the', 'university of melbourne, australia', 'fortemedia singapore, singapore', 'centre for vision, speech', 'and signal processing (cvssp), university of surrey, uk']
kim25n_interspeech	['school of electrical engineering, kaist, republic of korea']
hasumi25_interspeech	['ly corporation, japan']
broughton25_interspeech	['fano, hong kong sar, china']
zhang25i_interspeech	['hsu1, shrikanth narayanan2, krishna nayak2, louis goldstein1', 'linguistics, university of southern california, united states', 'electrical and computer engineering, university of southern california, united states']
zhong25_interspeech	['the chinese university of hong kong, china', 'national research council canada, canada']
ji25_interspeech	['department of chinese and bilingual studies, the hong kong polytechnic university, hong kong sar', 'department of english, tongji university, china']
pham25_interspeech	['fpt software ai center, hanoi, vietnam', 'irisa, universite bretagne sud, umr 6074, vannes, france']
bendom25_interspeech	['university of auckland, new zealand']
feng25_interspeech	['university of southern california, los angeles, usa']
subramanian25_interspeech	['microsoft corporation, usa', 'microsoft corporation, india']
fan25b_interspeech	['department of linguistics, macquarie university', 'macquarie university hearing, macquarie university']
wang25h_interspeech	['key laboratory of modern acoustics, nanjing university, china', 'nju-horizon intelligent audio lab, horizon robotics, china', 'r&d centre, samsung electronics (china), china']
dong25d_interspeech	['department of east asian languages and cultures, indiana university bloomington, usa', 'department of second language studies, indiana university bloomington, usa', 'department of linguistics, indiana university bloomington, usa']
li25n_interspeech	['state key laboratory of cognitive science and mental health, institute of psychology, chinese', 'academy of sciences, china', 'department of psychology, university of the chinese academy of sciences, china', 'school of computer, jiangsu university of science and technology, china']
b25_interspeech	['department of mathematical and computational sciences, sri sathya sai university for human', 'excellence, karnataka, india,']
shen25_interspeech	['school of computer science, inner mongolia university, china', 'department of computer science and engineering, southern university of science and', 'technology, china']
prakrankamanant25_interspeech	['department of computer engineering, faculty of engineering, chulalongkorn university, thailand', 'electrical and computer engineering, carnegie mellon university, usa']
inoue25b_interspeech	['arulkumaran, ilya horiguchi, shuntaro sasai', 'araya inc., japan']
tian25b_interspeech	['language technologies institute, carnegie mellon university, usa', 'ly corporation, japan', 'nvidia research, usa']
zhu25c_interspeech	['anhui province key laboratory of multimodal cognitive computation, school of computer', 'science and technology, anhui university, hefei', ', china']
dong25e_interspeech	['school of information engineering, nanchang university, china', 'school of computer science and technology, fudan university, china', 'st affiliated hospital of nanchang university, china']
fujita25_interspeech	['ntt, inc., japan']
someki25_interspeech	['language technologies institute, carnegie mellon university, usa', 'neural efficiency science, amazon artificial general intelligence, usa']
chandra25_interspeech	['center for language and speech processing (clsp), johns hopkins university, usa', 'the university of texas at dallas, usa', 'amazon, usa', 'nus, singapore', 'language technologies institute (lti), carnegie mellon university, usa']
wang25i_interspeech	['university of illinois at urbana-champaign, usa']
su25c_interspeech	['institute of information engineering, chinese academy of sciences, beijing, china', 'school of cyber security, university of chinese academy of sciences, beijing, china']
geng25c_interspeech	"[""gupta3, rolando coto-solano4, anna kazantseva1, marc tessier1, delaney lothian1, akwiratekha'"", 'martin1, eric joanis1, samuel larkin1, roland kuhn1', 'national research council canada, canada', 'rochester institute of technology, united states;', 'computer research institute of montreal, canada', 'dartmouth college, united states']"
feng25b_interspeech	['signal analysis and interpretation laboratory, university of southern california, usa', 'weill institute for neurosciences, university of california, san francisco, usa']
yang25i_interspeech	['shanghai jiao tong university, china']
kumar25b_interspeech	['school of computer science & engineering, galgotias university, india', 'aimotion bavaria, technische hochschule ingolstadt, germany']
park25d_interspeech	['department of artificial intelligence, korea university, south korea', 'information science, cornell university, united states', 'department of linguistics, university of pennsylvania, united states']
bhattacharya25b_interspeech	['leap lab, electrical engineering, indian institute of science, india']
liu25j_interspeech	['auditory cognition and computational acoustics lab', 'moe key lab of artificial intelligence, ai institute', 'school of computer science, shanghai jiao tong university, shanghai, china', 'zhiyuan college, shanghai jiao tong university, shanghai, china']
du25b_interspeech	['department of computer science, william & mary, usa']
ryu25_interspeech	['interdisciplinary program in cognitive science, seoul national university, republic of korea', 'department of intelligence and information, seoul national university, republic of korea', 'interdisciplinary program in artificial intelligence, seoul national university, republic of korea']
mahapatra25_interspeech	['center for language and speech processing, johns hopkins university, usa', 'language technologies institute, carnegie mellon university, usa', 'data science and ai institute (dsai), johns hopkins university, usa']
choi25c_interspeech	['school of electrical engineering, kaist, south korea', 'moe key lab of artificial intelligence, x-lance lab, school of computer science,', 'shanghai jiao tong university, china 3shanghai innovation institute, china 4geely, china']
cao25_interspeech	['key laboratory of linguistics, chinese academy of social sciences, china', 'school of chinese language and literature, beijing normal university, china']
male25_interspeech	['bhattacharya, sri garimella', 'amazon agi, bangalore, india']
hirano25_interspeech	['nara institute of science and technology, japan']
raman25_interspeech	['department of electrical engineering, indian institute of technology bombay, india']
zhang25j_interspeech	['qian1', 'shanghai jiao tong university, china 2waseda university, japan 3carnegie mellon university,', 'usa 4google deepmind, japan 5meta, usa 6technische universitat braunschweig, germany']
chae25_interspeech	['interdisciplinary program in artificial intelligence, seoul national university,', 'department of intelligence and information, seoul national university,', 'artificial intelligence institute, seoul national university, republic of korea']
chae25b_interspeech	['interdisciplinary program in artificial intelligence, seoul national university,', 'department of intelligence and information, seoul national university,', 'artificial intelligence institute, seoul national university, republic of korea']
suen25_interspeech	['fano, hong kong']
manakul25_interspeech	['pipatanakul1', 'scb 10x, scbx group, thailand', 'department of engineering, university of cambridge, united kingdom']
cheng25b_interspeech	['school of computer science, wuhan university, china', 'school of artificial intelligence, wuhan university, china', 'suzhou municipal key laboratory of multimodal intelligent systems, digital innovation research', 'center, duke kunshan university, china']
deng25_interspeech	['deng1, guinan li1, youjun chen1, huimeng wang1, haoning xu1, mingyu cui1, xunying liu1∗', 'the chinese university of hong kong, hong kong sar, china', 'institute of software, chinese academy of sciences, china', 'national research council canada, canada']
klein25_interspeech	['speech research, pindrop, usa']
sun25g_interspeech	['milm plus, xiaomi inc., china']
cui25_interspeech	['the chinese university of hong kong, hong kong sar, china', 'x-lance lab, school of computer science, shanghai jiao tong university, china', 'alibaba, china']
uniyal25_interspeech	['cse department & infosys center for ai, iiit-delhi, india']
jin25c_interspeech	['ai engine development team, voinosis inc., south korea', 'department of computer science and engineering, konkuk university, south korea']
li25o_interspeech	['x-lance lab, school of computer science, shanghai jiao tong university', 'moe key lab of artificial intelligence, jiangsu key lab of language computing, china', 'university of texas at arlington, united states']
zhang25k_interspeech	['moe key lab of artificial intelligence, jiangsu key lab of language computing, x-lance lab,', 'school of computer science, shanghai jiao tong university, china', 'department of data science and artificial intelligence, the hong kong polytechnic university,', 'china']
kwok25c_interspeech	"['college of computing and data science, nanyang technological university, singapore', 'contextual biasing improves rare word recognition of asr', 'models by prioritizing the output of rare words during decod-', 'ing. a common approach is trie-based biasing, which gives', '“bonus scores” to partial hypothesis (e.g. “bon”) that may lead', 'to the generation of the rare word (e.g. “bonham”). if the full', ""word (“bonham”) isn't ultimately recognized, the system re-"", 'vokes those earlier bonuses. this revocation is limited to beam', 'search and is computationally expensive, particularly for mod-', 'els with large decoders. to overcome these limitations, we pro-', 'pose adapting asr models to look ahead and predict multiple', 'steps at once. this avoids the revocation step entirely by better', 'estimating whether a partial hypothesis will lead to the genera-', 'tion of the full rare word. by fine-tuning whisper with only 10', 'hours of synthetic data, our method reduces the word error rate', 'on the nsc part 2 test set from 30.86% to 12.19%.']"
dao25_interspeech	['menlo research', 'ccds, nanyang technological university, singapore']
toikkanen25_interspeech	['rsc lab, modulabs, republic of korea', 'department of psychiatry, wonkwang university hospital, republic of korea']
chen25j_interspeech	['graduate institute of communication engineering, national taiwan university', 'department of computer science and information engineering, national taiwan university', 'department of electrical engineering, national taiwan university', 'independent researcher']
maeda25_interspeech	['honda research institute japan, japan']
nakagome25_interspeech	['line works corporation, japan', 'naver cloud corporation, south korea']
dasilva25_interspeech	['machine listening lab (mll), university of bremen, germany', 'cognitive systems lab (csl), university of bremen, germany', 'department of ece, national university of singapore, singapore', 'school of data science, the chinese university of hong kong, shenzhen,china']
kumar25c_interspeech	['cse department & infosys centre for ai , iiit-delhi, india']
fujita25b_interspeech	['sb intuitions, japan']
ko25_interspeech	['department of electronic engineering, hanyang university, seoul, republic of korea']
ahn25b_interspeech	['department of electronic engineering, hanyang university, seoul, republic of korea', 'department of artificial intelligence, hanyang university, seoul, republic of korea']
wang25j_interspeech	['tongyi lab, alibaba group, china']
fukunaga25_interspeech	['tokushima university, japan', 'toyohashi university of technology, japan', 'national institute of technology, anan college, japan']
lay25_interspeech	['university of hamburg, signal processing, germany', 'hamburg informatik technologie-center e.v., germany']
wu25h_interspeech	['department of seem, the chinese university of hong kong, hong kong sar, china', 'sribd, school of data science, the chinese university of hong kong, shenzhen, china', 'school of intelligence science and technology, nanjing university, suzhou, china', 'department of ece, national university of singapore, singapore']
chuang25_interspeech	['department of taiwan culture, languages, and literature, national taiwan normal university,', 'taiwan', 'institute of linguistics, academia sinica, taiwan']
chen25k_interspeech	['nerc-slip, ustc, china', 'iflytek research, iflytek co., ltd., china']
alradhi25_interspeech	['department of telecommunications and artificial intelligence, budapest university of technology', 'and economics, budapest, hungary', 'faculty of electrical engineering and information technologies, university of ss. cyril and', 'methodius, skopje, rn macedonia']
zhang25l_interspeech	['ict cluster, singapore institute of technology, singapore', 'college of computing & data science, nanyang technological university, singapore', 'division of natural and applied sciences, duke kunshan university, china']
hoang25_interspeech	['soict, hanoi university of science and technology, vietnam', 'institute for infocomm research (i2r), a∗star, singapore']
kano25_interspeech	['watanabe2', 'ntt inc., japan', 'carnegie mellon university, usa']
song25b_interspeech	['anhui province key laboratory of multimodal cognitive computation, school of computer', 'science and technology, anhui university, hefei', ', china']
kwon25_interspeech	['department of artificial intelligence, ajou university, south korea', 'department of mathematics, ajou university, south korea']
chung25_interspeech	['naver cloud, south korea']
ryu25b_interspeech	['deeply inc., republic of korea', 'seoul national university, republic of korea', 'university of california, san diego, usa']
tzeng25_interspeech	['department of electrical engineering, national tsing hua university, taiwan', 'language technologies institute, carnegie mellon university, usa']
zhang25m_interspeech	['ict cluster, singapore institute of technology, singapore', 'college of computing & data science, nanyang technological university, singapore', 'division of natural and applied sciences, duke kunshan university, china']
mimura25_interspeech	['ntt, inc., japan', 'school of informatics, kyoto university, japan']
panda25_interspeech	['tcs research, tata consultancy services, mumbai, india']
hojo25_interspeech	['nozaki2, tetsuya takiguchi1', 'graduate school of system informatics, kobe university, japan', 'graduate school of dentistry, osaka university, japan']
saijo25_interspeech	['waseda university, japan 2shanghai jiao tong university, china 3carnegie mellon university, usa', 'google deepmind, japan 5meta, usa 6technische universitat braunschweig, germany']
zhao25g_interspeech	['school of computer science and technology, xinjiang university, china', 'xinjiang key laboratory of multi-lingual information technology, china', 'joint international research laboratory of silk road multilingual cognitive computing, china', 'department of electronic engineering, tsinghua university, china', 'school of cyber security, guangdong polytechnic normal university, china']
kim25o_interspeech	['electrical and electronic engineering, yonsei university, seoul, south korea', 'electronics and telecommunications research institute, daejeon, south korea']
choi25d_interspeech	['department of electrical and electronic engineering, yonsei university, seoul, south korea', 'electronics and telecommunications research institute, daejeon, south korea']
pan25d_interspeech	['tongyi lab, alibaba group, singapore', 'nanjing university of posts and telecommunications, nanjing, china']
kim25p_interspeech	['department of psychiatry, wonkwang university hospital, republic of korea', 'rsc lab, modulabs, republic of korea', 'department of psychiatry, school of medicine, wonkwang university, republic of korea']
xiang25c_interspeech	['school of computer science and technology, xinjiang university, china']
li25p_interspeech	['auditory cognition and computational acoustics lab', 'moe key lab of artificial intelligence, ai institute', 'school of computer science, shanghai jiao tong university, china', 'tencent ai lab, usa']
phan25_interspeech	['getman1, ekaterina voskoboinik1, tamas grosz1, mikko kurimo1', 'department of information and communications engineering, aalto university, finland', 'department of language and communication studies, university of jyvaskyla, finland', 'department of education, university of helsinki, finland']
nie25_interspeech	['apple, usa', 'the university of north carolina at chapel hill, usa;', 'johns hopkins university, usa']
yamamoto25_interspeech	['cyberagent, japan']
yang25j_interspeech	['human language technology and pattern recognition, computer science department, rwth', 'aachen university, germany', 'apptek gmbh, germany']
chen25l_interspeech	['university of washington,', 'google ar,', 'google deepmind,']
wang25k_interspeech	['beijing fosafer information technology co., ltd., china']
birkholz25b_interspeech	['institute of acoustics and speech communication, tu dresden, germany', 'institute of textile machinery and high performance material technology, tu dresden, germany', 'cnrs, ietr-umr 6164, universite de rennes, france']
luo25b_interspeech	['school of electronic science and engineering, xiamen university, china', 'school of informatics, xiamen university, china']
grigoryan25_interspeech	['ginsburg2', 'nvidia, armenia', 'nvidia, usa']
cho25_interspeech	['department of artificial intelligence, korea university, seoul, korea']
cho25b_interspeech	['department of artificial intelligence, korea university, seoul, korea']
tan25_interspeech	['ping an technology, china']
choi25e_interspeech	['department of artificial intelligence, korea university, seoul, korea']
mitsumori25_interspeech	['waseda university, japan', 'waseda research institute for science and engineering, japan']
khanday25_interspeech	['dept. signal theory, telematics, and communications, university of granada, spain', 'dept. of experimental psychology, university of granada,, spain', 'gitam, andhra pradesh, india']
puhach25_interspeech	['department of linguistics and philology, uppsala university, sweden', 'division of software and computer systems, kth, sweden', 'department of speech, music, and hearing, kth, sweden']
nguyen25c_interspeech	['karlsruhe institute of technology, germany', 'carnegie mellon university, usa']
du25c_interspeech	['shenzhen university, shenzhen 518055, china', 'university of science and technology of china, hefei 230027, china', 'east china normal university, shanghai 200241, china']
guo25c_interspeech	['national engineering research center of speech and language information processing, university', 'of science and technology of china, hefei, p r. china']
phuong25_interspeech	['soict, hanoi university of science and technology, vietnam', 'institute for infocomm research (i2r), a∗star, singapore']
kong25b_interspeech	['school of computer science and technology, xinjiang university, china', 'speech processing and machine intelligence (spmi) lab, tsinghua university, china']
wu25i_interspeech	['national institute of informatics, japan', 'academia sinica, taiwan']
dang25_interspeech	['graduate school of informatics, nagoya university, japan', 'ai lab, cyberagent, inc., japan']
zhang25n_interspeech	['faculty of computing, harbin institute of technology, harbin, china']
mak25_interspeech	['fano, hong kong']
attia25_interspeech	['electrical and computer engineering, university of maryland,', 'graduate school of education, stanford university,', 'college of education, university of maryland,']
shi25c_interspeech	['graduate school of informatics, nagoya university, japan', 'faculty of data science, city university of macau, china', 'information technology center, nagoya university, japan']
biyani25_interspeech	['media analysis group, sony research india, bangalore', 'indraprastha institute of information technology (iiit), delhi, india']
hu25l_interspeech	['department of intelligent systems, nagoya university, japan', 'cyberagent, japan', 'digital', 'content and media sciences research division, national institute of informatics, japan']
alabi25_interspeech	['saarland university, saarland informatics campus, germany', 'national institute of informatics, japan']
white25b_interspeech	"['the radar-cns consortium10', ""institute of psychiatry, psychology and neuroscience, king's college london, uk"", 'thymia, london, uk', 'inesc-id, portugal', 'school of psychology, university of sussex, falmer, uk', 'south london and maudsley nhs foundation trust, london, uk', 'janssen research and development llc, titusville, nj, united states', 'institute of health informatics, university college london, uk', ""davos alzheimer's collaborative"", 'instituto superior tecnico, university of lisbon, portugal', 'www.radar-cns.org']"
shi25d_interspeech	['graduate school of informatics, nagoya university, japan', 'faculty of data science, city university of macau, china', 'information technology center, nagoya university, japan']
zheng25b_interspeech	['nercms, school of computer science, wuhan university, china', 'tencent youtu lab, china']
glazer25_interspeech	['bar ilan university, israel']
rautenberg25_interspeech	['department of communications engineering, paderborn university, germany', 'phonetics work group, faculty of linguistics and literary studies, bielefeld university, germany']
shi25e_interspeech	['graduate school of informatics, nagoya university, japan', 'faculty of data science, city university of macau, china', 'information technology center, nagoya university, japan']
yu25b_interspeech	['department of computer science and engineering, the ohio state university, usa', 'center for cognitive and brain sciences, the ohio state university, usa', 'meta reality labs, usa']
jiang25b_interspeech	['national engineering research center of speech and language information processing, university', 'of science and technology of china, hefei, china', 'ict cluster, singapore institute of technology, singapore']
terashima25_interspeech	['ly corporation, japan']
wang25l_interspeech	['school of foreign languages, qingdao university, qingdao, china', 'department of linguistics and translation, city university of hong kong, hong kong sar']
yao25b_interspeech	['institute of big data science and industry, school of computer and information technology,', 'shanxi university, china']
yang25k_interspeech	['zhejiang university, china', 'school of engineering, westlake university, china', 'institute of advanced technology, westlake institute for advanced study, china']
li25q_interspeech	['institute for communications technology, technische universitat braunschweig,', 'braunschweig, germany']
agrawal25_interspeech	['indian institute of science, bangalore, india', 'google, bangalore, india']
zhang25o_interspeech	['national institute of informatics, japan', 'nagoya university, japan', 'duke kunshan university, china']
gogate25_interspeech	['school of computing, engineering & the built environment, edinburgh napier university, united', 'kingdom']
yosha25_interspeech	['the school of computer science and engineering', 'the hebrew university of jerusalem, israel']
kim25q_interspeech	['department of artificial intelligence, sejong university, republic of korea', 'department of artificial intelligence and data science, sejong university, republic of korea']
jeong25_interspeech	['seoul national university of science and technology, south korea']
liang25d_interspeech	['institute of acoustics chinese academy of science, beijing, china', 'university of chinese academy of sciences, beijing, china', 'jiangsu key university laboratory of software and media technology under human-computer', 'cooperation, jiangnan university, wuxi, china']
marchini25_interspeech	['linguistics and english language, university of edinburgh, uk']
ho25_interspeech	['zalo ai, vietnam', 'university of science, ho chi minh city, vietnam', 'vietnam national university, ho chi minh city, vietnam', 'corresponding author: duc chau. (*) indicates equal contribution.']
gao25e_interspeech	['college of computer science, sichuan university, china', 'national key laboratory of fundamental science on synthetic vision, sichuan university,', 'china']
takahashi25_interspeech	['toyohashi university of technology, japan']
wu25j_interspeech	['department of electrical and computer engineering, university of british columbia, canada']
mohsin25_interspeech	['aligarh muslim university, india', 'vit bhopal university, india', 'university of edinburgh, uk;', 'edinburgh napier university, uk. ,']
negroni25_interspeech	['dipartimento di elettronica, informazione e bioingegneria, politecnico di milano, italy']
choi25f_interspeech	['ipai, interdisciplinary program in artificial intelligence, seoul national university, korea', 'department of intelligence and information, seoul national university, korea']
que25_interspeech	['department of computer science, the university of sheffield, united kingdom']
villani25_interspeech	"['dept. of electronic systems, aalborg university, denmark', ""dept. electr. and computer eng., queen's university, canada"", 'oticon a/s, denmark']"
elkheir25b_interspeech	['olamide toyin5, sadeen alharbi6, modar alfadly6, lamya alkanhal6, ibrahim selim7, shehab', 'elbatal7, salima mdhaffar8, thomas hain3, yasser hifny7, mostafa shahin9, ahmed ali6', 'dfki', 'alexandria univ.', 'univ. of sheffield', 'taibah univ.', 'mbzuai', 'sdaia', 'helwan', 'univ.', 'univ. of avignon', 'univ. of new south wales ,']
qin25_interspeech	['speech and audio signal processing laboratory, beijing university of technology, china', 'institute of ai (teleai), china telecom, china']
ma25_interspeech	['school of computer science and technology, xinjiang university, china', 'guangxi radio and television monitoring center, guangxi, china', 'speech processing and machine intelligence (spmi) lab, tsinghua university, china']
mojarad25_interspeech	['department of english language and linguistics, institute of english and american studies,', 'faculty of arts and humanities, heinrich heine university dusseldorf, germany', 'department of linguistics, university of florida, united states of america']
gu25c_interspeech	['national engineering research center of speech and language information processing, university', 'of science and technology of china, hefei, china', 'ict cluster, singapore institute of technology, singapore']
luo25c_interspeech	['school of electronic science and engineering, xiamen university, china', 'school of informatics, xiamen university, china']
chochlakis25_interspeech	['university of southern california, usa', 'aws ai labs, usa']
kienegger25_interspeech	['signal processing (sp), university of hamburg, germany']
he25b_interspeech	['school of electronic information, wuhan university, wuhan, hubei, china', 'school of computing and artificial intelligence, southwestern university of finance and', 'economics, chengdu, sichuan, china']
bandekar25_interspeech	['department of electrical engineering, indian institute of science, bengaluru, india']
wang25m_interspeech	"[""polytechnical university, xi'an, china"", 'bytedance inc., sydney, australia']"
deheerkloots25_interspeech	['institute for logic, language and computation, university of amsterdam, the netherlands', 'cognitive science and artificial intelligence, tilburg university, the netherlands', 'centre for language studies, radboud university, netherlands']
ozer25_interspeech	['sony ai', 'sony group corporation']
zhou25e_interspeech	['school of informatics, kyoto university, japan', 'shenzhen international graduate school,', 'tsinghua university, china', 'nanyang technological university, singapore', 'institute of science', 'tokyo, japan', 'department of electronic engineering, tsinghua university, china']
huttner25_interspeech	['rotger-griful1', 'eriksholm research centre, oticon a/s, snekkersten, denmark', 'department of health technology, technical university of denmark, kongens lyngby, denmark']
m25_interspeech	['speech processing lab, ltrc, international institute of information technology-hyderabad, india', 'samsung research & development institute-bengaluru, india']
shah25_interspeech	['cvit, kohli centre for intelligent systems, iiit hyderabad, india', 'tcs research, pune, india']
li25r_interspeech	['shenzhen international graduate school, tsinghua university, china', 'milm plus, xiaomi inc., china']
xia25_interspeech	['honor device co, ltd, china', 'auditory cognition and computational acoustics lab', 'moe key lab of artificial intelligence, ai institute', 'school of computer science, shanghai jiao tong university, shanghai, china']
xiao25d_interspeech	['institute for natural language processing, university of stuttgart, germany']
shao25b_interspeech	['northwestern polytechnical university, china', 'iqiyi, inc, china']
lu25d_interspeech	['national institute of information and communications technology, japan', 'research center for information technology innovation, academia sinica, taiwan']
toyin25_interspeech	['mohamed bin zayed university of artificial intelligence, uae']
jing25b_interspeech	['school of information science and engineering, southeast university, china', 'ai research center, midea group (shanghai) co.,ltd., china']
laquatra25_interspeech	['♦kore university of enna, italy, ♣politecnico di torino, italy, ♠universita di palermo, italy']
dai25b_interspeech	['audio research group, tampere university, finland']
das25_interspeech	['german research center for artificial intelligence, germany', 'technical university berlin, germany', 'gretchen ai gmbh, germany']
klejch25_interspeech	['centre for speech technology research, university of edinburgh, united kingdom', 'celtic and scottish studies, university of edinburgh, united kingdom']
nguyen25d_interspeech	['vietai research, new turing institute, vietnam', 'phenikaa university, vietnam', 'institute of information technology, vietnam']
sankala25_interspeech	['department of electrical engineering, indian institute of technology hyderabad, india']
wang25n_interspeech	['faculty of computing, harbin institute of technology, china']
liu25k_interspeech	['national engineering research center of speech and language information processing, university', 'of science and technology of china, hefei, p r. china', 'interdisciplinary research center for linguistic sciences, university of science and technology of', 'china, hefei, p r. china', 'centre for speech technology research, university of edinburgh, uk', 'department of electronic engineering and information science, university of science and', 'technology of china, hefei, p r. china']
battula25_interspeech	['tcs reseach and innovation pune, india']
wang25o_interspeech	['oppo, china', 'institute of acoustics, chinese academy of sciences, china']
takeuchi25_interspeech	['ntt corporation, japan']
li25s_interspeech	['school of data science, the chinese university of hong kong, shenzhen, china', 'school of intelligence science and technology, nanjing university, suzhou, china', 'shenzhen research institute of big data, shenzhen, china', 'tencent ethereal audio lab, tencent, shenzhen, china']
wang25p_interspeech	['faculty of computing, harbin institute of technology, china']
xu25j_interspeech	['tencent ai lab, beijing, china', 'tencent ai lab, seattle, usa', 'institute of automation, chinese academy of sciences, beijing, china']
yang25l_interspeech	['school of electronic and information engineering, south china university of technology, china', 'ant group, china']
futami25_interspeech	['arora3, shinji watanabe3', 'sony group corporation, japan', 'sony europe, germany', 'carnegie mellon university, usa']
zhou25f_interspeech	['su1,2, lan wang1,2, nan yan1,2', 'shenzhen institute of advanced technology, chinese academy of sciences, china', 'key laboratory of biomedical imaging science and system, chinese academy of sciences, china', 'shenzhen mental health center/shenzhen kangning hospital, china']
liu25l_interspeech	['national engineering research center of speech and language information processing, university', 'of science and technology of china, hefei, p r. china', 'interdisciplinary research center for linguistic sciences, university of science and technology of', 'china, hefei, p r. china']
zhou25g_interspeech	['orka labs inc., china', 'electrical engineering, stanford university, united states', 'materials science and engineering, stanford university, united states']
lim25_interspeech	['seoul national university of science and technology, south korea']
choi25g_interspeech	['electronics and telecommunications research institute, south korea', 'university of science and technology, south korea', '†']
koudounas25_interspeech	['†politecnico di torino, turin, italy', '‡kore university of enna, enna, italy', '⋆universita degli studi di palermo, palermo, italy']
fang25d_interspeech	['zhengzhou university, china', 'wuhan university, china', 'college of computer science and technology, national university of defense technology, china', 'durham university, united kingdom']
kamo25_interspeech	['ntt corporation, japan']
kutsakov25_interspeech	['salutedevices, russia']
proctor25_interspeech	['macquarie university, australia', 'university of york, united kingdom', 'university of sydney, australia', 'westmead hospital, australia']
zevallos25_interspeech	['hernando1,3', 'langtech lab, barcelona supercomputing center, spain', 'centre de llenguatge i computacio,', 'universitat de barcelona, spain', 'universitat politecnica de catalunya (upc), spain', '(rodolfo.zevallos, marti.cortada, sarah.solito, carlos.hernandez,']
yu25c_interspeech	['department of ai, big data & management, kookmin university, republic of korea']
gao25f_interspeech	['coler1', 'speech technology lab, university of groningen, the netherlands', 'english and communication, the hong kong polytechnic university, hong kong']
lin25f_interspeech	['school of data science, the chinese university of hong kong, shenzhen, china', 'machine listening lab, university of bremen, germany', 'department of ece, national university of singapore, singapore']
xing25_interspeech	['south china university of technology, china', 'meituan, china', 'pazhou lab, china']
jacquelin25_interspeech	['univ. grenoble alpes, cnrs, grenoble inp, gipsa-lab, france', 'vogo, france']
lu25e_interspeech	['samsung r&d institute china-beijing, china', 'mobile experience business, samsung electronics, republic of korea']
yoshinaga25_interspeech	['national institute of advanced industrial science and technology (aist), japan', 'waseda university, japan', 'doshisha university, japan', 'kyoto university, japan']
gupta25_interspeech	['samsung research institute bangalore', 'texas instruments, bangalore, india']
piyadasa25_interspeech	['szalay4, naeim sanaei5, sheryl foster1,5, david waddington1, craig jin1', 'the university of sydney, australia,2universite paris cite, france,3university of york, united', 'kingdom,4macquarie university, australia,5westmead hospital, australia']
xue25_interspeech	['polytechnical university, china', 'bytedance, china']
a25_interspeech	['college of engineering trivandrum, india', 'government engineering idukki, india', 'apj abdul kalam technological university, india']
liu25m_interspeech	['key laboratory of child development and learning science of ministry of education, school of', 'biological science and medical engineering, southeast university, nanjing 211189, china']
cordlandwehr25_interspeech	['paderborn university, communications engineering department, germany']
sofer25_interspeech	['originai, israel']
zhao25h_interspeech	['auditory cognition and computational acoustics lab', 'moe key lab of artificial intelligence, ai institute', 'school of computer science, shanghai jiao tong university, shanghai,china', 'suzhou institute of artificial intelligence, shanghai jiao tong university, suzhou,china']
xu25k_interspeech	['li1, lei xie2', 'institute of artificial intelligence (teleai), china telecom, china', 'northwestern polytechnical university, china']
lu25f_interspeech	['school of foreign languages, tianjin university, china', 'key laboratory of linguistics, chinese academy of social sciences, china']
sun25h_interspeech	['laboratoire de phonetique et phonologie, cnrs & sorbonne nouvelle, france', 'laboratoire interdisciplinaire des sciences du numerique, cnrs & universite paris-saclay, france']
liu25n_interspeech	['department of chinese language and literature, east china normal university, china', 'department of chinese and bilingual studies, the hong kong polytechnic university, hong kong', 'department of psychology, university of essex, uk', 'experimental psychology, university college london, uk']
xue25b_interspeech	"[""frontier institute of science and technology, xi'an jiaotong university, china"", 'department of language science and technology, saarland university, germany']"
li25t_interspeech	['south china university of technology, china', 'pazhou lab, china']
li25u_interspeech	['northwestern polytechnical university, china', 'huawei cloud, china']
kim25r_interspeech	['department of imaging science and arts, chung-ang university, south korea', 'department of metaverse convergence, chung-ang university, south korea']
vauquier25_interspeech	['nijta sas, france', 'universite de lorraine, cnrs, inria, loria, f-54000 nancy, france']
ugan25_interspeech	['interactive systems lab, karlsruhe institut of technology (kit), germany', 'interact, carnegie mellon university (cmu), usa']
tran25b_interspeech	['marteau3', 'univ rennes, irisa, cnrs, france 2univ le mans, lium, france', 'univ bretagne sud, irisa, cnrs, france']
hannan25b_interspeech	['university of trento, italy', 'fondazione bruno kessler, italy', 'johannes kepler university linz, austria', 'mohamed bin zayed university of artificial intelligence, u.a.e.']
tan25b_interspeech	['lu1,3', 'key laboratory of modern acoustic, nanjing university, china', 'bytedance, china', 'nju-horizon intelligent audio lab, horizon robotics, china']
tadevosyan25_interspeech	['nvidia, armenia', 'nvidia, usa']
prakash25_interspeech	['uniphore systems, india & usa', 'shankar.venkatesan, andreas.stolcke}uniphore.com']
wang25q_interspeech	['suzhou municipal key laboratory of multimodal intelligent system, digital innovation research', 'center, duke kunshan university, china', 'integrated graduate school of medicine, engineering, and agricultural sciences, university of', 'yamanashi, japan', 'school of computer science, wuhan university, china']
vurma25_interspeech	['estonian academy of music and theatre, estonia', 'tallinn university of technology, estonia']
song25c_interspeech	['key laboratory of modern acoustics, nanjing university, china', 'nju-horizon intelligent audio lab, horizon robotics, china']
zhao25i_interspeech	['department of electronic engineering and information science, university of science and', 'technology of china, china', 'rdg group, iflytek research, china']
bodur25_interspeech	['aix-marseille univ, cnrs, lpl, aix-en-provence, france', 'avignon universite, lia, avignon, france']
jun25_interspeech	['department of electrical and computer engineering and inmc,', 'seoul national university, seoul, south korea']
sharon25_interspeech	['department of computer science, iit madras, india']
szekely25_interspeech	['department of speech, music and hearing, kth royal institute of technology, sweden', 'hun-ren research center for linguistics, budapest university of techn. and econ., hungary', 'institute of informatics, university of szeged, hungary']
teplansky25_interspeech	['department of speech, language, and hearing sciences', 'department of neurology, dell medical school', 'the university of texas at austin, united states']
deoliveira25_interspeech	['signal processing group, university of hamburg, germany']
mcguire25_interspeech	['national tsing hua university, taiwan']
wang25r_interspeech	['school of computer science and technology (school of artificial intelligence), zhejiang sci-tech', 'university, china', 'school of information science and engineering, zhejiang sci-tech university, china']
wang25s_interspeech	"[""polytechnical university, xi'an, china"", 'huawei technologies, china']"
kaneko25_interspeech	['ntt corporation, japan']
turnbull25_interspeech	['school of english literature, language and linguistics, newcastle university, uk', 'laboratoire de sciences cognitives et psycholinguistique, ens-psl / cnrs / ehess, paris,', 'france']
zhang25p_interspeech	['school of computer science, wuhan university, china', 'school of artificial intelligence, wuhan university, china', 'suzhou municipal key laboratory of multimodal intelligent systems, digital innovation research', 'center, duke kunshan university, china']
guillaume25_interspeech	['univ. lille, cnrs umr 9193 - scalab - sciences cognitives et sciences affectives, f-59000,', 'lille, france', 'univ. grenoble alpes, univ. savoie mont blanc, cnrs, lpnc', ' grenoble, france']
liu25o_interspeech	['national engineering research center of speech and language information processing, university', 'of science and technology of china, china', 'tencent ai lab, china']
zezario25_interspeech	['academia sinica, taiwan', 'university of palermo, italy', 'southern university of science and technology, china']
koutsianos25_interspeech	['department of informatics, athens university of economics and business, greece', 'archimedes/athena rc, greece', 'department of informatics and telecommunications, national and kapodistrian university of', 'athens, greece', 'omilia - conversational intelligence, greece']
giraldo25_interspeech	['langtech lab, barcelona supercomputing center, spain', 'centre de llenguatge i computacio,', 'universitat de barcelona, spain', 'dfki gmbh, saarland informatics campus, germany']
kaneko25b_interspeech	['ntt corporation, japan']
wang25t_interspeech	['signal processing research center, tampere university, finland', 'nokia technologies, finland']
chen25m_interspeech	['the chinese university of hong kong, hong kong sar, china', 'shenzhen international graduate school, tsinghua university, shenzhen, china', 'vocal engineering technologies limited, hong kong sar, china']
qian25b_interspeech	['kth royal institute of technology, sweden']
park25e_interspeech	['seoul national university, south korea,']
dewhurst25_interspeech	"['linguistics and english language, lancaster university, united kingdom', ""department of language and communication science, city st george's, university of london,"", 'united kingdom']"
liang25e_interspeech	['zou*1', 'guangdong provincial key laboratory of ultra high definition immersive media technology,', 'shenzhen graduate school, peking university, china', 'the chinese university of hong kong,', 'china', 'south china university of technology, china']
li25v_interspeech	['the chinese university of hong kong, china', 'institute of software, chinese academy of sciences, china', 'department of electronic engineering, tsinghua university, china']
sun25i_interspeech	['polytechnical university, china', 'space ai, li auto']
ren25b_interspeech	['school of informatics, xiamen university, china', 'school of electronic science and engineering, xiamen university, china']
lin25g_interspeech	"[""northwestern polytechnical university, xi'an, china"", 'chongqing changan automobile co., ltd., china']"
alcalapadilla25_interspeech	['communication acoustics and cluster of excellence hearing4all, carl von ossietzky universitat', 'oldenburg, germany', 'bose corporation, usa']
maji25_interspeech	['indian institute of technology kharagpur, india', 'university of copenhagen, denmark']
ma25b_interspeech	['alta institute, department of engineering, university of cambridge, uk']
alumae25_interspeech	['department of software science, tallinn university of technology, estonia']
li25w_interspeech	['school of chinese language and literature, beijing normal university, china', 'key laboratory of linguistics, chinese academy of social sciences, china', 'research center for collation and standardization of chinese characters, china', 'note: yaolin zhou is a visiting student at the key laboratory of linguistics, chinese academy of social sciences.', '\uf02acorresponding author.']
park25f_interspeech	['emotech ltd., london, uk', 'school of computer science, university of sheffield, uk']
kponou25_interspeech	['institut de mathematiques et de sciences physiques, dangbo, benin', 'lia, avignon, france', 'opscidia, paris, france']
zhong25b_interspeech	['centre for language studies, radboud university, the netherlands']
kalda25_interspeech	['tallinn university of technology, estonia', 'irit, universite de toulouse, cnrs, toulouse, france']
abdullah25_interspeech	['language science and technology, saarland university, germany', 'camb.ai, uae']
huang25f_interspeech	['city university of macau', 'national tsing hua university']
yoneyama25_interspeech	['nagoya university, japan', 'ly corporation, japan']
berthommier25_interspeech	['univ. grenoble alpes, cnrs, grenoble inp, gipsa-lab, france']
wang25u_interspeech	['southeast university, nanjing, china', 'monash university, melbourne, australia', 'r *corresponding author:']
linke25_interspeech	['signal processing and speech communication laboratory, graz university of technology, austria']
istaiteh25_interspeech	['lia, avignon university, france']
magoshi25_interspeech	['graduate school of informatics, kyoto university, japan']
kanamori25_interspeech	['saruwatari1', 'the university of tokyo, japan', 'keio university, japan']
li25x_interspeech	['school of foreign languages, tianjin university, china']
mehralian25_interspeech	['department electrical engineering esat-psi, ku leuven, belgium']
leygue25_interspeech	['universite paris-saclay, cea, list, f-91120, palaiseau, france']
li25y_interspeech	['key laboratory of linguistics, chinese academy of social sciences , china', 'corpus and computational linguistics center, chinese academy of social sciences, china', 'university of chinese academy of social sciences, china,', 'beijing international studies university, china,']
zhang25q_interspeech	"['the chinese university of hong kong, hong kong sar, china', 'independent researcher, seattle, wa, usa', ""xi'an jiaotong liverpool university, suzhou, china""]"
franz25_interspeech	['department of technology and health for people, jade university of applied sciences, oldenburg,', 'germany', 'communication acoustics and cluster of excellence hearing4all, carl von ossietzky university,', 'oldenburg, germany']
havard25_interspeech	"[""lll, universite d'orleans, cnrs"", ' orleans, france', 'lig, universite grenoble alpes, cnrs, grenoble inp', ' grenoble, france', ""langse, universite d'etat d'haiti, port-au-prince, haiti""]"
hopponen25_interspeech	['school of humanities, university of eastern finland, finland', 'school of computing, university of', 'eastern finland, finland', 'faculty of humanities, university of oulu, finland', 'forensic laboratory', 'of national bureau of investigation, finland', 'tallinn university of technology, estonia']
lu25g_interspeech	['research centre for language, cognition, and neuroscience, department of chinese and bilingual', 'studies, the hong kong polytechnic university, hong kong, china']
silveira25_interspeech	['ifl phonetik, university of cologne, germany', 'iel, universidade de campinas, brazil']
li25z_interspeech	['department of electrical and electronic engineering, the hong kong polytechnic university', 'institute of electrical and computer engineering, national yang ming chiao tung university', 'department of electrical engineering, stanford university', 'systems engineering & engineering management, the chinese university of hong kong']
koudounas25b_interspeech	['politecnico di torino, italy', 'kore university of enna, italy', 'san feliciano hospital, italy', 'ospedale san giovanni bosco, italy', 'universita degli studi di torino, italy', 'universita degli studi di palermo, italy']
shao25c_interspeech	"['laboratoire de phonetique et phonologie, cnrs & universite sorbonne nouvelle, france', ""departement d'etudes cognitives, ecole normale superieure, universite psl, france""]"
li25aa_interspeech	['school of computer science, xiangtan university, china', 'school of software & microelectronics, peking university, china']
wang25v_interspeech	['microsoft research asia, microsoft, china', 'school of foreign studies, tongji university, china']
sinha25_interspeech	['department of electronics and communication engineering, nit sikkim, india', 'department of information and communications engineering, aalto university, finland']
yang25m_interspeech	['school of computer science and technology, xinjiang university, china', 'institute of science tokyo, japan', 'joint international research laboratory of silk road multilingual cognitive computing, china', 'xinjiang key laboratory of multi-lingual information technology, china', 'college of computing and data science, nanyang technological university, singapore']
zhao25j_interspeech	['department of linguistics, cornell university, usa']
so25_interspeech	['the chinese university of hong kong,', 'university of oxford,', 'university college dublin,']
vangysel25_interspeech	['apple, usa', 'meta, usa']
dai25c_interspeech	"[""northwestern polytechnical university, xi'an, china"", 'beijing aishell technology co., ltd., beijing, china', 'li auto inc., beijing, china']"
pahuja25_interspeech	['machine listening lab (mll), university of bremen, germany', 'cognitive systems lab (csl),', 'university of bremen, germany', 'department of ece, national university of singapore, singapore;', 'school of data science, the chinese university of hong kong, shenzhen,china']
serbest25_interspeech	['electrical and electronics engineering, ecole polytechnique federale de lausanne (epfl),', 'switzerland', 'audio machine learning, logitech, switzerland']
rosero25_interspeech	"['alex a kane5, rami r hallac5,6, carlos busso1', 'language technologies institute, carnegie mellon university, pa, usa', 'array innovation, bh;', 'ece, the university of texas at dallas, tx, usa', 'clsp, johns hopkins university, md, usa;', 'department of plastic surgery, university of texas southwestern medical center, tx, usa;', ""analytical imaging and modeling center, children's health, tx, usa;""]"
ofaolain25_interspeech	['school of computer science, university college dublin, ireland']
do25_interspeech	['japan advanced institute of science and technology, japan']
urai25_interspeech	['department of computer engineering, faculty of engineering, chulalongkorn university, thailand']
grossman25_interspeech	['kensho technologies, usa', 'nvidia corporation, usa']
mohamedismailyasararafath25_interspeech	['department of electrical engineering, indian institute of technology, kharagpur, india', 'counselling centre, indian institute of technology, kharagpur, india']
buech25_interspeech	['laboratoire de phonetique et phonologie, universite sorbonne nouvelle, cnrs, paris, france']
shen25b_interspeech	['tilburg university, the netherlands', 'university of groningen, the netherlands']
ick25_interspeech	['mitsubishi electric research laboratories (merl), cambridge, ma, usa', 'music and audio research laboratory, new york university, brooklyn, ny, usa']
wang25w_interspeech	['university of edinburgh, united kingdom']
scheck25_interspeech	['cognitive systems lab, university of bremen, germany', 'berkeley artificial intelligence research, university of california, usa', 'supsi, idsia & meditech, switzerland']
mai25b_interspeech	['school of electronic and information engineering, south china university of technology, china', 'school of future technology, south china university of technology, china', 'systems engineering & engineering management, the chinese university of hong kong, china']
valente25_interspeech	['university of aveiro, portugal', 'speechcare center', 'mbzuai, uae', 'instituto brasileiro de', 'fluencia, brazil']
sasu25_interspeech	['computer science, it university of copenhagen, denmark']
alexos25_interspeech	['vishnubhotla2, kyu j han⋆2, srikanth ronanki2', 'university of california, irvine', 'amazon web services, ai labs']
coppietersdegibson25_interspeech	['idiap research institute, switzerland', 'ecole polytechnique federale de lausanne, switzerland']
pierotti25_interspeech	"['the biorobotics institute and department of excellence in robotics and ai, scuola superiore', ""sant'anna, pisa, italy"", ""health science interdisciplinary research center, scuola superiore sant'anna, pisa, italy"", 'kite research institute, university health network, toronto, on, canada']"
meng25b_interspeech	['the centre for speech technology research, university of edinburgh, united kingdom']
zheng25c_interspeech	['ai lab, giant network, china', 'the east china university of science and technology, china']
maison25_interspeech	"[""laboratoire informatique d'avignon, avignon university, france"", 'cirst, universite du quebec a montreal, canada', 'thales, france']"
havras25_interspeech	['voiceinteraction, lisbon, portugal', 'flul, university of lisbon, lisbon, portugal', 'inesc-id, lisbon, portugal']
mayer25_interspeech	['university of stuttgart, germany', 'apptek gmbh, germany']
lalay25_interspeech	['telecom paris, institut polytechnique de paris, ltci, france']
zhang25r_interspeech	"['dept. of computer science, ucla, usa 2dept. of linguistics, ucla, usa 3dept. of linguistics,', 'stanford university, usa 4dept. of communication, ucla, usa 5department of computer', ""science george washington university, usa 6departement d'etudes cognitives, ens, france,""]"
joubaud25_interspeech	['acoustics and protection of the soldier, french-german research institute of saint-louis, france', 'laboratoire de mecanique des structures et des systemes couples, conservatoire national des arts', 'et metiers, france']
hu25m_interspeech	['college of computer science, inner mongolia university, china']
watkins25_interspeech	['university of amsterdam, the netherlands', 'institute for phonetics and speech processing, lmu munich, germany']
hou25b_interspeech	['school of artificial intelligence, shanghai jiao tong university, china', 'ant group, china;', 'school of cyber science and engineering, wuhan university, china']
burkhardt25_interspeech	['eyben1,2, bj¨orn schuller1,3,4,6', 'audeering gmbh, germany', 'agile robots, germany', 'tu-munich, germany', 'imperial', 'college london, england', 'tu-berlin, germany', 'munich data science institute, munich, germany']
gallego25_interspeech	['barcelona supercomputing center, spain', 'universitat politecnica de catalunya, spain']
do25b_interspeech	['faculty of computer science, university of information technology, ho chi minh city, vietnam', 'faculty of information science and engineering, university of information technology,', 'ho chi minh city, vietnam', 'vietnam national university, ho chi minh city, vietnam']
shi25f_interspeech	['language technologies institute, carnegie mellon university, u.s.a.']
sasu25b_interspeech	['computer science, it university of copenhagen, denmark', 'intelligent agents research group, university of florida, u.s.a', 'intelligent robot lab, brown university, u.s.a']
kunze25_interspeech	['dupoux1, alejandrina cristia1, marvin lavechin2', 'lscp, dec, ens, ehess, cnrs, psl university, france', 'computational psycholinguistics lab., massachusetts institute of technology, united states']
millot25_interspeech	"['inria, france', 'sorbonne nouvelle, cnrs, laboratoire de phonetique et phonologie, france', ""ea 4128, laboratoire informatique d'avignon, france"", 'cnrs & universite de lorraine, loria, france']"
arisoy25_interspeech	['electrical and electronics engineering, mef university, turkey', 'computer engineering, bogazici university, turkey', 'allianz partners, germany']
pratapsingh25_interspeech	['school of computing, university of eastern finland, finland', 'institute for advancing intelligence, tcg crest, india']
deng25b_interspeech	['division of psychiatry, the university of edinburgh, uk', 'usher institute, the university of edinburgh, uk', 'centre for medical informatics, usher institute, the university of edinburgh, uk']
naini25_interspeech	['language technologies institute (lti), carnegie mellon university, usa', 'the university of texas at dallas, usa', 'clsp, johns hopkins university, usa']
serditova25_interspeech	['english department, university of freiburg, germany', 'faculty of arts and humanities, heinrich heine university dusseldorf, germany', 'institute of sound and vibration engineering, university of applied sciences dusseldorf, germany']
ducceschi25_interspeech	['institute for applied linguistics, eurac research, italy']
huang25g_interspeech	['graduate school of informatics, nagoya university, japan', 'national institute of information and communications technology, japan', 'information technology center, nagoya university, japan']
mai25c_interspeech	['school of electronic and information engineering, south china university of technology, china', 'school of future technology, south china university of technology, china']
weilinghoff25_interspeech	['department of english and american studies, university of koblenz, germany']
johnson25_interspeech	['machine learning center of excellence, jpmorganchase, usa']
griot25_interspeech	"[""laboratoire d'informatique d'avignon, france"", 'ardelan, france', 'daon, ireland', 'defense&security department, inria, france']"
duraisamy25_interspeech	['university of luxembourg, luxembourg', 'german research center for artificial intelligence (dfki), germany']
peurey25_interspeech	['lscp, dec, ens, ehess, cnrs, psl university, france', 'babydevlab, university of east london, uk', 'izwt, university of wuppertal, germany']
parvathala25_interspeech	['speech information processing lab, department of electrical engineering, indian institute of', 'technology hyderabad, india']
kirkland25_interspeech	['department of speech, music and hearing, kth royal institute of technology, sweden']
ahmed25_interspeech	['research center for information technology innovation, academia sinica, taiwan', 'national tsing hua university, taiwan', 'edinburgh napier university, scotland, uk', 'institute of information science, academia sinica, taiwan']
zhao25k_interspeech	['the chinese university of hong kong, hong kong sar, china']
aboeitta25_interspeech	['nlp department, mbzuai, uae', 'invertible ai, uae']
marx25_interspeech	['free university of bozen-bolzano, italy', 'augmented intelligence center, fondazione bruno kessler, italy']
tang25_interspeech	['samsung research america, usa']
monteroramirez25_interspeech	['valverde-albacete2, carmen pelaez-moreno1,3', 'signal theory and communications dept., universidad carlos iii de madrid, spain', 'dtscstc, universidad rey juan c., spain', 'institute of gender studies, universidad carlos iii de madrid, spain']
chandra25b_interspeech	['school of computing and electrical engineering, indian institute of technology, mandi, india']
tam25_interspeech	['anne rowling regenerative neurology clinic, edinburgh, uk 2centre for clinical brain sciences,', 'university of edinburgh, uk 3euan macdonald centre for mnd research, university of', 'edinburgh, uk 4uk dementia research institute, uk 5speakunique ltd, edinburgh, uk']
falez25_interspeech	['whispeak, france', 'univ bretagne sud, cnrs, irisa, france', 'univ rennes, cnrs, irisa, france']
zhengjie25_interspeech	['key lab of speech acoustics and content understanding, institute of acoustic,cas, china', 'university of chinese academy of sciences, china']
tamir25_interspeech	['faculty of data and decision sciences, technion - israel institute of technology, haifa, israel', 'department of electrical and computer engineering, johns hopkins university, maryland, usa']
alam25_interspeech	['qatar computing research institute, qatar', 'university of new brunswick, canada']
zhao25l_interspeech	['key laboratory of speech acoustics and content understanding, institute of acoustics, chinese', 'academy of sciences, china', 'university of chinese academy of sciences, china', 'hardware engineering system, oppo, beijing, china']
wang25x_interspeech	['department of data science & ai, monash university, australia', 'mbzuai, united arab emirates']
ueda25_interspeech	['universidade estadual de campinas (unicamp), brazil', 'cpqd, brazil']
ravi25_interspeech	['big data research and supercomputing division; acsir, csir-4pi, india', 'department of electrical engineering, iit kanpur, india']
gao25g_interspeech	['chen4, siniscalchi sabato marco5, odette scharenborg6', 'university of science and technology of china, china 2georgia institute of technology, usa', 'carnegie mellon university, usa 4northwestern polytechnical university, china 5university of', 'palermo, italy 6delft university of technology, netherlands']
greenberg25_interspeech	['nist itl/iad/multimodal information group, md, usa', 'mit lincoln laboratory, ma, usa', 'u.s. department of defense, md, usa']
siegert25_interspeech	['mobile dialog systems, otto von guericke university magdeburg, germany', 'speech science and phonetics, halle university, germany']
carvalho25_interspeech	['inesc-id & instituto superior tecnico, portugal', 'carnegie mellon portugal, usa']
zhang25s_interspeech	['department of computational linguistics, university of zurich, switzerland']
mondal25_interspeech	['language technologies research center, iiit hyderabad, india', 'cse, saintgits college of engineering, kottayam, india']
shashaank25_interspeech	['chuan-che (jeff) huang1', 'bose corporation, boston, ma, usa', 'department of computer science, columbia university, new york, ny, usa']
palzer25_interspeech	['computer science and engineering, the ohio state university, u.s.a.', 'human language technology center of excellence, the johns hopkins university, u.s.a.']
pathak25_interspeech	['murthy1', 'indian institute of technology, madras, india', 'independent researcher, india']
mondal25b_interspeech	['yarra', 'language technologies research center, iiit hyderabad, india']
zgorzynski25_interspeech	['samsung r&d institute poland,', 'agh university of krakow, poland']
choi25h_interspeech	['information science, cornell university, usa', 'department of psychiatry, northwell health, usa', 'linguistic data consortium, department of linguistics, university of pennsylvania, usa']
huang25h_interspeech	['signal analysis and interpretation laboratory, university of southern california, usa', 'department of linguistics, university of southern california, usa']
slomianka25_interspeech	['department of health technology, hearing systems section, technical university of denmark,', 'lyngby, denmark']
lobashev25_interspeech	['glam ai, san francisco, us', 'independent researcher, astana, kazakhstan', 'magicly ai, dubai, uae']
tuckute25_interspeech	['department of brain and cognitive sciences & mcgovern institute for brain research, mit, usa', 'department of computer science & wu tsai neurosciences institute, stanford university, usa', 'department of psychology, stanford university, usa', 'program in speech and hearing bioscience and technology, harvard university, usa']
polle25_interspeech	"['goria1', 'thymia, london, uk', ""institute of psychiatry, psychology & neuroscience, king's college london, uk""]"
peters25_interspeech	['university of sheffield, uk', 'university of manchester, uk', 'university of exeter, uk']
ratajczak25_interspeech	['rev.com, usa']
markitantov25_interspeech	['st. petersburg institute for informatics and automation of the russian academy of sciences,', 'st. petersburg federal research center of the russian academy of sciences (spc ras), russia', 'department of information and computing sciences, utrecht university, the netherlands']
hussein25_interspeech	['mitsubishi electric research laboratories, usa', 'johns hopkins university, usa']
firc25_interspeech	['kinnunen2, kamil malinka1', 'brno university of technology, czech republic', 'university of eastern finland, finland']
wallbridge25_interspeech	['centre for speech technology research, university of edinburgh, uk']
elhajal25_interspeech	['idiap research institute, ch-1920 martigny, switzerland', 'epfl, ecole polytechnique federale de lausanne, ch-1015 lausanne, switzerland']
hutin25_interspeech	['atilf, universite de lorraine, cnrs, nancy, france', 'sfl, universite paris 8 vincennes-saint-denis, cnrs, saint-denis, france']
hegde25_interspeech	['indian institute of information technology dharwad, india']
li25ba_interspeech	['speech technology lab, university of groningen, the netherlands', 'center for language and cognition, university of groningen, the netherlands']
sanders25_interspeech	['the centre for speech technology research, university of edinburgh, united kingdom']
serre25_interspeech	['ltci, telecom paris, institut polytechnique de paris, palaiseau, france', 'signal processing and machine learning department, orosound, paris, france']
kulkarni25_interspeech	['idiap research institute, switzerland', 'tallinn university of technology, estonia']
roquefort25_interspeech	['callyope, france']
yang25n_interspeech	['tankasala2, di he2, venkatesh ravichandran2', 'georgia institute of technology, atlanta, usa', 'amazon agi, usa']
niculescu25_interspeech	['romanian academy institute of linguistics “iorgu iordan – alexandru rosetti”', 'faculty of letters, university of bucharest']
xiong25b_interspeech	['communication sciences and disorders, northwestern university, usa']
miodonska25_interspeech	['faculty of biomedical engineering, silesian university of technology, zabrze, poland']
dindart25_interspeech	['pillot-loiseau5, christophe tresallet2, frederique frouin1', 'lito, inserm, institut curie, universite paris-saclay, france', 'departments of nuclear medicine and surgery, avicenne hospital, ap-hp, universite sorbonne', 'paris nord, france', 'mindray france sarl, france', 'lib, cnrs, inserm, sorbonne universite, france', 'lpp umr 7018, cnrs, sorbonne nouvelle, france']
morais25_interspeech	['ibm research, brazil', 'ibm research, israel', 'ibm research, usa']
gogoi25_interspeech	['kalita6, jagabandhu mishra3, md sahidullah7, priyankoo sarmah1, s r. m prasanna8', 'iit guwahati, india', 'duiet, dibrugarh university, india', 'university of eastern finland, finland;', 'independent researcher, india', 'saryps labs, india', 'armsoftech.air, india', 'tcg crest, india;', 'iiit dharwad, india']
akinrintoyo25_interspeech	['i-x and department of computing, imperial college london, uk']
grinberg25_interspeech	['epfl, switzerland', 'reality defender inc., usa']
mitrofanov25_interspeech	['karelin1, nikita khmelev1,2, dmitry dutov1,2, stepan malykh1, igor agafonov1, aleksandr nikitin2,', 'oleg petrov1', 'stcon llc., kingdom of saudi arabia', 'itmo university, russia', 'mitrofanov-aa,novoselov,prisyach,marchevskiy,karelin,khmelev,dutov,malykh-s,agafonov-i']
chen25n_interspeech	['liu1', 'department of electrical engineering, national tsing hua university, taiwan', 'dept. of otorhinolaryngology, head and neck surgery, china medical university hospital, taiwan']
chiang25_interspeech	['cochlear implant processing laboratory, center for robust speech systems (crss-cilab), the', 'university of texas at dallas, usa']
mote25_interspeech	['language technologies institute, carnegie mellon university, usa', 'electrical and computer engineering, the university of texas at dallas, usa', 'laboratory for analytic sciences, north carolina state university, usa']
kulkarni25b_interspeech	['idiap research institute, martigny, switzerland', 'inesc-id, lisbon, portugal', 'instituto superior tecnico, university of lisbon, portugal']
dey25_interspeech	['samsung r&d institute, bangalore, india']
alizadeh25_interspeech	['faculty of technology and media engineering, iran broadcasting university (iribu), tehran, iran']
mote25b_interspeech	['language technologies institute, carnegie mellon university, usa', 'electrical and computer engineering, the university of texas at dallas, usa', 'laboratory for analytic sciences, north carolina state university, usa']
hartmann25_interspeech	['university of zurich, english department, switzerland']
gogoi25b_interspeech	['iit guwahati, india', 'duiet, dibrugarh university, india', 'armsoftech.air, india', 'nielit', 'kohima, india', 'iiit dharwad, india']
lechler25_interspeech	['cisco systems, europe']
wang25y_interspeech	['nvidia, usa']
ivucic25_interspeech	['cognitive systems lab, university of bremen, germany', 'machine listening lab, university of bremen, germany']
ibrahimov25_interspeech	['department of telecommunications and artificial intelligence,', 'budapest university of technology and economics, budapest, hungary', 'hun-ren–szte research group on artificial intelligence, szeged, hungary', 'university of szeged, institute of informatics, szeged, hungary']
serajian25_interspeech	['school of intelligent systems, university of tehran, iran']
wagner25_interspeech	['riedhammer1, tobias bocklet1', 'technische hochschule nurnberg georg simon ohm, germany', 'korea advanced institute of science & technology, republic of korea', 'friedrich-alexander-universitat erlangen-nurnberg, germany']
shim25_interspeech	['yeung1', 'department of linguistics, simon fraser university, canada', 'school of computing science, simon fraser university, canada']
funfgeld25_interspeech	['phonetics, trier university, germany']
talkar25_interspeech	['linus health, usa']
kang25c_interspeech	"['center for machine vision and signal analysis, university of oulu, finland', ""xi'an jiaotong liverpool university, , china""]"
alderete25_interspeech	['linguistics and cognitive science, simon fraser university, canada', 'khoury college of computer sciences, northeastern university, vancouver, bc, canada']
ferrofilho25_interspeech	['akcit, federal university of goias, brazil']
parvathala25b_interspeech	['speech information processing lab, department of electrical engineering, indian institute of', 'technology hyderabad, india']
malykh25_interspeech	['stcon llc., kingdom of saudi arabia', 'itmo university, st. petersburg, russia']
phukan25_interspeech	['mallick4, pailla balakrishna reddy5, arun balaji buduru1, rajesh sharma6,7', 'iiit-delhi, india', 'upes, india', 'v.b.s.p.u, india', 'independent researcher, india', 'reliance ai,', 'india', 'university of tartu, estonia', 'plaksha university, india']
gebauer25_interspeech	['institut fur informationsverarbeitung - l3s, leibniz university hannover, germany', 'institut fur sonderpadagogik, leibniz university hannover, germany']
szmajdzinski25_interspeech	['samsung r&d institute poland,']
dinh25_interspeech	"['simon fraser university, canada', ""noah's ark lab, huawei technologies canada co., ltd., canada""]"
maciejewski25_interspeech	['human language technology center of excellence, johns hopkins university, usa']
hrabanek25_interspeech	['university of amsterdam, the netherlands']
ersoy25_interspeech	['qatar computing research institute, hbku, qatar,']
eren25_interspeech	['dept. of electrical and computer engineering, university of california, los angeles, usa', 'flawless ai, usa', 'imperial college london, uk']
kuhlmann25_interspeech	['paderborn university, germany', 'bielefeld university, germany']
phukan25b_interspeech	['balakrishna reddy5, arun balaji buduru1, rajesh sharma6,7', 'iiit-delhi, india', 'upes, india', 'v.b.s.p.u, india', 'independent researcher, india', 'reliance ai,', 'india', 'university of tartu, estonia', 'plaksha university, india']
mcgahay25_interspeech	['department of linguistics, ucla, usa']
ho25b_interspeech	['human-media interaction, university of twente, the netherlands']
papadimitriou25_interspeech	['department of electrical & computer engineering, university of thessaly', ' volos, greece', 'robotics institute, athena research center', ' maroussi, greece']
balasubramanian25_interspeech	['hor1, sriram srinivasan1', 'meta platforms, inc., usa,']
gaudrain25_interspeech	['lyon neuroscience research center, universite lyon 1, cnrs umr5292, inserm u1028, france', 'department of otorhinolaryngology, university medical center groningen, university of', 'groningen, netherlands']
parvathala25c_interspeech	['speech information processing lab, department of electrical engineering, indian institute of', 'technology hyderabad, india']
batchelderschwab25_interspeech	['department of linguistics, boston university, usa']
phukan25c_interspeech	['mallick4, santanu roy5, arun balaji buduru1, rajesh sharma6,7', 'iiit-delhi, india', 'upes, india', 'v.b.s.p.u, india', 'independent researcher, india', 'dhineu', 'solutions, india', 'university of tartu, estonia', 'plaksha university, india']
zhang25t_interspeech	['khoury college of computer sciences, northeastern university, vancouver, bc, canada']
mousavi25_interspeech	['concordia university, canada', 'universite laval, canada', 'mila - quebec ai institute, canada']
ma25c_interspeech	['school of music, georgia institute of technology, united states', 'research, bose corporation, united states']
leschly25_interspeech	['hosamath1, lakshmi arbatti1, line h clemmensen5, melanie ganz3,4, vikram ramanarayanan1,2', 'modality.ai, inc., san francisco, ca, usa. 2university of california, san francisco, san', 'francisco, ca, usa. 3department of computer science, university of copenhagen, copenhagen,', 'denmark. 4neurobiology research unit, copenhagen university hospital, copenhagen, denmark.', 'department of mathematical sciences, university of copenhagen, copenhagen, denmark']
phukan25d_interspeech	['balakrishna reddy5, arun balaji buduru1, rajesh sharma6,7', 'iiit-delhi, india', 'upes, india', 'v.b.s.p.u, india', 'independent researcher, india', 'reliance ai,', 'india', 'university of tartu, estonia', 'plaksha university, india']
hope25_interspeech	['department of linguistics & cognitive science, university of delaware, usa', 'department of speech, music and hearing, kth royal institute of technology, sweden']
phukan25e_interspeech	['kiran patibandla4, arun balaji buduru1, rajesh sharma5,6', 'iiit-delhi, india', 'v.b.s.p.u, india', 'upes, india', 'independent researcher, india', 'university of', 'tartu, estonia', 'plaksha university, india']
medennikov25_interspeech	['balam, boris ginsburg', 'nvidia, usa']
verdini25_interspeech	['bratieres3,4, paolo merialdo2, simone scardapane1', 'sapienza university of rome, italy', 'roma tre university, italy', 'translated, italy', 'pi school,', 'italy', 'fondazione bruno kessler, italy', 'agh university of krakow, poland', 'acc cyfronet agh,', 'poland']
stein25_interspeech	['institute of linguistics, faculty of arts and humanities, hhu dusseldorf, germany', 'department of english language and linguistics, faculty of arts and humanities, hhu', 'dusseldorf, germany', 'department of linguistics, university of florida, usa']
yan25c_interspeech	['althubaiti4, puyuan peng9, matthew wiesner7, thamar solorio2, ahmed ali4, sanjeev khudanpur7,', 'shinji watanabe1', 'carnegie mellon university', 'mohamed bin zayed university of artificial intelligence', 'kyoto', 'university', 'humain', 'university of sheffield', ' university of british columbia', 'johns hopkins', 'university', 'brno university of technology', 'university of texas at austin']
phukan25f_interspeech	['osama siddiqui1, sarthak jain1, priyabrata mallick4, jaya sai kiran patibandla4, pailla', 'balakrishna reddy5, arun balaji buduru1, rajesh sharma6,7', 'iiit-delhi, india', 'v.b.s.p.u, india', 'upes, india', 'independent researcher, india', 'reliance', 'ai, india', 'university of tartu, estonia', 'plaksha university, india']
malisz25_interspeech	['division of speech, music and hearing, kth royal institute of technology, sweden', 'faculty of english, adam mickiewicz university, poland']
chan25_interspeech	['department of linguistics, university of pennsylvania, u.s.a.']
ozyilmaz25_interspeech	['department of internal medicine, division of nephrology, university of groningen, university', 'medical center groningen, the netherlands', 'bernoulli institute for mathematics, computer', 'science, and artificial intelligence, university of groningen, the netherlands', 'speech technology', 'lab, campus fryslˆan, university of groningen, the netherlands']
salihs25_interspeech	['winful1', 'department of computer science, university of ghana, ghana', 'school of computing and engineering, university of west london, united kingdom', 'talking tipps africa foundation, ghana', 'university college london interaction centre, united kingdom', 'global disability innovation hub, university college london, united kingdom', 'department of information processing science, university of oulu, finland', 'google research, usa']
nilsson25_interspeech	['friedrich miescher institute for biomedical research, switzerland', 'gn audio, denmark;', 'technical university of denmark, denmark', 'university of basel, switzerland']
rommel25_interspeech	['department of linguistics, universitat konstanz, germany', 'department of english, aarhus university, denmark']
neumann25_interspeech	['lindenmayer2, vikram ramanarayanan1,3', 'modality.ai, inc., san francisco, ca, usa', 'nathan kline institute for psychiatric research at', 'manhattan psychiatric center, new york, ny, usa', 'university of california, san francisco, san', 'francisco, ca, usa']
braun25_interspeech	['hillemacher3, tobias bocklet1, korbinian riedhammer1', 'technische hochschule nurnberg, germany', 'geromed gmbh erlangen, germany', 'klinik fur psychiatrie und psychotherapie, universitatsklinik der paracelsus medizinischen', 'privatuniversitat, klinikum nurnberg, germany']
zhong25c_interspeech	['centre for speech technology research, university of edinburgh, united kingdom', 'department of linguistics, university of british columbia, canada']
karimov25_interspeech	['rsi group, airi, moscow, russia', 'safe ai lab, mtuci, moscow, russia', 'skoltech, moscow,', 'russia', 'vein cv llc, moscow, russia', 'kandinsky lab, sber, moscow, russia']
hameed25_interspeech	['vox ai, netherlands', 'department of computational linguistics, university of zurich, switzerland', 'paitaxt technical institute, kurdistan regional government, iraq']
febrinanto25_interspeech	"['xia3', 'institute of innovation, science and sustainability, federation university australia, australia', ""csiro's data61, australia"", 'school of computing technologies, rmit university, australia']"
bafna25_interspeech	['clsp and 2hltcoe, johns hopkins university, usa']
rachman25_interspeech	['department of otorhinolaryngology, university medical center groningen, the netherlands']
kothare25_interspeech	['modality.ai, inc., usa', 'university of california, san francisco, usa']
letellier25_interspeech	['universite paris-saclay, cnrs, lisn, orsay, france']
sanguedolce25_interspeech	['geranmayeh3,4, patrick a naylor2', 'department of computing, imperial college london, uk', 'department of electrical and electronic engineering, imperial college london, uk', 'department of brain sciences, imperial college london, uk', 'imperial college healthcare nhs trust, london, uk', 'department of engineering, reykjavik university, iceland']
kibria25_interspeech	['department of computer science & engineering, the ohio state university, usa']
tomashenko25_interspeech	['universite de lorraine, cnrs, inria, loria, f-54000, nancy, france', 'universite de lille, cnrs, inria, centrale lille, umr 9189 - cristal, lille, france']
lu25h_interspeech	['university of potsdam, germany', 'university of southern california, united states']
jalal25_interspeech	['samsung r&d institute uk (sruk), united kingdom', 'centre for research and technology hellas, greece', 'language ai r&d group (mx), samsung electronics, south korea']
tisdale25_interspeech	['ramanarayanan1,3', 'modality.ai, inc., san francisco, usa', 'california polytechnic state university, san luis obispo, usa', 'university of california, san francisco, usa']
phukan25g_interspeech	['behera5, vandana rajan6, muskaan singh7, arun balaji buduru1, rajesh sharma8,9', 'iiit-delhi, india', 'upes, india', 'v.b.s.p.u, india', 'bit mesra, india', 'independent researcher,', 'india', 'independent researcher, uk', 'ulster university, uk', 'university of tartu, estonia', 'plaksha', 'university, india']
wu25k_interspeech	['department of computer science, university of maryland, college park, united states']
premananth25_interspeech	['department of electrical & computer engineering, university of maryland, college park, usa', 'institute for advanced computer studies, university of maryland, college park, usa', 'school of medicine, university of maryland, usa']
titeux25_interspeech	"['bachoud-levi1,3, emmanuel dupoux2', 'npi/ens/inserm/upec/psl research university, france', 'coml/ens/cnrs/ehess/psl research university, france', ""huntington's disease national reference center, henri-mondor hospital, aphp, creteil, france""]"
yang25o_interspeech	['mitsubishi electric research laboratories (merl), cambridge, ma, usa', 'indiana university, bloomington, in, usa', 'information technology r&d center, mitsubishi electric corporation, kanagawa, japan']
arora25_interspeech	['kashiwagi2, emiru tsunoo2, shinji watanabe1', 'language technologies institute, carnegie mellon university, usa', 'sony group corporation, japan']
pu25_interspeech	['department of electronic engineering, tsinghua university, china', 'school of comput. sci. and eng., northeastern university, china', 'dept. of comput. sci. and eng., shanghai jiao tong university, china']
premananth25b_interspeech	['institues for systems research, department of electrical & computer engineering, university of', 'maryland, college park, usa']
jones25_interspeech	['linguistic data consortium, university of pennsylvania, usa', 'mit lincoln laboratory, ma, usa']
yong25_interspeech	['department of computer science, brown university, united states', 'meta fair, united states']
sirigiaju25_interspeech	['speech processing lab, language technologies research center (ltrc), iiith, india']
fathan25_interspeech	['computer research institute of montreal (crim), montreal, canada']
sheikh25_interspeech	['carnegie mellon university, usa', 'kyoto university, japan']
schouwenaars25_interspeech	['center for language and cognition, university of groningen, the netherlands', 'department of modern languages, cvo university of oldenburg, germany']
netzorg25_interspeech	['garoute3, keith johnson1, gopala krishna anumanchipalli1', 'university of california, berkeley, usa', 'kth royal institute of technology, sweden', 'transvoicelessons, usa']
mujtaba25_interspeech	['michigan state university, usa']
wang25z_interspeech	['carnegie mellon university, usa']
dumpala25_interspeech	['dalhousie university, canada']
tabatabaee25b_interspeech	['department of electrical and computer engineering, university of maryland college park, usa', 'department of communication sciences and disorders, university of cincinnati, usa', 'department of otolaryngology-head and neck surgery, university of cincinnati, usa', 'department of psychiatry, yale university, usa']
xie25_interspeech	['center for robust speech systems (crss), university of texas at dallas, usa', 'meta, usa']
ahadzi25_interspeech	['university of eastern finland, finland']
shi25g_interspeech	['hsu1, louis goldstein1, shrikanth narayanan1', 'university of southern california, united states', 'university of potsdam, germany', 'earlitec diagnostics, united states']
fort25_interspeech	['computational linguistics, indiana university, usa']
wu25l_interspeech	['school of modern languages, georgia institute of technology, united states', 'college of computing, georgia institute of technology, united states']
eads25_interspeech	['mcallister1', 'communicative sciences and disorders, new york university, usa', 'neurology, new york university school of medicine, usa', 'electrical and computer engineering, university of maryland, usa', 'communication sciences and disorders, syracuse university, usa', 'communication sciences and disorder, montclair state university, usa']
xie25b_interspeech	['shenzhen international graduate school, tsinghua university, china', 'pengcheng laboratory, china', 'the chinese university of hong kong, china']
cheng25d_interspeech	['university of massachusetts lowell, usa']
subramanian25b_interspeech	['microsoft, usa']
zhou25h_interspeech	['ortiz2, zoe ezzes3, jet vonk3, brittany morin3, rian bogley3, lisa wauters3, zachary miller3, maria', 'gorno-tempini3, gopala anumanchipalli2', 'zhejiang university, china', 'uc berkeley, united states', 'ucsf, united states']
ali25_interspeech	['department of electrical and computer engineering, university of michigan, usa']
chen25o_interspeech	['department of psychology, sun yat-sen university, china', '️guangzhou zhengxin psychological counseling co. ltd., china']
huang25i_interspeech	['beijing fosafer information technology co., ltd., china', 'institute of forensic science, ministry of public security, china', 'the institute of linguistics, chinese academy of social sciences, china']
xiao25e_interspeech	['school of computer science, the university of sheffield, united kingdom', 'south westphalia university of applied sciences, germany']
wu25m_interspeech	['school of modern languages, georgia institute of technology, usa', 'keck school of medicine, university of southern california, usa', 'university of chicago, usa', 'the hong kong polytechnic university, hong kong']
gohider25_interspeech	['electrical & computer engineering department, university of waterloo, canada']
fathan25b_interspeech	['computer research institute of montreal (crim), montreal, canada']
lee25i_interspeech	['gwangju institute of science and technology, korea']
liu25p_interspeech	['center for robust speech systems (crss), the university of texas at dallas, usa']
smith25b_interspeech	['indiana university', 'university of alberta']
guo25d_interspeech	['miller3, maria gorno-tempini3, gopala anumanchipalli2', 'zhejiang university, china', 'uc berkeley, united states', 'ucsf, united states']
lin25h_interspeech	['shenzhen international graduate school, tsinghua university, china', 'platform and content group, tencent, china']
araizaillan25_interspeech	['department of otorhinolaryngology / head and neck surgery, university medical centre', 'groningen, university of groningen, the netherlands']
zheng25d_interspeech	['moe key lab of artificial intelligence, x-lance lab, school of computer science,', 'shanghai jiao tong university, china', 'shanghai innovation institute, china', 'microsoft, usa']
chang25c_interspeech	['new york university, usa', 'max planck society, germany']
zwilling25_interspeech	['carter4, marie moore channell1', 'university of illinois', 'lee silverman voice treatment', 'team gleason', 'lingraphica,']
cheema25_interspeech	['speech and hearing bioscience and technology program, harvard university, cambridge, usa', 'eaton peabody laboratories, massachusetts eye and ear infirmary (meei), boston, usa', 'department of otolaryngology, harvard medical school, boston, usa']
kwon25b_interspeech	['department of linguistics, cornell university, usa']
tripathi25_interspeech	['media analysis group, sony research india']
uehara25_interspeech	['graduate school of system informatics, kobe university, japan']
cm25_interspeech	['samsung r&d institute bangalore, india']
chowdhury25_interspeech	['department of computer science, colby college, usa', 'department of psychology, colby college, usa']
fu25_interspeech	['school of automation and intelligent manufacturing, southern university of science and', 'technology (sustech), china', 'department of computer science and engineering, sustech,', 'china', 'department of mechanical engineering, city university of hong kong, china']
gan25b_interspeech	['key laboratory of universal wireless communications, ministry of education, beijing university', 'of posts and telecommunications, beijing, china', 'peng cheng laboratory, shenzhen, china', 'state key laboratory of networking and switching technology, beijing university of posts and', 'telecommunications, beijing, china']
seong25_interspeech	['department of electronic engineering, hanyang university, seoul, republic of korea']
pulikodan25_interspeech	['department of mathematics, indian institute of science, india', 'department of electrical engineering, indian institute of science, india']
serrand25_interspeech	['universite de sherbrooke, canada', 'ecole de technologie superieure, canada', 'centre de recherche informatique de montreal, canada']
ye25b_interspeech	['zhejiang university, china', 'uc berkeley, united states', 'southern university of science and technology, china', 'ucsf, united states']
kumar25d_interspeech	['speech lab, language technologies research center (ltrc), iiit, hyderabad', ', india']
jiang25c_interspeech	['national engineering research center of speech and language information processing, university', 'of science and technology of china, hefei, china', 'ict cluster, singapore institute of technology, singapore']
durmus25_interspeech	['argmax inc, usa', 'university of california los angeles, usa']
teleki25_interspeech	['department of computer science & engineering, texas a&m university, usa']
srinivasmenon25_interspeech	['media analysis group, sony research india']
shi25h_interspeech	['narayanan1, maja mataric1', 'viterbi school of engineering, university of southern california, united states', 'sara technology inc., united states', 'fu foundation school of engineering and applied science, columbia university, united states']
rasendiranr25_interspeech	['department of metallurgical engineering and materials science, indian institute of technology', 'indore, india', 'department of computer science & engineering, indian institute of technology indore, india']
mallela25_interspeech	['speech processing lab, language technologies research center, iiit hyderabad, india', 'hewlett packard enterprise, bangalore, india']
bai25_interspeech	['school of data science', 'sribd, the chinese university of hong kong, shenzhen, china', 'school of intelligence science and technology, nanjing university, suzhou, china', 'tencent ethereal audio lab, tencent, china', 'department of ece, national university of singapore, singapore']
pothula25_interspeech	['kumar vuppala1', 'speech processing laboratory, international institute of information technology, hyderabad, india']
baser25_interspeech	['department of electrical and computer engineering, the university of texas at austin, usa', 'department of electrical and computer engineering, georgia institute of technology, usa']
hoq25_interspeech	['state university of new york at buffalo, usa']
gupta25b_interspeech	['samsung research institute, bangalore, india']
park25g_interspeech	['department of electrical and computer engineering, inha university, republic of korea']
jung25c_interspeech	['carnegie mellon university, usa 2shanghai jiao tong university, china 3meta, usa', 'renmin university of china, china 5national institute of informatics, japan', 'korea advanced institute of science and technology, south korea 7university of tokyo, japan', 'yonsei university, south korea 9eurecom, france 10keio university, japan']
zhong25d_interspeech	['department of computer science, the university of tokyo, japan']
yang25p_interspeech	['school of computer science and technology, xinjiang university, china', 'college of computing and data science, nanyang technological university, singapore', 'joint international research laboratory of silk road multilingual cognitive computing, china', 'xinjiang key laboratory of multi-lingual information technology, china', 'institute of science tokyo, japan']
huang25j_interspeech	['university of california san diego, united states']
lewis25_interspeech	"['mischoulon2, thomas f quatieri4, nicholas cummins5,6, paola pedrelli2, rosalind picard1', 'mit media lab, usa', 'massachusetts general hospital, usa', 'northeastern university, usa;', 'mit lincoln laboratory, usa', ""king's college london, uk"", 'thymia, uk']"
hidalgojulia25_interspeech	['swords2, gabriela valdivia2, christine wilson-mendenhall2, raquel tartar3, rosalind picard1,', 'richard davidson2', 'media lab, massachusetts institute of technology, united states', 'healthy minds institute,', 'university of wisconsin-madison, united states', 'healthy minds innovations, united states']
ohashi25_interspeech	['graduate school of informatics, nagoya university, japan']
zhou25i_interspeech	['college of computer and control engineering, northeast forestry university, harbin, prc']
sakuma25_interspeech	['nhk science and technology research laboratories, japan', 'waseda university, japan']
lodagala25_interspeech	['humain, saudi arabia', 'saudi data ai authority, saudi arabia', 'kth royal institute of technology, sweden', 'qcri, qatar']
patakis25_interspeech	['national technical university of athens, athens, greece']
rangappa25_interspeech	['idiap research institute , switzerland', 'uniphore systems, india & usa,', 'epfl, switzerland', 'university of zurich, switzerland', 'brno university, czech republic,']
kim25s_interspeech	['department of electrical engineering', 'department of semiconductor engineering', 'center for', 'semiconductor technology convergence, pohang university of science and technology', '(postech), pohang, korea']
oh25c_interspeech	['university of science and technology, south korea', 'electronics and telecommunications research institute, south korea']
baser25b_interspeech	['department of electrical and computer engineering, the university of texas at austin, usa', 'department of electrical and computer engineering, georgia institute of technology, usa']
kim25t_interspeech	['department of artificial intelligence, korea university, seoul, korea']
kim25u_interspeech	['electrical engineering, kaist, south korea']
shahidi25_interspeech	['mrc cognition and brain sciences unit, university of cambridge, uk']
wang25aa_interspeech	['subbalakshmi2', 'jiangnan university, china', 'stevens institute of technology, usa', 'henan polytechnic university,', 'china', 'silicon austria labs, austria']
sharma25b_interspeech	['electrical engineering, indian institute of science (iisc), bangalore-560012, india', 'rewa engineering college, rewa, madhya pradesh-486002, india']
carofilis25_interspeech	['venkatesan4, saurabh vyas4, andreas stolcke4', 'idiap research institute , switzerland', 'epfl, switzerland', 'uniphore systems, india & usa,', 'university of zurich (uzh), switzerland', 'brno university, czech republic,']
kuparinen25_interspeech	['faculty of information technology and communication sciences, tampere university, finland']
koudounas25c_interspeech	['politecnico di torino, italy']
khurana25_interspeech	['♠, juraj novosad', '♠, peter', 'gazdik', '♠, ellen zhang', '♢, zili huang', '♡, amir hussein', '♡, ricard marxer', '♣, yoshiki masuyama1, ryo', 'aihara1, chiori hori1, francois g germain1, gordon wichern1, jonathan le roux1', 'mitsubishi electric research laboratories (merl), cambridge, ma, usa', 'lium university, france']
carta25_interspeech	['department of mathematics and computer science, university of cagliari, cagliari, italy', 'visioscientiae s.r.l., cagliari, italy']
das25b_interspeech	['spring lab, department of electrical engineering, indian institute of technology madras, india']
buker25_interspeech	['department of artificial intelligence and machine learning, bursa technical university, turkiye', 'department of electrical and electronic engineering, bursa technical university, turkiye', 'department of electrical and electronic engineering, bursa uludag university, turkiye']
sudo25b_interspeech	['sb intuitions, japan']
li25ca_interspeech	['karlsruhe institute of technology, germany']
martinek25_interspeech	['nask national research institute, poland', 'agh university of krakow, poland']
santamariajorda25_interspeech	"['silvestre-cerda1, adria gimenez2, ruben gaspar aparicio3, rene fernandez sanchez3, jorge', 'civera1, albert sanchis1, alfons juan1', 'mllp research group, vrain, universitat politecnica de valencia, spain', ""departament d'informatica, escola tecnica superior d'enginyeria, universitat de valencia, spain"", 'european organization for nuclear research (cern), geneve']"
singh25c_interspeech	['department of computer science and information technology, la trobe university, australia', 'department of electrical engineering, indian institute of technology kanpur, india']
chatzichristodoulou25_interspeech	['poulopoulou1, efthymios georgiou†1,3, athanasios katsamanis3, vassilis katsouros3, alexandros', 'potamianos1,2', 'ece, national technical university of athens, greece', 'archimedes, athena rc, greece', 'ilsp, athena rc, greece']
song25d_interspeech	['department of electrical engineering', 'department of semiconductor engineering', 'center for', 'semiconductor technology convergence, pohang university of science and technology', '(postech), pohang, korea']
horii25_interspeech	['ntt corporation, japan']
vesterbacka25_interspeech	['kblab, national library of sweden, sweden']
huang25k_interspeech	['kang2,3, rong zheng1', 'beijing fosafer information technology co., ltd., china', 'institute of forensic science, ministry of public security, china', 'the institute of linguistics, chinese academy of social sciences, china']
zhang25u_interspeech	['anumanchipalli2', 'zhejiang university, china', 'uc berkeley, usa', 'ucsf, usa']
ranjan25_interspeech	['indian institute of technology jodhpur, india', 'pandit deendayal energy university, india']
elmers25_interspeech	['graduate school of informatics, kyoto university, japan']
li25da_interspeech	['shenzhen research institute of big data, shenzhen, china', 'school of intelligence science and technology, nanjing university, suzhou, china', 'school of data science, the chinese university of hong kong, shenzhen, china', 'department of electrical and computer engineering, national university of singapore, singapore']
kim25v_interspeech	['department of electronic engineering, hanyang university, republic of korea']
ranjan25b_interspeech	['indian institute of technology jodhpur, india', 'columbia university, usa']
mittal25_interspeech	['ibm research, india', 'iit bombay, india']
mun25c_interspeech	['smarthome ai lab, samsung research, samsung electronics, republic of korea']
gorthi25_interspeech	['indian institute of information technology kottayam, india', 'indian institute of technology jodhpur, india']
sanchez25_interspeech	['centre for speech technology research, university of edinburgh, uk']
gulzar25_interspeech	['software innovation center, ntt, japan', 'human informatics laboratories, ntt, japan']
wardah25_interspeech	['quality and usability lab, faculty iv, technische universitat berlin, germany', 'orange innovation, france', 'head acoustics gmbh, germany', 'rohde & schwarz swissqual ag, switzerland']
wang25ba_interspeech	['hong1∗, lin li2∗', 'school of informatics, xiamen university, china', 'school of electronic science and engineering, xiamen university, china', 'zhejiang university, china']
yong25b_interspeech	['division of integrative systems and design, the hong kong university of science and', 'technology, hong kong sar', 's.k. yee school of health sciences, saint francis university, hong kong sar']
agrawal25b_interspeech	['observe ai, india,']
mizumoto25_interspeech	['sb intuitions corp., japan']
he25c_interspeech	['graduate school of informatics, nagoya university, japan', 'information technology center, nagoya university, japan']
jin25d_interspeech	['shenzhen international graduate school, tsinghua university, china']
sridhar25_interspeech	['aimpower.org, usa', 'basis independent silicon valley, usa']
dutta25b_interspeech	['indian institute of technology jodhpur, india']
kim25w_interspeech	['department of artificial intelligence, sogang university, south korea']
javed25_interspeech	['ai4bharat, indian institute of technology madras, india']
singh25d_interspeech	['idlab, department of electronics and information systems, imec - ghent university, belgium', 'department of electrical engineering, indian institute of technology kanpur, india']
baumann25_interspeech	['technische hochschule nurnberg georg simon ohm, germany']
behera25_interspeech	['speech information processing lab, department of electrical engineering, indian institute of', 'technology hyderabad, india']
chen25p_interspeech	['school of informatics, xiamen university, china', 'school of electronic science and engineering, xiamen university, china']
rolland25_interspeech	['inesc-id, lisbon, portugal', 'instituto superior tecnico, lisbon, portugal']
joshi25_interspeech	['ai4bharat, indian institute of technology madras, india']
barahona25_interspeech	['audias, universidad autonoma de madrid, spain', 'brno university of technology, czechia', 'athens university of economics and business | omilia | archimedes ai/athena rc, greece', 'politecnico di torino, italy', 'phonexia, czechia']
chen25q_interspeech	['bytedance china, shenzhen, china', 'bytedance inc., sydney, australia']
hoffner25_interspeech	['communications acoustics, carl von ossietzky universitat oldenburg, germany', 'medizinische physik, carl von ossietzky universitat oldenburg, germany', 'cluster of excellence hearing4all, carl von ossietzky universitat oldenburg, germany']
eom25_interspeech	['korea advanced institute of science and technology, south korea', 'university of illinois urbana-champaign, united states']
minixhofer25_interspeech	['cstr, university of edinburgh, uk']
kang25d_interspeech	['the chinese university of hong kong, hong kong sar, china', 'centre for perceptual and interactive intelligence, hong kong sar, china']
rastogi25_interspeech	['computer science & engineering department, thapar institute of engineering & technology, india']
krzywdziak25_interspeech	['samsung r&d institute, poland']
sankar25_interspeech	['ai4bharat, wsai, indian institute of technology madras, india', 'cantina labs, usa', 'mistral ai, france']
sedlacek25_interspeech	['indian institute of information technology dharwad, india']
srinivasavaradhan25_interspeech	['khapra1', 'ai4bharat, indian institute of technology madras, india', 'gan.ai, india']
ys25_interspeech	['chowdam venkata thirumala4, madassu keerthipriya5, darshan chikktimmegowda5, dipti', 'baskar5, yamini belur5, seena vengalil5, atchayaram nalini5, prasanta kumar ghosh2', 'hewlett packard enterprise, bengaluru, india', 'electrical engineering department, indian institute', 'of science, bengaluru, india', 'brno university of technology, brno, czech republic', 'speech', 'processing lab, ltrc, international institute of information technology, hyderabad, india;', 'national institute of mental health and neurosciences, bengaluru, india']
degroot25_interspeech	['multimedia computing group, delft university of technology, the netherlands', 'dept. of plastic and reconstructive surgery, erasmus medical centre (emc), the netherlands', 'dept. of electronics and communication, indian inst. of information technology allahabad, india']
gong25c_interspeech	['wu2, ahmad emami1, julia hirschberg2', 'machine learning center of excellence, jpmorgan chase & co., usa', 'department of computer science, columbia university, usa']
yue25_interspeech	['stipdonk3, yuanyuan zhang1, elke de witte3, erfan loweimi4, hugo van hamme2, djaina satoer3,', 'marina ruiter6, laureano moro velazquez7, nicholas cummins4, odette scharenborg1', 'tu delft, netherlands', 'ku leuven, belgium', 'erasmus mc, netherlands', 'kcl, uk', 'royal', 'dutch auris group, netherlands', 'radboud university, netherlands', 'john hopkins, usa']
moussa25_interspeech	['max planck institute for software systems, germany']
chang25d_interspeech	['schuller1,5', 'glam – the group on language, audio, & music, imperial college london, united kingdom', 'cognitive systems lab, university of bremen, germany', 'school of medical technology, beijing institute of technology, china', 'griffith university, australia', 'chair of health informatics, technical university of munich, germany']
yang25q_interspeech	['department of computer science, university of oxford, uk']
hartanto25_interspeech	['institute of science tokyo, japan', 'nara institute of science and technology, japan']
marcinek25_interspeech	['department of speech, music and hearing, kth, sweden']
freisinger25_interspeech	['technische hochschule nurnberg, germany']
wakayama25_interspeech	['ntt corporation, japan']
gourav25_interspeech	['oracle corporation, india']
nguyen25e_interspeech	['independent researcher, vietnam', 'computer science, indiana university, usa']
lay25b_interspeech	['university of hamburg, signal processing, germany', 'hamburg informatik technologie-center e.v., germany']
cho25c_interspeech	['nc ai co., ltd, republic of korea', 'sogang university, republic of korea', 'chung-ang university, republic of korea']
roman25_interspeech	['centre de llenguatge i computacio (clic), universitat de barcelona, spain', 'institut de recerca en sistemes complesos (ubics), universitat de barcelona, spain']
shepardson25_interspeech	['intelligent instruments lab, university of iceland', 'emute lab, university of sussex, uk']
bokkahallisatish25_interspeech	['department of speech, music and hearing, kth royal institute of technology, sweden']
francis25_interspeech	['division of speech, music and hearing, kth royal institute of technology, sweden']
deluca25_interspeech	['linguistic research infrastructure, university of zurich, switzerland', 'department of computational linguistiscs, university of zurich, switzerland']
baihaqi25b_interspeech	['nara institute of science and technology, japan', 'guardian robot project, riken, japan;', 'institute of science tokyo, japan', 'kyoto institute of technology, japan']
arai25_interspeech	['sophia univ. (japan)']
merzougui25_interspeech	"['hasanuzzaman2,3, aurelien bournonville1, edgar madelaine1, thomas berthelin le tellier1,', 'francois ledoyen1, laure poutrain-lejeune1, francois rioult1, jeremie pantin1', 'universite caen normandie, ensicaen, cnrs, normandie univ, greyc umr6072, france', 'computer science department, munster technological university, adapt centre, ireland', ""school of eeecs, queen's university belfast, northern ireland""]"
rai25_interspeech	['indian institute of technology, kharagpur, india']
draxler25_interspeech	['institute of phonetics and speech processing, lmu munich, germany', 'centre for language studies, radboud university, netherlands', 'dipartimento di filologia e critica delle letterature antiche e moderne, siena university, italy', 'utrecht university, netherlands']
vukovic25_interspeech	['mcdonald1, johannes gra¨en1, noah bubenhofer1', 'linguistic research infrastructure, university of zurich, switerland']
peirolilja25_interspeech	['langtech lab, barcelona supercomputing center, spain', 'clic, universitat de barcelona, spain;', 'ubics, universitat de barcelona, spain', 'dfki gmbh, saarland informatics campus, germany']
pallala25_interspeech	['meeami technologies, hyderabad, india,', 'rakesh.pogula,umasubhashini.ravuri,naveen.ellanki, harish.rajamani,']
mcallister25b_interspeech	['liang1, tae hong park3', 'communicative sciences and disorders, new york university, usa', 'music and performing arts professions, new york university, usa', 'department of music, purdue university, usa']
quinterovillalobos25_interspeech	['quality and usability lab, technische universitat berlin, germany', 'german research center for artificial intelligence, berlin, germany']
li25ea_interspeech	['harris school of public policy anddepartment of computer science, university of chicago, usa', 'school of modern languages, georgia institute of technology, usa', 'university of southern california, usa', 'california state university san marcos, usa']
okamoto25_interspeech	['national institute of information and communications technology, japan']
znotins25_interspeech	['institute of mathematics and computer science, university of latvia, latvia']
patapati25_interspeech	['dept. of hci, cyrion labs, united states']
raju25_interspeech	['r&d, hitloop, usa']
nethil25_interspeech	['adalat ai, india']
