paper_id	affiliations
wu19_interspeech	['center for language and speech processing,', 'human language technology center of excellence,', 'johns hopkins university, baltimore, md, usa']
yeung19_interspeech	['dept. of electrical and computer engineering, university of california, los angeles, usa']
gale19_interspeech	['center for spoken language understanding (cslu)', 'oregon health & science university (ohsu), portland, or']
ribeiro19_interspeech	['the centre for speech technology research, university of edinburgh, uk']
loukina19_interspeech	['educational testing service, usa']
lopes19_interspeech	['nova lincs, departamento de informatica', 'faculdade de ciencias e tecnologia', 'universidade nova de lisboa', '-516 caparica, portugal']
esposito19_interspeech	['universita degli studi della campania “luigi vanvitelli”, department of psychology and', 'international institute for advanced scientific studies (iiass), italy.', 'istituto nazionale di geofisica e vulcanologia, sez. di napoli osservatorio vesuviano, italy.']
niebuhr19_interspeech	['centre of industrial electronics, mads clausen institute, university of southern denmark', 'institute of culture and society, aarhus university']
cohn19_interspeech	['university of california, davis']
lai19_interspeech	['school of informatics, university of edinburgh, edinburgh, uk', 'edinburgh futures institute, school of literatures, languages and cultures, university of', 'edinburgh, edinburgh, uk', 'computer human interaction & creativity, monash university, melbourne, australia', 'toyota motor corporation, tokyo, japan', 'toyota motor europe, brussels, belgium']
sebastian19_interspeech	['telepathy labs gmbh, zurich, switzerland']
rajwadi19_interspeech	['school of architecture, computing and engineering, university of east london, u.k.', 'intelligent voice ltd., london, u.k.']
kleinlein19_interspeech	['information processing and telecommunications center, e.t.s.i. de telecomunicacion,', 'universidad politecnica de madrid', ', madrid, spain', 'department of languages and computer systems, university of granada', ', granada, spain']
pham19_interspeech	['interactive systems lab, karlsruhe institute of technology, karlsruhe, germany', 'carnegie mellon university, pittsburgh pa, usa']
li19_interspeech	['nvidia, santa clara, usa', 'new york university, new york, usa']
moritz19_interspeech	['mitsubishi electric research laboratories (merl), cambridge, ma, usa']
belinkov19_interspeech	['mit computer science and artificial intelligence laboratory, cambridge, ma, usa', 'harvard john a paulson school of engineering and applied sciences, cambridge, ma, usa', 'qatar computing research institute, hbku, doha, qatar']
tawara19_interspeech	['department of communications and computer engineering, waseda university, tokyo, japan']
tesch19_interspeech	['signal processing, universitat hamburg, germany']
martindonas19_interspeech	['dept. of signal theory, telematics and communications, university of granada, spain', 'department of communications engineering, paderborn university, germany']
bagheri19_interspeech	['sonos inc., santa barbara, ca, usa']
togami19_interspeech	['line corporation, tokyo, japan']
nakatani19_interspeech	['ntt communication science laboratories, ntt corporation']
snyder19_interspeech	['department of linguistics, university of california, davis']
illa19_interspeech	['electrical engineering, indian institute of science (iisc), bangalore-560012, india']
zhang19_interspeech	['college of intelligence and computing, tianjin university, tianjin, china']
yoshinaga19_interspeech	
uttam19_interspeech	[', yaman kumar ∗', ', dhruva sahrawat ∗', ', mansi aggarwal4,', 'rajiv ratn shah3, debanjan mahata5, amanda stent5', 'adobe, india', 'midas, iiit-delhi, india', 'bloomberg, usa']
saha19_interspeech	
chung19_interspeech	['computer science and artificial intelligence laboratory', 'massachusetts institute of technology', 'cambridge, ma 02139, usa']
huang19_interspeech	['acoustic research institute, austrian academy of sciences']
m19_interspeech	['indian institute of technology, kharagpur, india']
pascual19_interspeech	
nellore19_interspeech	['speech processing laboratory, international institute of information technology, hyderabad, india', 'tcs research and innovation-mumbai, india', 'indian institute of technology jammu, india']
chatziagapi19_interspeech	
kons19_interspeech	['ibm research']
lorenzotrueba19_interspeech	['amazon.com, cambridge, united kingdom']
neekhara19_interspeech	
mustafa19_interspeech	[',2,', ', christian bergler1, julia schottenhamml1, andreas maier1', 'pattern recognition lab, fau erlangen-nuremberg, erlangen, germany', 'dolby germany gmbh, nuremberg, germany']
wu19b_interspeech	['graduate school of informatics, nagoya university, japan', 'graduate school of information science, nagoya university, japan', 'information technology center, nagoya university, japan']
tian19_interspeech	['department of electrical and computer engineering, national university of singapore', 'school of computer engineering, nanyang technological university, singapore']
zhao19_interspeech	['college of computer and information engineering, tianjin normal university, china', 'zd.b chair of embedded intelligence for health care and wellbeing, university of augsburg, germany', 'glam – group on language, audio & music, imperial college london, uk']
li19b_interspeech	['department of electrical engineering, national tsing hua university, taiwan', 'most joint research center for ai technology and all vista healthcare, taiwan']
gallardoantolin19_interspeech	['dept. of signal theory and communications, universidad carlos iii de madrid, madrid, spain', 'speech technology group, etsit, universidad politecnica de madrid, madrid, spain']
mallolragolta19_interspeech	['zd.b chair of embedded intelligence for health care & wellbeing, university of augsburg, germany', 'college of computer and information engineering, tianjin normal university, china', 'glam – group on language, audio & music, imperial college london, uk']
carmantini19_interspeech	['centre for speech technology research, university of edinburgh, edinburgh eh8 9ab, uk']
luscher19_interspeech	['human language technology and pattern recognition, computer science department,', 'rwth aachen university', ' aachen, germany', 'apptek gmbh', ' aachen, germany']
kanda19_interspeech	['hitachi ltd., japan', 'johns hopkins university, usa']
meng19_interspeech	['microsoft corporation, redmond, wa, usa']
wang19_interspeech	['the ohio state university, columbus, usa', 'tencent ai lab, bellevue, usa']
mac19_interspeech	['department of electrical and computer engineering,', 'university of illinois at urbana-champaign, il 61801, usa', 'ibm research ai', 'ibm t j. watson research center, yorktown heights, ny 10598, usa']
milde19_interspeech	['language technology group, dept. of informatics, universitat hamburg']
ondel19_interspeech	['brno university of technology']
higuchi19_interspeech	['department of communication and computer engineering, waseda university, tokyo, japan']
prasad19_interspeech	['google']
azuh19_interspeech	['mit computer science and artificial intelligence laboratory, cambridge, ma, usa']
feng19_interspeech	['department of electronic engineering, the chinese university of hong kong, hong kong']
nissen19_interspeech	['department of communication disorders, brigham young university, provo, utah, usa']
ahlers19_interspeech	['university of osnabruck, germany', 'university of munster, germany']
gubian19_interspeech	['institute of phonetics and speech processing, lmu munich, germany', 'school of linguistics and applied language studies, victoria univ. of wellington, new zealand']
gessinger19_interspeech	['language science and technology, saarland university, germany', 'audeering gmbh, gilching, germany']
niebuhr19b_interspeech	['centre of industrial electronics, mads clausen institute, university of southern denmark', 'chair of technology management, fau erlangen-nuremberg, germany']
michalsky19_interspeech	['chair of technology management, fau erlangen-nuremberg, germany', 'institute for german studies, university of oldenburg, germany', 'institute of psychology, georg-august-university goettingen, germany']
sager19_interspeech	['department of electrical and computer engineering', 'johns hopkins university, baltimore md 21218, usa']
koh19_interspeech	['school of humanities, nanyang technological university, singapore', 'digital services lab, info-communications and media development authority, singapore']
picheny19_interspeech	['ibm research ai', 'ibm t j. watson research center yorktown heights, ny 10598']
ramteke19_interspeech	['national institute of technology karnataka, surathkal, india', 'school of allied health sciences, manipal, karnataka']
ali19_interspeech	['†qatar computing research institute', 'hamad bin khalifa university, doha, qatar', '‡computational approaches to modeling language lab', 'new york university abu dhabi, uae']
fallgren19_interspeech	['kth royal institute of technology']
diez19_interspeech	['brno university of technology, faculty of information technology, it4i centre of excellence', 'speechlab, department of computer science and engineering, shanghai jiao tong university']
vestman19_interspeech	['biometrics research laboratories, nec corporation, japan', 'computational speech group, university of eastern finland, finland']
shon19_interspeech	['mit computer science and artificial intelligence laboratory, cambridge, ma, usa', 'center for language and speech processing, johns hopkins university, baltimore, usa', 'mit lincoln laboratory, lexington, ma, usa']
gao19_interspeech	['university of science and technology of china, hefei, china', 'school of computing, university of kent, medway, uk']
lin19_interspeech	['data science research center, duke kunshan university, kunshan, china', 'school of electronics and information technology, sun yat-sen university, guangzhou, china,', 'limsi, cnrs, univ. paris-sud, universite paris-saclay, orsay, france']
chung19b_interspeech	['naver corporation, south korea']
xie19_interspeech	['center for language and speech processing &', 'human language technology center of excellence,', 'the johns hopkins university, baltimore, md', ', usa']
mccree19_interspeech	['human language technology center of excellence', 'johns hopkins university, baltimore, md, usa']
ghahabi19_interspeech	['eml european media laboratory gmbh, berliner strasse 45', ' heidelberg, germany']
park19_interspeech	['university of southern california', 'jd ai research']
shafey19_interspeech	['google']
cumani19_interspeech	['politecnico di torino, italy']
yamamoto19_interspeech	['nec corporation, japan']
ylmaz19_interspeech	['dept. of electrical and computer engineering, national university of singapore, singapore', 'cls/clst, radboud university, nijmegen, netherlands', 'cyberupt bv, south africa', 'icis, radboud university, nijmegen, netherlands']
dubey19_interspeech	['robust speech technologies lab (rstl), center for robust speech systems (crss)', 'the university of texas at dallas, richardson, tx- 75080, usa']
kovacs19_interspeech	['embedded internet systems lab, lulea university of technology, lulea, sweden', 'mta-szte research group on artificial intelligence, szeged, hungary', 'institute of informatics, university of szeged, szeged, hungary', 'department of electrical engineering (esat), ku leuven, leuven, belgium']
soni19_interspeech	['tcs innovations lab']
wu19c_interspeech	['key laboratory of speech acoustics and content understanding, institute of acoustics, china', 'university of chinese academy of sciences, china', 'xinjiang laboratory of minority speech and language information processing,', 'xinjiang technical institute of physics and chemistry, chinese academy of sciences, china']
ming19_interspeech	"[""queen's university belfast, belfast bt7 1nn, u.k.""]"
soni19b_interspeech	['tcs innovations lab', 'yantra park, thane, mumbai, india']
kumar19_interspeech	['samsung research institute india - bangalore']
delcroix19_interspeech	['ntt communication science laboratories, ntt corporation, kyoto, japan', 'center for language and speech processing, johns hopkins university, baltimore, md, usa']
hsu19_interspeech	['usc information sciences institute, marina del rey, ca, usa']
suzuki19_interspeech	['graduate school of integrated science and technology, shizuoka university, shizuoka, japan', 'national institute of advanced industrial science and technology, japan']
wu19d_interspeech	"[""school of computer science, northwestern polytechnical university, xi'an, china"", 'tencent ai lab, shenzhen, china', 'tencent ai lab, bellevue, usa']"
wang19b_interspeech	['department of computer science and engineering, the ohio state university, usa', 'center for cognitive and brain sciences, the ohio state university, usa']
wang19c_interspeech	['department of computer science and engineering, the ohio state university, usa', 'center for cognitive and brain sciences, the ohio state university, usa']
neekhara19b_interspeech	['uc san diego department of computer science', 'uc san diego department of electrical and computer engineering', 'uc san diego department of music']
fujimoto19_interspeech	['national institute of information and communications technology, japan']
liu19_interspeech	['national laboratory of pattern recognition, institute of automation, chinese academy of', 'sciences, china', 'school of artificial intelligence, university of chinese academy of sciences, china', 'tencent ai lab, bellevue, wa, usa', 'tencent ai lab, shenzhen, china', 'xueersi online school, china', 'kingsoft ai lab, china']
yang19_interspeech	['columbia university, usa']
dinkov19_interspeech	['faculty of mathematics and informatics, sofia university “st kliment ohridski”', 'qatar computing research institute, hbku']
an19_interspeech	['department of engineering technology, queensborough community college (cuny), usa', 'department of computer science, cuny graduate center, usa', 'department of computer and information science, brooklyn college (cuny), usa']
weninger19_interspeech	
gosztolya19_interspeech	['mta-szte research group on artificial intelligence, szeged, hungary', 'university of szeged, institute of informatics, szeged, hungary']
mori19_interspeech	['utsunomiya university, japan', 'chiba institute of technology, japan']
ludusan19_interspeech	['phonetics and phonology workgroup, faculty of linguistics and literary studies,', 'bielefeld university, germany']
truong19_interspeech	['human media interaction, university of twente, enschede, the netherlands', 'language science and technology, saarland university, saarbrucken, germany']
baird19_interspeech	['zd.b chair of embedded intelligence for health care & wellbeing, university of augsburg, germany', 'chair of health psychology, fau erlangen-nuremberg, germany', 'chair of clinical psychology and psychotherapy, university of ulm, germany', 'glam – group on language, audio and music, imperial college london, uk']
baird19b_interspeech	['zd.b chair of embedded intelligence for health care and wellbeing, univeristy of augsburg, germany', 'department of music, university of liverpool, uk', 'computer science department, columbia university, usa', 'glam – group on language, audio and music, imperial college london, uk']
niebuhr19c_interspeech	['mads clausen institute, centre for industrial electronics, university of southern denmark', 'dept. of design and communication, university of southern denmark']
vasquezcorrea19_interspeech	['pattern recognition lab, friedrich-alexander-universitat erlangen-nurnberg, erlangen, germany', 'faculty of engineering, universidad de antioquia udea, calle 70 no. 52-21, medellin, colombia']
chang19_interspeech	['graduate institute of communication engineering, national taiwan university']
meier19_interspeech	['cognitive systems lab, university of bremen, germany']
beeferman19_interspeech	['lab for social machines, mit media lab']
mdhaffar19_interspeech	['quiniou', '⋆lium - university of le mans, france', '‡ lia - university of avignon, france', 'ls2n - university of nantes , france']
marinelli19_interspeech	['signals and interactive systems lab, university of trento', 'vui inc.']
dabike19_interspeech	['department of computer science, university of sheffield, uk']
huang19b_interspeech	['department of computer science, university of sheffield, sheffield, uk']
vidal19_interspeech	['departamento de computacion, fceyn, universidad de buenos aires (uba), argentina', 'instituto de investigacion en ciencias de la computacion (icc), conicet-uba, argentina']
angerbauer19_interspeech	['institute for natural language processing (ims), university of stuttgart, germany', 'visualisation research centre (visus), university of stuttgart, germany', 'bosch center for artificial intelligence (bcai), renningen, germany']
luo19_interspeech	['mit computer science and artificial intelligence laboratory', 'ford motor company']
gutz19_interspeech	['department of communication sciences and disorders, mgh institute of health professions, usa', 'speech and hearing bioscience and technology program, harvard university, usa', 'department of communication sciences and disorders, university of texas at austin, usa', 'department of speech-language pathology, university of toronto, canada']
k19_interspeech	['indian institute of technology kharagpur, india']
heo19_interspeech	['school of computer science, university of seoul, south korea']
chen19_interspeech	['samsung research america', '\x02\x03\x04\x05\x06\x07\x05\x08', '\x0e\x05\x08\x0f\x07\x04\t\x10\x07\x05\x11\x12\x13\x04\x14\x13\x15\x05\x08', '\x0e\x14']
sharma19_interspeech	['department of electrical and computer engineering,', 'national university of singapore, singapore']
shrem19_interspeech	['department of computer science, bar-ilan university, ramat-gan, israel', 'department of linguistics, northwestern university, evanston, il, usa']
hui19_interspeech	['hkust-shenzhen research institute, shenzhen, china', 'department of industrial engineering and decision analytics, the hong kong university of', 'science and technology, hong kong, china', 'bioengineering graduate program, school of engineering, the hong kong university of science', 'and technology, hong kong, china']
shah19_interspeech	['speech research lab,', 'dhirubhai ambani institute of information and communication technology (da-iict),', 'gandhinagar, india']
shankar19_interspeech	['department of electrical and computer engineering, johns hopkins university']
mateju19_interspeech	['faculty of mechatronics, informatics and interdisciplinary studies,', 'technical university of liberec, studentska 2', ' 17 liberec, czech republic']
tang19_interspeech	['university of maryland, united states']
paul19_interspeech	['department of computer science, university of crete, greece', 'institute of applied and computational mathematics, forth, greece']
chou19_interspeech	['college of electrical engineering and computer science, national taiwan university']
lu19_interspeech	['tsinghua-cuhk joint research center for media sciences, technologies and systems,', 'graduate school at shenzhen, tsinghua university, shenzhen, china', 'beijing national research centre for information science and technology (bnrist),', 'department of computer science and technology, tsinghua university, beijing, china', 'department of systems engineering and engineering management,', 'the chinese university of hong kong, shatin, n.t., hong kong sar, china', 'tencent ai lab, tencent, shenzhen, china']
tobing19_interspeech	['graduate school of information science, nagoya university, japan', 'information technology center, nagoya university, japan']
kaneko19_interspeech	['ntt communication science laboratories, ntt corporation, japan']
kurita19_interspeech	['nagoya university, furo-cho, chikusa-ku, nagoya, aichi, japan']
zhao19b_interspeech	['machine intelligence technology, alibaba group']
juvela19_interspeech	['aalto university, finland', 'national institute of informatics, japan', 'university of edinburgh, uk']
yamamoto19b_interspeech	['line corp., tokyo, japan', 'naver corp., seongnam, korea']
mohammadi19_interspeech	['oben, inc.']
huang19c_interspeech	['academia sinica, taiwan', 'nagoya university, japan']
liu19b_interspeech	['human-computer communications laboratory,', 'the chinese university of hong kong, shatin, n.t., hong kong sar, china', 'speechx limited, shenzhen, china']
chen19b_interspeech	
ding19_interspeech	['department of computer science and engineering, texas a&m university, usa']
stephenson19_interspeech	['intel ai lab, santa clara, ca, usa']
dey19_interspeech	['idiap research institute', 'adobe research']
kim19_interspeech	['samsung research, seoul, south korea']
zhu19_interspeech	['key laboratory of speech acoustics and content understanding, institute of acoustics, china', 'university of chinese academy of sciences, china', 'xinjiang laboratory of minority speech and language information processing, xinjiang technical', 'institute of physics and chemistry, chinese academy of sciences, china']
guo19_interspeech	"['shaanxi provincial key laboratory of speech and image information processing,', ""school of computer science, northwestern polytechnical university, xi'an, china""]"
kitza19_interspeech	['human language technology and pattern recognition, computer science department,', 'rwth aachen university', ' aachen, germany', 'apptek gmbh', ' aachen, germany']
xie19b_interspeech	['chinese university of hong kong, hong kong, china', 'shenzhen institutes of advanced technology, chinese academy of sciences, shenzhen, china']
tsunoo19_interspeech	['sony corporation, japan']
sar19_interspeech	['department of electrical and computer engineering, university of illinois at urbana-champaign', 'ibm research ai']
sim19_interspeech	['google, usa']
jain19_interspeech	['samsung r&d institute, india - bangalore']
shor19_interspeech	['google, united states', 'als therapy development institute, united states']
peskov19_interspeech	['university of maryland department of computer science and umiacs', 'carnegie mellon university language technology institute', 'university of maryland department of computer science, ischool, umiacs, and lsc']
gupta19_interspeech	['amazon.com, cambridge, ma-usa']
marzinotto19_interspeech	['orange labs/ lannion france', 'aix marseille universite, univ. toulon, cnrs, lis, marseille, france']
parcollet19_interspeech	['avignon universite, lia, france', 'orkis, aix-en-provence, france']
georges19_interspeech	
lugosch19_interspeech	
shivakumar19_interspeech	['signal processing for communication understanding and behavior analysis laboratory', 'university of southern california, los angeles, usa']
tomashenko19_interspeech	['lia, university of avignon, france', 'lium, university of le mans, france']
song19_interspeech	['department of computer science and engineering,', 'the hong kong university of science and technology, hong kong', 'ai group, webank co., ltd, shenzhen, china']
masumura19_interspeech	['ntt media intelligence laboratories, ntt corporation, japan']
chien19_interspeech	['department of electrical and computer engineering, national chiao tung university, taiwan']
williams19_interspeech	['microsoft', 'one microsoft way, redmond, washington']
korpusik19_interspeech	['loyola marymount university, los angeles, ca 90045, usa', 'mit computer science and artificial intelligence laboratory, cambridge, ma 02139, usa']
kobayashi19_interspeech	['corporate research & development center, toshiba corporation, japan']
seneviratne19_interspeech	['university of maryland college park', 'pindrop']
dash19_interspeech	"['department of bioengineering, university of texas at dallas, usa', 'department of psychology, university of texas at austin, usa', ""meg lab, dell children's medical center, austin, tx, usa"", 'callier center for communication disorders, university of texas at dallas, usa']"
sheth19_interspeech	['dept. of physics and astronomy, university of california, los angeles, usa', 'dept. of neurology and neurosurgery, tel aviv university, tel aviv, isr', 'dept. of neurosurgery, university of california, los angeles, usa', 'dept. of linguistics, university of california, los angeles, usa', 'dept. of radiological sciences, university of california, los angeles, usa']
silva19_interspeech	
douros19_interspeech	['universite de lorraine, cnrs, inria, loria, f-54000 nancy, france,', 'universite de lorraine, inserm u1254, iadi, f-54000 nancy, france']
rasskazova19_interspeech	['humboldt-universitat zu berlin, germany', 'leibniz-centre general linguistics, germany']
gubian19b_interspeech	['institute of phonetics and speech processing, lmu munich, germany']
csapo19_interspeech	['department of telecommunications and media informatics,', 'budapest university of technology and economics, budapest, hungary', 'mta-elte lendulet lingual articulation research group, budapest, hungary', 'mta-szte research group on artificial intelligence, szeged, hungary', 'institute of informatics, university of szeged, hungary', 'department of phonetics, e¨otv¨os lorand university, budapest, hungary']
klein19_interspeech	['humboldt-universitat zu berlin, germany', 'ludwig-maximilians-universitat munchen, germany']
takemoto19_interspeech	['chiba institute of technology, japan', 'konan university, japan', 'national institute for japanese language and linguistics, japan']
leeuwen19_interspeech	['department of head and neck oncology and surgery, netherlands cancer institute, amsterdam', 'department of radiology, netherlands cancer institute, amsterdam', 'techmed center, university of twente, enschede', 'amsterdam center for language and communication, university of amsterdam, amsterdam', 'the netherlands']
mucke19_interspeech	['ifl-phonetics, university of cologne, germany', 'laboratoire de phonetique et phonologie, umr 7018, cnrs/sorbonne-nouvelle, france', 'cornell university, ithaca, united states', '\x02']
kleijn19_interspeech	['google llc., san francisco, ca', 'school of engineering and computer science, victoria university of wellington, new zealand']
ramanathi19_interspeech	['electrical engineering, indian institute of science (iisc), bangalore 560012, india']
mannem19_interspeech	['electrical engineering, indian institute of science (iisc), bangalore 560012, india', 'rajiv gandhi university of knowledge technologies (rgukt), kadapa', ', india']
springenberg19_interspeech	['university of hamburg - dept. of informatics, knowledge technology']
paraskevopoulos19_interspeech	
dhiman19_interspeech	['department of electrical engineering, indian institute of science, bangalore-12, india', 'department of computer science, university of crete, greece']
xu19_interspeech	['college of internet of things, nanjing university of posts and telecommunications, p.r. china', 'agile robots ag, germany', 'group on language audio and music, imperial college london, uk', 'school of information science and engineering, southeast university, p.r. china']
sudhakara19_interspeech	['electrical engineering, indian institute of science (iisc), bangalore 560012, india']
saha19b_interspeech	['electrical engineering, jadavpur university, kolkata 700032, india', 'electrical engineering, indian institute of science (iisc), bangalore 560012, india']
vasquezcorrea19b_interspeech	['pattern recognition lab, friedrich-alexander-universitat, erlangen, germany.', 'faculty of engineering, universidad de antioquia udea, medellin, colombia.', 'department of otorhinolaryngology. ludwig-maximilians-university, munich, germany.', 'machine learning and data analysis lab, friedrich-alexander-universitat, erlangen, germany.', 'th rosenheim, rosenheim, germany.']
kiss19_interspeech	['budapest university of technology and economics, budapest, hungary']
yarra19_interspeech	['electrical engineering, indian institute of science (iisc), bangalore 560012, india', 'rajiv gandhi university of knowledge technologies (rgukt), kadapa', ', india']
nissen19b_interspeech	['department of communication disorders, brigham young university, provo, utah, usa', 'news media, department of communications, brigham young university, provo, utah, usa']
miwardelli19_interspeech	
annand19_interspeech	['university of cincinnati - usa']
radostev19_interspeech	['ai and research, microsoft corporation']
ryant19_interspeech	"['linguistic data consortium, university of pennsylvania, philadelphia, pa, usa', 'baidu research, sunnyvale, ca, usa', ""laboratoire de sciences cognitives et de psycholinguistique, dept d'etudes cognitives, ens,"", 'ehess, cnrs, psl university, paris, france', 'university of science and technology of china, hefei, china', 'electrical engineering department, indian institute of science, bangalore, india']"
singh19_interspeech	['learning and extraction of acoustic patterns (leap) lab, indian institute of science', 'university of jaffna, sri lanka']
vinals19_interspeech	['vivolab, aragon institute for engineering research (i3a), university of zaragoza, spain']
zajic19_interspeech	['university of west bohemia', 'faculty of applied sciences', 'ntis - new technologies for the information society and 2dept. of cybernetics,', 'univerzitni 8', ' 14 plzeˇn, czech republic']
park19b_interspeech	['university of southern california, los angeles, ca, usa']
novoselov19_interspeech	['itmo university, st.petersburg, russia', 'stc-innovations ltd., st.petersburg, russia']
todisco19_interspeech	
lai19b_interspeech	['center for language and speech processing, johns hopkins university, baltimore, md, usa']
chettri19_interspeech	['school of eecs, queen mary university of london, united kingdom', 'school of eecs, kth royal institute of engineering, stockholm, sweden']
cai19_interspeech	['data science research center, duke kunshan university, kunshan, china', 'school of electronics and information technology, sun yat-sen university, guangzhou, china']
biaobrzeski19_interspeech	['samsung r&d institute poland']
lavrentyeva19_interspeech	['stc-innovations ltd., st.petersburg, russia', 'itmo university, st.petersburg, russia']
yang19b_interspeech	['moe key lab of artificial intelligence', 'speechlab, department of computer science and engineering', 'shanghai jiao tong university, shanghai, china']
alluri19_interspeech	['speech processing laboratory, kcis', 'international institute of information technology, hyderabad, india']
li19c_interspeech	['school of electronic science and engineering, xiamen university, china', 'school of information science and engineering, xiamen university, china']
williams19b_interspeech	['the centre for speech technology research, university of edinburgh, united kingdom']
das19_interspeech	['department of electrical and computer engineering,', 'national university of singapore, singapore']
chang19b_interspeech	['national sun yat-sen university, taiwan']
gomezalanis19_interspeech	['university of granada, granada, spain', 'university of malaga, malaga, spain']
zeinali19_interspeech	['brno university of technology, faculty of it, it4i centre of excellence, czechia', 'omilia - conversational intelligence, athens, greece']
alzantot19_interspeech	['department of computer science, ucla, los angeles, usa', 'department of electrical and computer engineering, ucla, los angeles, usa']
jung19_interspeech	['school of computer science, university of seoul, south korea']
dunbar19_interspeech	"['laboratoire de linguistique formelle (cnrs - paris diderot - sorbonne paris cite), france', 'cognitive machine learning (ens - cnrs - ehess - inria - psl research university), france', 'department of computer graphics and multimedia, brno univ. of technology, czech republic', 'language technologies institute, carnegie mellon university, usa', ""laboratoire d'informatique de grenoble, equipe getalp (universite grenoble alpes), france"", 'nara institute of science and technology, japan', 'riken center for advanced intelligence project, japan', 'facebook a.i. research, paris, france']"
feng19b_interspeech	['department of electronic engineering, the chinese university of hong kong, hong kong']
yusuf19_interspeech	['bogazici university, turkey', 'national defense university naval academy, turkey']
eloff19_interspeech	['dept. e&e engineering, stellenbosch university, south africa', 'cstr, school of informatics, university of edinburgh, uk']
liu19c_interspeech	['college of electrical engineering and computer science, national taiwan university']
s19_interspeech	['indian institute of technology madras']
tjandra19_interspeech	['graduate school of information science, nara institute of science and technology, japan', 'riken, center for advanced intelligence project aip, japan', 'department of electrical and computer engineering, national university of singapore, singapore']
jia19_interspeech	['google']
liu19d_interspeech	['nlpr, institute of automation, chinese academy of sciences, beijing, china', 'university of chinese academy of sciences, beijing, china', 'cas center for excellence in brain science and intelligence technology, beijing, china', 'baidu inc. no. 10, shangdi 10th street, beijing, china']
gangi19_interspeech	['university of trento, italy', 'fondazione bruno kessler, trento, italy']
hillis19_interspeech	['language technologies institute, carnegie mellon university, pittsburgh, pa, usa']
bhattacharya19_interspeech	['mcgill university', 'computer research institute of montreal']
wang19d_interspeech	['moe key lab of artificial intelligence', 'speechlab, department of computer science and engineering', 'shanghai jiao tong university, shanghai, china']
ravanelli19_interspeech	
you19_interspeech	['national engineering laboratory for speech and language information processing', 'university of science and technology of china, hefei, china']
wu19e_interspeech	['moe key lab of artificial intelligence', 'speechlab, department of computer science and engineering', 'shanghai jiao tong university, shanghai, china']
you19b_interspeech	['national engineering laboratory for speech and language information processing', 'university of science and technology of china, hefei, china']
bhat19_interspeech	['interactions llc, usa']
vukotic19_interspeech	['lamark / imatag, rennes, france', 'insa rennes & inria/irisa, rennes, france']
ray19_interspeech	['samsung research america, mountain view, ca, usa']
bhosale19_interspeech	['tcs research and innovation - mumbai, india']
takatsu19_interspeech	['waseda university, japan', 'honda r&d co.,ltd, japan', 'chiba institute of technology, japan']
caubriere19_interspeech	['lium - le mans university', 'lia - avignon university', 'ls2n - university of nantes, cnrs']
dash19b_interspeech	"['department of bioengineering, university of texas at dallas, usa', 'department of psychology, university of texas at austin, usa', ""meg lab, dell children's medical center, austin, tx, usa"", 'callier center for communication disorders, university of texas at dallas, usa']"
nijveld19_interspeech	['cls, radboud university, nijmegen, the netherlands', 'clst, radboud university; donders institute, nijmegen, the netherlands']
bosch19_interspeech	['radboud university nijmegen, the netherlands', 'max planck institute for psycholinguistics, the netherlands']
kharaman19_interspeech	['department of linguistics, university of konstanz, germany']
scharenborg19_interspeech	['multimedia computing group, delft university of technology, the netherlands', 'radboud university nijmegen, the netherlands', 'department of psychology, university of illinois at urbana-champaign, usa', 'beckman institute, university of illinois at urbana-champaign, il, usa']
parmonangan19_interspeech	['division of information science, nara institute of science and technology, japan', 'riken, center for advanced intelligence project aip, japan', 'graduate school of information science and technology, the university of tokyo, japan']
huang19d_interspeech	['google inc., usa']
zhao19c_interspeech	['machine intelligence technology, alibaba group']
khokhlov19_interspeech	['stc-innovations ltd, st. petersburg, russia', 'itmo university, st. petersburg, russia', 'speech technology center ltd, st. petersburg, russia']
kanda19b_interspeech	['hitachi ltd., japan', 'paderborn university, germany']
drude19_interspeech	['paderborn university, department of communications engineering, paderborn, germany']
ma19_interspeech	['university of science and technology of china, hefei, anhui, p r. china', 'iflytek research, hefei, anhui, p.r.china', 'georgia institute of technology, atlanta, ga. usa']
padi19_interspeech	['minds.ai, bengaluru, india.', 'learning and extraction of acoustic patterns (leap) lab, electrical engineering,', 'indian institute of science, bengaluru, india.']
jung19b_interspeech	['school of computer science, university of seoul, south korea']
rao19_interspeech	['department of electrical and computer engineering, national university of singapore, singapore', 'school of computer science and engineering, nanyang technological university, singapore', 'temasek laboratories, nanyang technological university, singapore']
mazzawi19_interspeech	['google research', 'google speech']
zheng19_interspeech	['institute of automation, chinese academy of science, china', 'school of artificial intelligence, university of chinese academy of science, china', 'microsoft china, beijing, china']
guo19b_interspeech	['∗school of computer science, northwestern polytechnical university, xian, china', '†microsoft china']
he19_interspeech	['school of computer science and engineering, beihang university, china', 'microsoft china', '* work done during internship at microsoft stc asia']
zhang19b_interspeech	['national university of singapore, singapore', 'national institute of informatics, tokyo, japan']
luong19_interspeech	['national institute of informatics, tokyo, japan', 'sokendai (the graduate university for advanced studies), kanagawa, japan', 'kddi research inc., saitama, japan', 'university of edinburgh, edinburgh, uk']
okamoto19_interspeech	['national institute of information and communications technology, japan', 'information technology center, nagoya university, japan']
kafle19_interspeech	['rochester institute of technology', 'lomb memorial drive, rochester, ny']
chien19b_interspeech	['department of electrical and computer engineering, national chiao tung university, taiwan']
sun19_interspeech	['∗, william sethares , erik p bucy', 'electrical and computer engineering, uw-madison', 'comc, texas tech university']
shen19_interspeech	
tundik19_interspeech	['budapest university of technology and economics, budapest, hungary', 'nokia solutions and networks ltd, budapest, hungary', 'spicy analytics ltd, budapest, hungary', 'telepathy labs gmbh, zurich, switzerland']
huang19e_interspeech	['college of mathematics and informatics, south china agricultural university, china']
narisetty19_interspeech	['data science research laboratories, nec corporation, japan']
takahashi19_interspeech	['sony corporation, japan', 'sony india software centre, india']
appeltans19_interspeech	['department of computer science - ku leuven - belgium', 'processing speech and images - esat - ku leuven - belgium']
gu19_interspeech	['key laboratory of modern acoustics, institute of acoustics, nanjing university, nanjing 210093,', 'china', 'nanjing institute of advanced artificial intelligence, nanjing 210014, china']
yang19c_interspeech	['graduate institute of networking and multimedia, national taiwan university']
wichern19_interspeech	['mitsubishi electric research laboratories (merl), cambridge, ma, usa', 'whisper.ai, san francisco, ca, usa']
chermaz19_interspeech	['the centre for speech technology research, university of edinburgh, united kingdom', 'dept. medical physics and acoustics and cluster of excellence hearing4all, university of', 'oldenburg, germany']
edraki19_interspeech	
zhang19c_interspeech	['department of speech and hearing sciences, indiana university, usa', 'department of computer science, indiana university, usa']
dinh19_interspeech	['oregon health & science university', 'university of new york at buffalo']
platen19_interspeech	['cambridge university engineering dept., trumpington st., cambridge, cb2 1pz u.k.', 'institute of communication systems (iks), rwth aachen university, germany']
merboldt19_interspeech	['human language technology and pattern recognition, computer science department,', 'rwth aachen university', ' aachen, germany', 'apptek gmbh', ' aachen, germany']
sun19b_interspeech	['microsoft speech and language group']
karita19_interspeech	['ntt communication science laboratories, japan', 'waseda university, japan', 'center for language and speech processing, johns hopkins university, usa']
zhang19d_interspeech	['centre for speech technology research, university of edinburgh, edinburgh, uk', 'institute for language, cognition and computation, university of edinburgh, edinburgh, uk']
zhao19d_interspeech	['google, inc., usa']
nasir19_interspeech	['university of southern california, los angeles, ca, usa', 'university of utah, salt lake city, ut, usa', 'university of washington, seattle, wa, usa']
du19_interspeech	['language technologies institute, carnegie mellon university', 'department of psychology, university of pittsburgh']
voleti19_interspeech	
matton19_interspeech	
rohanian19_interspeech	['school of electronic engineering and computer science', 'queen mary university of london, uk']
espywilson19_interspeech	['speech communication laboratory, institute of systems research, and department of electrical', 'and computer engineering, university of maryland, college park, maryland 20742', 'bioengineering systems & technologies, mit lincoln laboratory, lexington, ma 02421']
paul19b_interspeech	['amazon']
goel19_interspeech	['amazon']
martinek19_interspeech	['dept. of computer science & engineering', 'university of west bohemia', 'plzeˇn, czech republic', 'ntis - new technologies for the information society', 'university of west bohemia', 'plzeˇn, czech republic', 'loria umr 7503', 'bp 239 - 54506 vandoeuvre, france']
chao19_interspeech	
griol19_interspeech	['dept. of computer science, universidad carlos iii de madrid, spain', 'dept. of languages and computer systems, university of granada, spain']
chen19c_interspeech	['apple inc.', 'one apple park way', 'cupertino, ca 95014 united states']
sadjadi19_interspeech	['nist itl/iad/multimodal information group, md, usa', 'mit lincoln laboratory, lexington, ma, usa', 'u.s. department of defense, md, usa']
villalba19_interspeech	['center for language and speech processing, johns hopkins university, baltimore, md, us', 'human language technology center of excellence, johns hopkins university, baltimore, md, us', 'mit lincoln laboratory, lexington, ma, us', 'mit computer science and artificial intelligence laboratory, cambridge, ma, us', 'lse-epita, villejuif, france']
garciaromero19_interspeech	
lee19_interspeech	['nec corporation, japan', 'university of eastern finland, finland', 'jd ai research and platform, usa', 'institute for infocomm research, singapore', 'lium, universite du maine, france', 'national university of singapore, singapore', 'lia, university of avignon, france', 'nanyang technological university, singapore', 'northwestern polytechnic university, china', 'crss, university of texas at dallas, usa', 'eurecom, france']
khoury19_interspeech	['pindrop, atlanta, ga, usa']
garciaromero19b_interspeech	['human language technology center of excellence & center for language and speech processing', 'the johns hopkins university, baltimore, md 21218, usa']
ayllon19_interspeech	['oben inc., ca, usa']
kuo19_interspeech	['oben inc., ca, usa']
braude19_interspeech	['cereproc ltd., uk', 'university of madeira, madeira iti, portugal', 'dublin city university, ireland', 'university of edinburgh, uk', 'technical university of cluj-napoca, romania']
zen19_interspeech	
shamsi19_interspeech	['univ rennes, cnrs, irisa']
hojo19_interspeech	['ntt communication science laboratories']
lo19_interspeech	['institute of information science, academia sinica, taipei, taiwan', 'research center for information technology innovation, academia sinica, taipei, taiwan', 'graduate school of informatics, nagoya university, japan', 'national institute of informatics, japan']
fong19_interspeech	['the centre for speech technology research, university of edinburgh, united kingdom']
govender19_interspeech	['the centre for speech technology research, university of edinburgh, united kingdom', 'department of otorhinolaryngology / head and neck surgery, university medical center', 'groningen, university of groningen, the netherlands']
douros19b_interspeech	['universite de lorraine, cnrs, inria, loria, f-54000 nancy, france', 'universite de lorraine, inserm u1254, iadi, f-54000 nancy, france', 'biomedizinische nmr, mpi fur biophysikalische chemie', ' g¨ottingen, germany', 'universite de lorraine, inserm, cic-it 1433, chru de nancy, f-54000 nancy, france']
chen19d_interspeech	['national engineering laboratory for speech and language information processing,', 'university of science and technology of china, hefei, p.r. china']
park19c_interspeech	['∗kakao brain, south korea', 'expedia group, usa']
karaulov19_interspeech	['sciforce, ukraine']
tong19_interspeech	['idiap research institute, martigny, switzerland', 'ecole polytechnique federale de lausanne (epfl), switzerland']
cui19_interspeech	['ibm research ai', 'ibm t j. watson research center, yorktown heights, ny 10598, usa']
shah19b_interspeech	['speech research lab, da-iict, gandhinagar, india', 'speech and hearing research group, university of sheffield, uk']
goyal19_interspeech	['indian institute of technology, delhi']
fainberg19_interspeech	['centre for speech technology research, university of edinburgh, united kingdom']
michel19_interspeech	['human language technology and pattern recognition, computer science department,', 'rwth aachen university', ' aachen, germany']
masumura19b_interspeech	['ntt media intelligence laboratories, ntt corporation, japan']
heba19_interspeech	['irit, universite paul sabatier, cnrs, france', 'linagora, france']
kurata19_interspeech	['ibm research ai']
fukuda19_interspeech	['ibm research ai', 'chuo-ku hakozaki, tokyo', '-8510, japan']
ladkat19_interspeech	['amazon.com']
huang19f_interspeech	['institute of information science, academia sinica, taiwan', 'research center for information technology innovation, academia sinica, taiwan', 'national taiwan university of science and technology, taiwan']
kurata19b_interspeech	['ibm research ai']
li19e_interspeech	['toshiba (china) r&d center, china']
georgiou19_interspeech	['school of ece, national technical university of athens, athens, greece', 'behavioral signal technologies, los angeles, ca, usa']
mitra19_interspeech	['apple, cupertino, ca, usa']
parry19_interspeech	['speech graphics ltd, edinburgh, united kingdom']
wang19e_interspeech	['department of psychiatry, university of oxford, uk', 'mathematical institute, university of oxford, uk', 'the alan turing institute, london, uk', 'department of mathematics, university college london, uk', 'department of computer science, university of warwick, uk']
egorow19_interspeech	['cognitive systems group, otto von guericke university, magdeburg, germany', 'virtual engineering, fraunhofer institute for factory operation and automation, magdeburg,', 'germany']
zhao19e_interspeech	['school of information, renmin university of china']
zhong19_interspeech	['department of electrical engineering, national tsing hua university, taiwan', 'college of management, national taiwan university, taiwan', 'most joint research center for ai technology and all vista healthcare, taiwan']
chao19b_interspeech	['department of electrical engineering, national tsing hua university, taiwan', 'most joint research center for ai technology and all vista healthcare, taiwan']
mao19_interspeech	['department of electronic engineering, the chinese university of hong kong, hong kong']
triantafyllopoulos19_interspeech	['audeering gmbh, gilching, germany', 'zd.b chair of embedded intelligence for health care and wellbeing, university of augsburg,', 'germany', 'glam – group on language, audio & music, imperial college london, uk']
li19f_interspeech	['tsinghua national laboratory for information science and technology, department of electronic', 'engineering, tsinghua university', 'institute of forensic science, ministry of public security, china', 'key laboratory of intelligent speech technology, ministry of public security, china']
jalal19_interspeech	['speech and hearing research group (spandh), university of sheffield, sheffield, uk', 'centre for speech technology research (cstr), university of edinburgh, edinburgh, uk']
dapolito19_interspeech	"['universita del salento - cril', 'this paper investigates the interaction between the', 'characteristics of both l1 and l2 phonetic-phonological', 'systems and how the context, in terms of the amount of', 'information available (less vs more information), may', 'influence the accuracy in producing l2 sounds as well as', 'speech fluency. specifically, it focuses on how french', 'learners of italian as l2, representing two different', 'competence levels (lower and higher), realize geminates (non-', 'native sounds) in two different contexts (less and more rich).', 'a rich context is expected to induce lower accuracy. acoustic', 'data of nine subjects (three beginners, three advanced and', 'three natives as control) were collected and analyzed in order', 'to observe: 1) the realization of geminates (duration of the', 'consonant and preceding vowel as an index of accuracy); and', ') the speech fluency (number and duration of disfluencies;', ""speech/articulation rate). results suggest that learners'"", 'productions are affected by l1, above all in the case of', 'beginners, who show a lower degree of accuracy. as regards', 'the accuracy and context interaction, results show that the', 'production of geminates is more accurate (longer duration) in', 'poor than in rich context. further, a higher number of', 'disfluencies is found in rich than in poor context.', 'index terms: geminates, italian as l2, context, l2 speech', 'accuracy, l2 speech fluency.', '. introduction', 'it is well known that accuracy in l2 speech is affected by the', 'characteristics of l1 [1] and, thus, investigating accuracy in', 'l2 pronunciation offers an overview of the interaction of the', 'l1 and l2 systems. for instance, the production of italian', 'geminates by french speakers is expected to lack in accuracy,', 'as gemination is not familiar to french. the duration of', 'consonants is a contrastive feature in italian so that words', 'have a different meaning in case a singleton (c) or a geminate', '(cc) consonant appears [2]. moreover, gemination implies a', 'change not only in the duration of the consonant but also in', 'the duration of the preceding vowel, which is shorter when', 'followed by cc and it is longer before c [3]. on the contrary,', 'french does not have gemination, except for the uvular', 'approximant within the opposition between the imperfect', 'tense and the conditional mood (e.g. pourait vs. pourrait) [4].', 'thus, gemination represents an interesting phenomenon to', 'investigate the interaction between a french-l1 and an italian-', 'l2 system.', 'the production of the geminates can be problematic for', 'l2 learners [5,6,7,8] and accuracy in production also has an', 'important', 'impact', 'on', 'comprehension.', 'thus,', 'studying', 'pronunciation accuracy of l2 non-native sounds gives', ""suggestion on learner's ability in communication. on the one"", 'hand, the ability to speak accurately and at comfortable rate', '(without long pauses and/or hesitations, that is fluently) allows', 'learners to express freely their own thoughts [9] and to be', 'comprehensible; on the other hand, it allows listeners to', 'comprehend the message without much effort. nevertheless,', 'in the literature, phonetic and phonological errors are reported', 'to account only for about 22% of l2 speech comprehension', '[10,11]. however, studies conducted on l2 pronunciation', 'often regard english as l2. further, the context in which', 'communication takes place may heavily affect the accuracy in', 'producing the intended message as well as its comprehension', '(see hyper and hypo-articulation theory [11]).', 'thus, it may be interesting: 1) to observe the interaction', 'between', 'phonetic-phonological', 'systems', 'different', 'from', 'english, such italian as l2 spoken by french learners; and 2)', 'to investigate the role of context on both production accuracy', 'and speech fluency.', '. goals and hypotheses', 'in this study, the singleton and geminate consonants are', 'realized by italian speakers and by french learners of italian', 'as l2 (two different competence levels, i.e. low and high', 'proficiency level) in two different contexts in which the', 'amount of information available varies (poor vs. rich context).', 'the contrast (measured in terms of duration) is observed in', 'order to investigate: 1) the interaction between the l1 and l2', 'phonetic-phonological systems in the production of non-native', 'sounds (geminates) by french speakers, who reached two', 'different competence levels', ') the interaction between the', 'amount of information available in the context (less vs more)', 'and l2 speech, in terms of: a) the accuracy in producing l2', 'non-native sounds; and b) speech fluency (disfluencies and', 'speaking/articulation rate).', 'the hypotheses are that: 1) french learners, due to the', 'influence of their l1, may reduce or substitute the non-native', 'sounds to/with native sounds; moreover, a lower accuracy is', 'expected by beginners [1]', 'a) information available in the', 'context affects accuracy, as lower accuracy (duration) is', 'expected when the context is rich, in that available', 'information may help to disambiguate the message [11]; and', 'b) the context affects speech fluency (speaking and', 'articulation rate), as a higher number disfluencies is expected', 'in the rich context, due to the greater attention to context', 'details required by the task.', '. method', 'nine subjects participated in the experiment. six french', 'learners were recruited among erasmus students at university', 'of salento (female; mean age 21.5: they came from paris (2),', 'nantes (3) and nancy (1)). according to the erasmus test', 'results, they were gathered into two groups: low competence', 'copyright © 2019 isca', 'interspeech 2019', 'september 15–19', ', graz, austria', 'http://dx.doi.org/10.21437/interspeech.2019-2934']"
jamakovic19_interspeech	['englisches seminar, westfalische wilhelms-universitat munster, germany', 'institut fur anglistik und amerikanistik, universitat hamburg, germany']
arantes19_interspeech	['languages and linguistics department, sao carlos federal university, brazil', 'department of linguistics, stockholm university, sweden']
kelly19_interspeech	['american university of beirut, lebanon']
jatteau19_interspeech	['limsi-cnrs, universite paris-saclay, orsay, france', 'lpp, cnrs-universite sorbonne nouvelle, paris, france']
huang19g_interspeech	['department of electrical engineering, national tsing hua university, taiwan']
schuppler19_interspeech	['signal processing and speech communication laboratory, graz university of technology, austria', 'institute for scandinavian studies, frisian studies and general linguistics,', 'university of kiel, germany']
johny19_interspeech	['google ai, london, united kingdom']
guitardivent19_interspeech	['laboratoire de phonetique et phonologie (umr7018, cnrs – sorbonne nouvelle)', 'french forensic police office (scpts)']
wei19_interspeech	['apple inc']
moczanow19_interspeech	['university of warsaw, poland']
berger19_interspeech	['institute for scandinavian studies, frisian studies and general linguistics,', 'university of kiel, germany', 'centre for industrial electronics, university of southern denmark, soenderborg, denmark']
luo19b_interspeech	['yangzhou university, china', '\x02\x03\x04\x05\x06\x07\x08', '\x07\x0c\r\x0e\x07\x0c\x0f\x05\x10']
zarka19_interspeech	['department of linguistics, university of graz, austria', 'signal processing and speech communication laboratory, graz university of technology, austria', 'ifl phonetics, university of cologne, germany']
alowonou19_interspeech	['college of intelligence and computing tianjin university, tianjin, china', 'japan advanced institute of science and technology, ishikawa, japan']
guo19c_interspeech	['zd.b chair of embedded intelligence for health care and wellbeing, university of augsburg,', 'germany', 'school of information science and engineering, lanzhou university, china', 'college of computer and information engineering, tianjin normal university, china', 'glam −group on language, audio & music, imperial college london, uk']
hao19_interspeech	
pascual19b_interspeech	['universitat politecnica de catalunya', 'telefonica research']
li19g_interspeech	['school of computer science and technology, wuhan university of technology, wuhan, hubei,', 'china']
lin19b_interspeech	['department of computer science and information engineering, national taiwan university, taiwan', 'research center for information technology innovation, academia sinica, taiwan', 'college of engineering, city university of hong kong, hong kong']
chai19_interspeech	['school of data science, university of science and technology of china, hefei, anhui, p r. china', 'university of science and technology of china, hefei, anhui, p r. china', 'georgia institute of technology, atlanta, ga. usa']
llombart19_interspeech	['vivolab, aragon institute for engineering research (i3a)', 'university of zaragoza, spain']
reddy19_interspeech	['microsoft corp., usa']
adiga19_interspeech	['†department of computer science, university of crete, greece', '∗institute of applied and computational mathematics, forth, greece']
pv19_interspeech	['speech signal processing lab (sspl), university of crete, greece']
braithwaite19_interspeech	['school of engineering and computer science', 'victoria university of wellington, new zealand']
kyriakopoulos19_interspeech	['alta institute / engineering department', 'cambridge university', 'trumpington st, cambridge cb2 1pz, uk']
merkx19_interspeech	['centre for language studies, radboud university, nijmegen, the netherlands']
skidmore19_interspeech	['speech and hearing research group, dept. computer science, university of sheffield, uk']
hansen19_interspeech	['center for robust speech systems (crss), eric jonsson school of engineering,', 'the university of texas at dallas (utd), richardson, texas, usa']
chen19e_interspeech	['graduate institute of communication engineering, national taiwan university']
trisitichoke19_interspeech	['graduate school of engineering, the university of tokyo']
karhila19_interspeech	['aalto university school of electrical engineering', 'university of helsinki']
yoon19_interspeech	['educational testing service', 'rosedale road, princeton, nj 08541, usa']
lu19b_interspeech	['alta institute / engineering department', 'cambridge university, uk']
yang19d_interspeech	['interdisciplinary program in cognitive science, seoul national university, republic of korea', 'department of linguistics, seoul national university, republic of korea']
hori19_interspeech	['mitsubishi electric research laboratories (merl), usa']
gopalakrishnan19_interspeech	['amazon alexa ai']
kubasova19_interspeech	['university of the fraser valley', 'abbotsford, bc, canada']
martinez19_interspeech	['signal analysis and interpretation lab, university of southern california, los angeles, ca, usa', 'department of couseling psychology, university of wisconsin-madison, madison, wi, usa', 'department of educational psychology, university of utah, salt lake city, ut, usa', 'department of psychiatry and behavioral sciences, university of washington, seattle, wa, usa']
haake19_interspeech	['tu dortmund university', 'universitat bielefeld']
li19h_interspeech	['university of chinese academy of social sciences', 'institute of linguistics, chinese academy of social sciences']
gjoreski19_interspeech	['voice inter connect gmbh, dresden, germany']
yu19_interspeech	['university of pittsburgh', 'adapt centre, trinity college dublin']
aldeneh19_interspeech	
lubold19_interspeech	['arizona state university, tempe, az, usa', 'utah state university, logan, ut, usa', 'california state university chico, chico, ca, usa']
lian19_interspeech	['national laboratory of pattern recognition, casia, beijing, china', 'cas center for excellence in brain science and intelligence technology, beijing, china', 'school of artificial intelligence, university of chinese academy of sciences, beijing, china']
oneill19_interspeech	['university college dublin, ireland']
kakouros19_interspeech	['department of digital humanities, university of helsinki, finland']
peperkamp19_interspeech	['laboratoire de sciences cognitives et psycholinguistique, ens - psl university – ehess –', 'cnrs, paris, france']
kocharov19_interspeech	['department of phonetics, saint petersburg university, russia']
gobl19_interspeech	['phonetics and speech laboratory, school of linguistic, speech and communication sciences', 'trinity college dublin, ireland']
chodroff19_interspeech	
park19d_interspeech	['department of electrical and computer engineering, johns hopkins university', 'computaional and information sciences directorate, army research laboratory']
sturm19_interspeech	['institute of phonetics, charles university, prague, czech republic']
kelterer19_interspeech	['department of linguistics, university of graz, austria', 'signal processing and speech communication laboratory, graz university of technology,', 'austria']
chien19c_interspeech	['center for analysis and design of intelligent agents, reykjavik university, reykjavik, iceland']
tavi19_interspeech	['university of eastern finland', 'tallinn university of technology']
xu19b_interspeech	['school of informatics, university of edinburgh', 'centre for speech technology research, university of edinburgh']
sharma19b_interspeech	['samsung r&d institute india, bangalore']
ardaillon19_interspeech	['umr 9912 stms (ircam / sorbonne university / cnrs), paris, france']
dong19_interspeech	['university of science and technology of china', 'microsoft search technology center asia, xiaoice']
sharma19c_interspeech	
sharma19d_interspeech	['department of electrical and computer engineering,', 'national university of singapore, singapore']
terasawa19_interspeech	['university of tsukuba, ibaraki, japan', 'wakayama university, wakayama, japan', 'health sciences university of hokkaido, sapporo, japan']
lin19c_interspeech	['cloudminds technology inc., santa clara, ca 95054']
yamamoto19c_interspeech	['department of advanced technology and science, tokushima university, tokushima, japan', 'panasonic corporation, osaka, japan']
gupta19b_interspeech	['department of electrical and computer engineering, national university of singapore']
vafeiadis19_interspeech	['information technologies institute, center for research & technology hellas, thessaloniki, greece', 'technological educational institute of crete, department of music technology and acoustics,', 'crete, greece', 'faculty of computing, engineering and media, de montfort university, leicester, uk']
kaburagi19_interspeech	['faculty of design, kyushu university', '-9-1 shiobaru, minami-ku, fukuoka', '-8540 japan']
zou19_interspeech	['institute of automation, chinese academy of sciences, china', 'university of chinese academy of sciences, china']
xue19_interspeech	"['shaanxi provincial key lab of speech and image information processing,', ""school of computer science, northwestern polytechnical university, xi'an, china"", 'jd.com, china', 'jd.com, usa']"
sokolov19_interspeech	['amazon.com, inc. usa']
taylor19_interspeech	['centre for speech technology research, the university of edinburgh']
chen19f_interspeech	['college of electrical engineering and computer science, national taiwan university']
zhang19e_interspeech	['google']
juzova19_interspeech	['department of cybernetics & new technologies for the information society,', 'faculty of applied sciences, university of west bohemia, pilsen, czech republic']
dai19_interspeech	['tsinghua-cuhk joint research center for media sciences, technologies and systems,', 'graduate school at shenzhen, tsinghua university, shenzhen, china', 'beijing national research centre for information science and technology (bnrist),', 'department of computer science and technology, tsinghua university, beijing, china', 'department of systems engineering and engineering management,', 'the chinese university of hong kong, shatin, n.t., hong kong sar, china', 'tencent ai lab, tencent, shenzhen, china']
yolchuyeva19_interspeech	['department of telecommunications and media informatics, budapest university of technology', 'and economics, budapest, hungary']
bleyan19_interspeech	['google']
chen19g_interspeech	['east china normal university', 'ping an technology']
cai19b_interspeech	['data science research center, duke kunshan university, kunshan, china', 'college of information and computer, taiyuan university of technology, taiyuan, china', 'school of electronics and information technology, sun yat-sen university, guangzhou, china']
sun19c_interspeech	['peking university', 'microsoft research', 'microsoft stc asia']
li19i_interspeech	['language technologies institute, carnegie mellon university; pittsburgh, pa; u.s.a.']
arsikere19_interspeech	
kannan19_interspeech	['google, inc.']
mendes19_interspeech	['voiceinteraction, portugal', 'inesc-id, portugal', 'instituto superior tecnico, universidade de lisboa, portugal']
viglino19_interspeech	['ecole polytechnique federale de lausanne', 'idiap research institute', 'logitech europe s.a.']
li19j_interspeech	['national institute of information and communications technology, kyoto, japan', 'kyoto university, kyoto, japan']
taneja19_interspeech	['indian institute of technology bombay, mumbai, india', 'microsoft india development center, hyderabad, india']
hu19_interspeech	['google, llc, usa']
khassanov19_interspeech	['school of computer science and engineering, nanyang technological university, singapore', 'temasek laboratories, nanyang technological university, singapore', 'machine intelligence technology, alibaba group']
zeng19_interspeech	['temasek laboratories, nanyang technological university, singapore', 'school of computer science and engineering, nanyang technological university, singapore', 'department of electrical and computer engineering, national university of singapore, singapore']
zhang19f_interspeech	['machine intelligence technology, alibaba group', 'school of computer science, northwestern polytechnical university']
swarup19_interspeech	
zhang19g_interspeech	['machine intelligence technology, alibaba group']
peyser19_interspeech	['google inc., u.s.a']
bai19_interspeech	['nlpr, institute of automation, chinese academy of sciences, china', 'school of artificial intelligence, university of chinese academy of sciences, china', 'cas center for excellence in brain science and intelligence technology, china', 'jiangsu normal university, china']
kao19_interspeech	['alexa speech, amazon']
li19k_interspeech	['national institute of information and communications technology, kyoto, japan', 'kyoto university, kyoto, japan']
guo19d_interspeech	['moe key lab of artificial intelligence', 'speechlab, department of computer science and engineering', 'shanghai jiao tong university, shanghai, china', 'aispeech ltd, suzhou china']
tanaka19_interspeech	['ntt media intelligence laboratories, ntt corporation']
malhotra19_interspeech	['learning and extraction of acoustic patterns (leap) lab, indian institute of science, bangalore.']
karafiat19_interspeech	['brno university of technology', 'john hopkins university', 'mitsubishi electric research laboratories (merl)']
zapotoczny19_interspeech	['university of wroclaw, poland']
jansche19_interspeech	['google research, london, united kingdom']
dudziak19_interspeech	['samsung ai center, cambridge', 'university of oxford', '* indicates equal contribution.']
gaur19_interspeech	['microsoft corporation, one microsoft way, redmond, wa 98052']
li19l_interspeech	['center for language and speech processing, the johns hopkins university, usa', 'human language technology center of excellence, the johns hopkins university, usa']
cohn19b_interspeech	['university of california, davis']
lewandowski19_interspeech	['independent scientist, stuttgart, germany', 'albert-ludwigs-universitat freiburg, germany']
lalonde19_interspeech	['boys town national research hospital, omaha, nebraska, usa']
bentum19_interspeech	['center for language studies, radboud university, nijmegen, the netherlands', 'max planck institute for psycholinguistics, nijmegen, the netherlands', 'knaw meertens institute, amsterdam, the netherlands']
bentum19b_interspeech	['center for language studies, radboud university, nijmegen, the netherlands', 'max planck institute for psycholinguistics, nijmegen, the netherlands', 'knaw meertens institute, amsterdam, the netherlands']
turner19_interspeech	['northwestern university']
bosch19b_interspeech	
liu19e_interspeech	['† electrical and computer engineering, ryerson university, toronto, on, canada', '‡ shenzhen research institute of big data, the chinese university of hong kong, shenzhen, china', '§ univ. grenoble alpes, cnrs, grenoble inp*, gipsa-lab', ' grenoble, france', '* institute of engineering univ. grenoble alpes']
yokoe19_interspeech	['sophia university, tokyo, japan']
meyer19_interspeech	['univ. grenoble alpes, cnrs, gipsa-lab, france', 'the world whistles research association, paris, france', 'laboratoire de phonetique et phonologie (lpp), univ. paris 3/cnrs, paris, france']
hsieh19_interspeech	['department of biomedical engineering, national yang-ming university, taiwan', 'biomedical engineering research and development center, national yang-ming university,', 'taiwan']
levari19_interspeech	['royal holloway, university of london, uk', 'north carolina state university, usa', 'laboratoire de sciences cognitives et psycholinguistique (ens – psl university, ehess,', 'cnrs), france']
segedin19_interspeech	['department of linguistics, university of california, davis, usa']
papadimitriou19_interspeech	['electrical and computer engineering department, university of thessaly, volos 38221, greece']
somandepalli19_interspeech	['department of electrical engineering, university of southern california, los angeles, ca, usa']
belitz19_interspeech	['crss: center for robust speech systems, the university of texas at dallas, richardson, tx, usa']
nguyen19_interspeech	['graz university of technology,', 'signal processing and speech communication lab.,', 'inffeldgasse 16c, a-8010 graz, austria/europe']
ahmed19_interspeech	['university of virginia', '∗', 'samsung research america']
moore19_interspeech	['speech and hearing research group, dept. computer science, university of sheffield, uk']
muckenhirn19_interspeech	['idiap research institute, martigny, switzerland', 'ecole polytechnique federale de lausanne, lausanne, switzerland,', 'mathematical institute, university of oxford, uk']
kilgour19_interspeech	['google ai, switzerland']
gong19_interspeech	['computer science and engineering, university of notre dame, in 46556, usa']
bt19_interspeech	['audio research group, singapore university of technology & design, singapore']
lee19b_interspeech	['school of eecs, gwangju institute of science and technology (gist), gwangju 61005, korea']
pienaar19_interspeech	['centre for text technology (ctext)', 'north-west university', 'potchefstroom, south africa']
maurer19_interspeech	['institute for the performing arts and film, zurich university of the arts, switzerland', 'department of computational linguistics, university of zurich, switzerland']
noll19_interspeech	['acoustics research institute, austrian academy of sciences, vienna']
eldesouki19_interspeech	['qatar computing research institute', 'hamad bin khalifa university, doha, qatar']
haider19_interspeech	['usher institute of population health sciences & informatics', 'edinburgh medical school, the university of edinburgh, uk']
gupta19c_interspeech	['department of electrical and computer engineering, national university of singapore, singapore']
schuller19_interspeech	['glam – group on language, audio & music, imperial college london, uk', 'chair of embedded intelligence for health care & wellbeing, university of augsburg, germany', 'audeering gmbh, gilching, germany', 'pattern recognition lab, fau erlangen-nuremberg, germany', 'division of phoniatrics, medical university of graz, austria', 'university of wuppertal, germany', 'rhenish university of applied science cologne, germany', 'department of linguistics, university of california, berkeley, usa', 'department of linguistics, university of graz, austria', 'psychology and neuroscience, duke university, usa', 'laboratoire de sciences cognitives et psycholinguistique, ecole normale superieure, france', 'speech, language, and hearing sciences, purdue university, usa', 'department of communication, university of california, los angeles, usa', 'department of psychology, university of pennsylvania, usa']
dubagunta19_interspeech	['idiap research institute, martigny, switzerland', 'ecole polytechnique federale de lausanne (epfl), switzerland']
elsner19_interspeech	['lmu munich, germany', 'tawny gmbh, germany']
kisler19_interspeech	['bavarian archive for speech signals,', 'institute of phonetics and speech processing,', 'ludwig maximilian university munich']
yeh19_interspeech	['tsai1,2, yu-wen tai1, zheng-chi lu1, chieh-yu chen3, tsung-ming tai3,', 'cheng-kuang lee3, chi-chun lee1,2', 'department of electrical engineering, national tsing hua university, taiwan', 'most joint research center for ai technology and all vista healthcare, taiwan', 'nvidia, taiwan']
wu19f_interspeech	['language technologies institute, carnegie mellon university, pa, usa']
ravi19_interspeech	['department of electrical and computer engineering, university of california los angeles, usa']
gosztolya19b_interspeech	['mta-szte research group on artificial intelligence, szeged, hungary', 'university of szeged, institute of informatics, szeged, hungary']
das19b_interspeech	['department of electrical and computer engineering,', 'national university of singapore, singapore']
schiller19_interspeech	['human centered multimedia, augsburg university, augsburg, germany']
caraty19_interspeech	['stih laboratory, paris university', ' rue des saints-peres', ', paris, france', 'stih laboratory, sorbonne university', ' rue serpente paris', ', paris, france']
wu19g_interspeech	['data science research center, duke kunshan university, kunshan, china', 'school of electronics and information technology, sun yat-sen university, guangzhou, china']
nandwana19_interspeech	['speech technology and research laboratory, sri international, menlo park, california, usa', 'lab41, in-q-tel, menlo park, california, usa']
novoselov19b_interspeech	['stc-innovations ltd., st. petersburg, russia', 'itmo university, st. petersburg, russia']
matejka19_interspeech	['brno university of technology, it4i center of excellence, brno, czechia']
medennikov19_interspeech	['stc-innovations ltd, st. petersburg, russia', 'itmo university, st. petersburg, russia', 'speech technology center ltd, st. petersburg, russia']
chong19_interspeech	['institute for infocomm research, singapore 138632']
jati19_interspeech	['university of southern california, los angeles, ca, usa']
snyder19b_interspeech	['center for language and speech processing', 'human language technology center of excellence', 'johns hopkins university, baltimore, md, usa']
huang19h_interspeech	
sun19d_interspeech	['institute for infocomm research, a*star, singapore']
liang19_interspeech	['lenovo research']
wang19f_interspeech	['center for language and speech processing, johns hopkins university, usa', 'human language technology center of excellence, johns hopkins university, usa']
cai19c_interspeech	['data science research center, duke kunshan university, kunshan, china', 'school of electronics and information technology, sun yat-sen university, guangzhou, china']
hauptman19_interspeech	['afeka tel-aviv college of engineering, aclp, israel', 'movement disorders unit, dept of neurology, tel-aviv sourasky medical center, israel', 'ono academic college, faculty of health professions, communication sciences and disorders', 'department, kiryat ono, israel', 'sackler school of medicine, tel-aviv university, tel-aviv, israel,', 'sagol school of neuroscience, tel aviv university, israel']
drioli19_interspeech	['department of mathematics, computer science and physics, university of udine, italy.', 'medical university of vienna, department of otorhinolaryngology, division of', 'phoniatrics-logopedics, vienna, austria.']
kadiri19_interspeech	['department of signal processing and acoustics, aalto university, finland']
cho19_interspeech	
schoentgen19_interspeech	['bio-, electro- and mechanical systems, faculty of applied sciences, universite libre de', 'bruxelles, brussels, belgium', 'medical university of vienna, division of phoniatrics-logopedics, department of', 'otorhinolaryngology, vienna, austria']
schaeffler19_interspeech	['clinical audiology, speech and language (casl) research centre, queen margaret university', 'edinburgh, scotland, uk', 'fitvoice cic, business innovation zone, university drive, musselburgh, scotland, uk']
moore19b_interspeech	['arizona state university, united states']
roessig19_interspeech	['ifl – phonetik, universitat zu k¨oln']
suni19_interspeech	['university of helsinki, finland', 'stockholm university, sweden']
murphy19_interspeech	['phonetics and speech laboratory, trinity college dublin']
albar19_interspeech	['umr 7710 laboratoire de linguistique formelle', 'universite de paris, labex efl, france']
okawa19_interspeech	['integrated graduate school of medicine engineering, and agricultural sciences,', 'university of yamanashi', 'idein inc.']
mulimani19_interspeech	['dept. of cse, national institute of technology karnataka, suarthkal, india', ' 025']
shen19b_interspeech	['department of electronic engineering, tsinghua university, beijing 100084, china']
ford19_interspeech	['computer science and artificial intelligence laboratory', 'massachusetts institute of technology', 'cambridge, ma, usa']
reddy19b_interspeech	
tarantino19_interspeech	['ecole polytechnique federale de lausanne, switzerland', 'artificial intelligence and machine learning group, swisscom', 'idiap research institute, martigny, switzerland']
nachmani19_interspeech	['facebook ai research', 'the school of computer science, tel aviv university']
lee19c_interspeech	['music & audio research group, seoul national university', 'center for super intelligence, seoul national university']
yi19_interspeech	['national engineering laboratory for speech and language information processing,', 'university of science and technology of china, hefei, p.r. china']
dahmani19_interspeech	['universite de lorraine, cnrs, inria, loria, f-54000 nancy, france']
ayllon19b_interspeech	['oben inc., ca, usa']
biasuttolervat19_interspeech	['universite de lorraine, cnrs, inria, loria, f-54000 nancy, france']
park19e_interspeech	
audhkhasi19_interspeech	['ibm research ai, ibm t j. watson research center, yorktown heights, ny 10598']
miao19_interspeech	['key laboratory of speech acoustics and content understanding, institute of acoustics, china', 'university of chinese academy of sciences, china', 'xinjiang laboratory of minority speech and language information processing, xinjiang technical', 'institute of physics and chemistry, chinese academy of sciences, china']
zhang19h_interspeech	['ibm research']
zhang19i_interspeech	
menne19_interspeech	['human language technology and pattern recognition, computer science department,', 'rwth aachen university', ' aachen, germany', 'apptek gmbh', ' aachen, germany']
novak19_interspeech	['university of illinois at chicago, united states of america']
shi19_interspeech	['university of illinois at urbana-champaign, usa', 'beijing language and culture university, china']
chen19h_interspeech	['the marcs institute, western sydney university, australia', 'haskins laboratories, new haven ct, usa']
tremblay19_interspeech	['university of kansas, usa', 'radboud university, nijmegen, the netherlands']
abujabal19_interspeech	['max planck institute for informatics', 'saarland informatics campus, germany', 'amazon alexa, aachen, germany']
bhati19_interspeech	['† center for language and speech processing, the johns hopkins university, usa', '‡department of electrical engineering, iit hyderabad, india']
yusuf19b_interspeech	['bogazici university']
yang19e_interspeech	['columbia university, usa']
wang19g_interspeech	['department of electrical and computer engineering, university of illinois, urbana champaign', 'beckman institute, university of illinois, urbana champaign']
boito19_interspeech	"[""laboratoire d'informatique de grenoble, univ. grenoble alpes (uga), france"", 'school of computer science and electronic engineering, university of essex, uk', 'institute of informatics, federal university of rio grande do sul, brazil']"
xue19b_interspeech	['jd ai research']
grondin19_interspeech	['computer science and artificial intelligence laboratory', 'massachusetts institute of technology', 'cambridge, ma 02139, usa']
zhang19j_interspeech	['moe key lab of artificial intelligence', 'speechlab, department of computer science and engineering', 'shanghai jiao tong university, shanghai, china']
masuyama19_interspeech	['department of intermedia art and science, waseda university, tokyo, japan', 'line corpolation, tokyo, japan']
li19m_interspeech	['national laboratory of pattern recognition, institute of automation, chinese academy of', 'sciences, china', 'school of artificial intelligence, university of chinese academy of sciences, china', 'tencent ai lab, bellevue, wa, usa', 'tencent ai lab, shenzhen, china', 'xueersi online school, china', 'kingsoft ai lab, china']
ochiai19_interspeech	['ntt communication science laboratories, ntt corporation, kyoto, japan']
germain19_interspeech	['ccrma, stanford university, stanford, ca, usa', 'department of computer science and engineering, hkust, kowloon, hong kong', 'intelligent systems lab, intel labs, santa clara, ca, usa']
wang19h_interspeech	['google inc., usa', 'idiap research institute, switzerland', 'epfl, switzerland']
liao19_interspeech	['research center for information technology innovation, academic sinica, taiwan', 'national institute of information and communications technology, japan']
mowlaee19_interspeech	['❸widex a/s, nymoellevej 6', ' lynge, denmark', '∗signal processing and speech communication lab, graz university of technology, austria', '❹school of engineering and computer science, victoria university of wellington, new zealand']
yao19_interspeech	['apple inc., united states of america']
hui19b_interspeech	['department of computer science and engineering, the ohio state university, usa']
shrivastava19_interspeech	['nsit-delhi, india', 'adobe, india', 'iiit-delhi, india', 'bloomberg, us', 'nus, singapore']
kandala19_interspeech	['samsung r&d institute india, bangalore']
koumparoulis19_interspeech	['electrical and computer engineering department, university of thessaly', ' volos, greece']
qu19_interspeech	['knowledge technology, department of informatics, university of hamburg,', 'vogt-koelln-str. 30', ', hamburg, germany']
sainath19_interspeech	['google, inc., usa']
lam19_interspeech	['tencent ai lab, shenzhen, china', 'tencent ai lab, bellevue wa, usa', 'department of systems engineering and engineering management,', 'the chinese university of hong kong, hong kong sar, china']
gowda19_interspeech	['speech processing lab, ai center, samsung research, korea']
han19b_interspeech	['jd ai research', 'east middlefield road', 'mountain view, ca 94043, usa']
hu19b_interspeech	['the chinese university of hong kong, hong kong sar, china']
lu19c_interspeech	['microsoft']
li19n_interspeech	['honda innovation lab, honda r&d co., ltd.', 'graduate school of informatics, kyoto university']
schmitt19_interspeech	['zd.b chair of embedded intelligence for health care and wellbeing,', 'university of augsburg, germany', 'glam – group on language, audio & music, imperial college london, u k.']
ouyang19_interspeech	['school of electrical engineering and telecommunications, unsw, sydney, australia']
ando19_interspeech	['ntt media intelligence laboratories, ntt corporation, japan']
gorrostieta19_interspeech	['cogito corporation']
bao19_interspeech	['institute for natural language processing (ims), university of stuttgart, stuttgart, germany']
bollepalli19_interspeech	['department of signal processing and acoustics, aalto university, finland']
seshadri19_interspeech	['department of signal processing and acoustics, aalto university, finland', 'unit of computing sciences, tampere university, finland']
zhao19f_interspeech	['department of computer science and engineering, texas a&m university, usa']
shankar19b_interspeech	['department of electrical and computer engineering, johns hopkins university']
lapidot19_interspeech	['afeka tel-aviv college of engineering, aclp, israel', 'avignon university, lia, france']
gao19b_interspeech	['department of computer science and engineering, new york university, usa', 'college of information and computer sciences, university of massachusetts amherst, usa', 'signify (formerly philips lighting) research, north america, usa']
stafylakis19_interspeech	['omilia - conversational intelligence, athens, greece', 'brno university of technology, faculty of information technology, it4i centre of excellence,', 'czechia']
nautsch19b_interspeech	['audio security and privacy, digital security department, eurecom, france', 'cryptography and privacy engineering, department of computer science, tu darmstadt, germany', 'omilia – conversational intelligence, greece']
liu19f_interspeech	['tsinghua national laboratory for information science and technology,', 'department of electronic engineering, tsinghua university, beijing 100084, china']
hajavi19_interspeech	
zhou19_interspeech	['school of electronic science and engineering, xiamen university, china', 'school of information science and engineering, xiamen university, china']
shon19b_interspeech	['mit computer science and artificial intelligence laboratory, cambridge, ma, usa']
avila19_interspeech	['inrs-emt, university of quebec, canada', 'computer research institut of montreal (crim), canada']
patil19_interspeech	['speech research lab, dhirubhai ambani institute of information and communication technology', '(da-iict), gandhinagar-382007, gujarat, india.', 'indian institute of information technology (iiit), vadodara, gujarat, india.']
mingote19_interspeech	['vivolab, aragon institute for engineering research (i3a), university of zaragoza, spain']
fan19_interspeech	['national key laboratory for novel software technology', 'collaborative innovation center of novel software technology and industrialization', 'department of computer science and technology, nanjing university, p r. china']
marras19_interspeech	['university of cagliari, cagliari, italy', 'new york university, new york, u.s.a.', 'agh university of science and technology, krakow, poland']
gunendradasan19_interspeech	['school of electrical engineering and telecommunications, unsw, australia', 'atp research laboratory, data61, csiro, australia', 'national university of singapore, singapore']
yun19_interspeech	['qualcomm ai research†, qualcomm korea yh']
seo19_interspeech	['dept. of computer science and engineering, sogang university, republic of korea']
you19c_interspeech	
wang19i_interspeech	['moe key lab of artificial intelligence', 'speechlab, department of computer science and engineering', 'shanghai jiao tong university, shanghai, china']
kanagasundaram19_interspeech	['department of electrical & electronic engineering, university of jaffna, sri lanka', 'speech and audio research lab, saivt, queensland university of technology, australia', 'leap lab, indian institute of science, india']
chen19i_interspeech	['center for language and speech processing', 'johns hopkins university, baltimore, md, usa']
wickramasinghe19_interspeech	['school of electrical engineering and telecommunications, unsw, australia', 'atp research laboratory, data61, csiro, australia']
bousquet19_interspeech	['university of avignon - lia, france']
shon19c_interspeech	['massachusetts institute of technology, cambridge, ma, usa', 'neosapience, inc., seoul, south korea']
yoshioka19_interspeech	['speech and dialog research group, microsoft, u.s.a.']
thomas19_interspeech	['ibm research ai, yorktown heights, usa']
farooq19_interspeech	['center for language engineering,', 'al-khawarizmi institute of computer science,', 'university of engineering and technology, lahore.']
tang19b_interspeech	['nuance communications, bellevue, washington, usa']
szaszak19_interspeech	['telepathy labs gmbh, zurich, switzerland', 'budapest university of technology and economics, budapest, hungary', 'nokia solutions and networks ltd, budapest, hungary']
pellegrini19_interspeech	['irit, universite paul sabatier, cnrs, toulouse, france', 'airbus, toulouse, france']
oneata19_interspeech	
wang19j_interspeech	['center for language and speech processing, the johns hopkins university, usa', 'human language technology center of excellence, the johns hopkins university, usa']
biswas19_interspeech	['department of electrical and electronic engineering, stellenbosch university, south africa']
helgadottir19_interspeech	['reykjavik university', 'language and voice lab']
gupta19d_interspeech	['centre de recherche informatique de montreal (crim)']
rutowski19_interspeech	['ellipsis health, inc.']
pietrowicz19_interspeech	['ibm thomas j watson research center', 'icahn school of medicine at mount sinai', 'bronx va mirecc']
jeancolas19_interspeech	['samovar, cnrs, télécom sudparis, institut polytechnique de paris, evry, france', 'sorbonne universite, upmc univ paris 06 umr s 1127; inserm u 1127 and cic 1422; cnrs', 'umr 7225, paris, france', 'département de neurologie, groupe hospitalier pitié-salpêtrière, ap-hp, paris, france', 'icm - institut du cerveau et de la moelle epiniere, paris, france', 'perform centre, electrical & computer engineering department concordia university,', 'montreal, canada']
janbakhshi19_interspeech	['idiap research institute, speech, and audio processing group, martigny, switzerland', 'ecole polytechnique federale de lausanne, lausanne, switzerland']
pasquale19_interspeech	['technological university dublin, ireland', 'university of the west of scotland, uk']
rueda19_interspeech	['department of electrical and computer engineering, ryerson university, canada', 'faculty of engineering, universidad de antioquia, colombia', 'pattern recognition lab, friedrich-alexander-university erlangen-nuremberg, germany']
onu19_interspeech	['mila - quebec artificial intelligence institute, mcgill university', 'ubenwa intelligence solutions inc', 'facebook ai research', 'google deepmind']
hong19_interspeech	['department of electrical engineering, national tsing hua university, taiwan', 'department of emergency medicine, chang gung memorial hospital, taiwan', 'department of emergency medicine, tao-yuan general hospital, taiwan', 'faculty of medicine, national yang-ming university, taiwan', 'most joint research center for ai technology and all vista healthcare, taiwan']
lopez19_interspeech	['institute of informatics, university of szeged, szeged, hungary', 'faculty of engineering, university of antioquia, medellin, colombia', 'pattern recognition lab, university of erlangen, erlangen, germany', 'mta-szte research group on artificial intelligence, szeged, hungary']
klumpp19_interspeech	['friedrich-alexander-universitat erlangen-nurnberg, erlangen, germany', 'universidad de antioquia, medellin, colombia']
chakravarthula19_interspeech	['dept. of electrical and computer engineering, university of southern california, usa', 'dept. of health outcomes and behavior, moffitt cancer center, usa']
qin19_interspeech	['department of electronic engineering, the chinese university of hong kong, hong kong', 'department of communication sciences and disorders, university of central florida, usa']
fu19_interspeech	['department of machine intelligence, speech and hearing research center, and key laboratory of', 'machine perception (ministry of education), peking university, beijing, china']
zayats19_interspeech	['electrical & computer engineering department, university of washington', 'linguistics department, university of washington']
parhammer19_interspeech	['icone – innsbruck cognitive neuroscience, department for hearing, speech, and voice', 'disorders, medical university of innsbruck, austria', 'department of subject-specific education, area of language education,', 'university of innsbruck, austria', 'department of psychology, university of innsbruck, austria', 'department of child and adolescent psychiatry and psychotherapy,', 'technical university of dresden, germany', 'language development department, max-planck-institute for psycholinguistics,', 'nijmegen, the netherlands', 'herder-institute, university of leipzig, germany', '*these authors contributed equally.']
hazan19_interspeech	['department of speech hearing and phonetic sciences, ucl, uk']
davis19_interspeech	['the marcs institute, western sydney university, australia']
ariasvergara19_interspeech	['faculty of engineering. universidad de antioquia udea, calle 70 no. 52-21, medellin, colombia', 'pattern recognition lab. friedrich-alexander university, erlangen-nurnberg, germany', 'department of otorhinolaryngology, head and neck surgery. ludwig-maximilians', 'university, munich, germany', 'logitech, laussane, switzerland']
hodoshima19_interspeech	['department of information media technology, tokai university, japan']
mamun19_interspeech	['crss: center for robust speech systems; cochlear implant processing laboratory (cilab)', 'department of electrical and computer engineering, university of texas at dallas, usa']
felker19_interspeech	['radboud university nijmegen, nl']
paulus19_interspeech	['speech, hearing and phonetic sciences, university college london, uk']
ward19b_interspeech	['acoustics research centre, university of salford, manchester, uk', 'bbc r&d, north lab, mediacityuk, salford, uk', 'bbc cardiff, wales, uk', 'american academy of dramatic arts, los angeles, usa', 'bbc r&d, south lab, london, uk']
chen19j_interspeech	['department of electrical and electronic engineering, southern university of science and', 'technology, shenzhen, china']
pirhosseinloo19_interspeech	['department of electrical engineering and computer science, university of kansas, usa', 'department of speech-language-hearing, university of kansas, usa']
liao19b_interspeech	['research center for information technology innovation, academia sinica, taiwan', 'institute of information science, academia sinica, taiwan', 'graduate institute of electrical engineering, national taiwan university, taiwan']
ge19_interspeech	['tianjin key laboratory of cognitive computing and application,', 'college of intelligence and computing, tianjin university, tianjin, china', 'japan advanced institute of science and technology, ishikawa, japan', 'didi chuxing, beijing, china']
pariente19_interspeech	['universite de lorraine, cnrs, inria, loria, f-54000 nancy, france']
lin19d_interspeech	['dept. of electrical and computer engineering, clemson university, clemson, sc', 'linkedin inc., mountain view, ca', 'nokia bell labs, nokia, murray hill, nj']
zezario19_interspeech	['research center for information technology innovation, academia sinica, taiwan', 'department of computer science and information engineering, national taiwan university,', 'taiwan', 'national institute of information and communications technology, japan', 'institute of information science, academia sinica, taiwan']
chuang19_interspeech	['department of electrical engineering, yuan ze university, taoyuan, taiwan', 'most joint research center for ai technology and all vista healthcare, taipei, taiwan', 'dept of electrical engineering, national chi nan university, taiwan', 'research center for information technology innovation, academia sinica, taipei, taiwan']
liu19g_interspeech	['inner mongolia key laboratory of mongolian information processing technology,', 'inner mongolia university, hohhot, china', 'beijing unisound information technology co. ltd., china']
shi19b_interspeech	['fujitsu research and development center', 'harbin institute of technology', 'shuangfeng first']
wang19k_interspeech	['speech and audio signal processing laboratory, faculty of information technology, beijing', 'university of technology, beijing, china']
llombart19b_interspeech	['vivolab, aragon institute for engineering research (i3a)', 'university of zaragoza, spain']
chen19k_interspeech	['amazon']
mantena19_interspeech	['apple inc., usa']
khare19_interspeech	['ibm research', 'university of copenhagen']
soomro19_interspeech	['school of computing, university of eastern finland, joensuu, finland']
ding19b_interspeech	['university of science and technology of china, hefei 230026, china', 'microsoft research asia, beijing 100080, china']
lopezespejo19_interspeech	['department of electronic systems, aalborg university, denmark', 'oticon a/s, denmark']
doulaty19_interspeech	['microsoft, germany', 'university of sheffield, uk']
li19o_interspeech	['key laboratory of speech acoustics and content understanding, institute of acoustics,', 'xinjiang laboratory of minority speech and language information processing, xinjiang technical', 'institute of physics and chemistry, chinese academy of sciences, china', 'university of chinese academy of sciences']
suzuki19b_interspeech	['faculty of information science and technology, osaka institute of technology, japan']
hsu19b_interspeech	['computer science and artificial intelligence laboratory', 'massachusetts institute of technology', 'cambridge, ma, usa']
luo19c_interspeech	['school of computer science and technology, harbin institute of technology, harbin, prc']
tammewar19_interspeech	['signals and interactive systems lab, university of trento', 'clinical psychology and psychotherapy, university of ulm']
chakraborty19_interspeech	['tcs research and innovation, thane west, mumbai, india']
li19p_interspeech	['japan advanced institute of science and technology']
rajan19_interspeech	['dept. of electronics and communication engineering', 'college of engineering, trivandrum', 'thiruvnanthapuram,kerala, india']
sridhar19_interspeech	['multimodal signal processing (msp) lab, department of electrical and computer engineering', 'the university of texas at dallas, richardson tx 75080, usa']
jin19_interspeech	['department of computer science, new york institute of technology, new york', ', usa']
gideon19_interspeech	['department of computer science and engineering, university of michigan, usa', 'department of psychiatry and human behavior, brown university, usa', 'psychosocial research program, butler hospital, usa', 'department of psychiatry, university of michigan, usa']
nazareth19_interspeech	['psychology, health and technology, university of twente', 'human media interaction, university of twente', 'centre for language studies, radboud university nijmegen']
zhao19g_interspeech	['national institute of informatics, japan', 'ntt media intelligence laboratories, japan']
gharsellaoui19_interspeech	['universite de moncton', ' boul. j - d gauthier, shippagan (nb), e8s 1p6, canada']
sahu19_interspeech	['speech communication laboratory, university of maryland, college park, md, usa']
spinu19_interspeech	['city university of new york', 'university of toronto']
ratko19_interspeech	['centre for language sciences, department of linguistics, macquarie university']
deme19_interspeech	['eotvos lorand university, hungary', 'mta-elte „lendulet” lingual articulation research group, hungary', 'research institute for linguistics has, hungary', 'budapest university of technology and economics, hungary']
king19_interspeech	['clillac-arp, ea 3967, universite de paris, france', 'laboratoire de phonetique et phonologie (umr7018, cnrs - sorbonne nouvelle), france']
marko19_interspeech	['eotvos lorand university, budapest, hungary', 'mta-elte “lendulet” lingual articulation research group, budapest, hungary', 'budapest university of technology and economics, budapest, hungary', 'research institute for linguistics has, budapest, hungary']
cunha19_interspeech	['ips, lmu munich, germany', 'deti/ieeta, universidade de aveiro, portugal', 'health school/ieeta, universidade de aveiro, portugal', 'max-planck-institut fur biophysikalische chemie, germany']
xiong19_interspeech	['school of electrical, computer and energy engineering', 'arizona state university, tempe, arizona, usa']
huang19i_interspeech	['amazon, usa']
su19_interspeech	['department of systems engineering and engineering management,', 'the chinese university of hong kong, china']
ashihara19_interspeech	['ntt media intelligence laboratories, ntt corporation, japan']
bergler19_interspeech	['friedrich-alexander-university erlangen-nuremberg, department of computer science – pattern', 'recognition lab, martensstr. 3', ' erlangen, germany', 'leibniz institute for zoo and wildlife research (izw) in the forschungsverbund berlin e.v.,', 'alfred-kowalke-strasse 17', ' berlin, germany', 'anthro-media, nansenstr. 19', ' berlin, germany']
sacchi19_interspeech	['ecole polytechnique federale de lausanne, switzerland', 'idiap research institute, switzerland', 'logitech europe s.a., switzerland']
gao19c_interspeech	['school of computer and cyberspace security, communication university of china', 'beijing, china']
choi19_interspeech	['hyperconnect, seoul, south korea']
huang19j_interspeech	['alibaba inc., p r. china']
yang19f_interspeech	['department of electronic engineering, tsinghua university, beijing', ', china']
carmi19_interspeech	['department of mathematics and computer sciences, the open university of israel']
hwang19_interspeech	['search solutions inc., seongnam, korea', 'department of electrical and electronic engineering, yonsei university, seoul, korea']
zhen19_interspeech	['indiana university, school of informatics, computing, and engineering, bloomington, in', 'indiana university, cognitive science program, bloomington, in', 'electronics and telecommunications research institute, daejeon, south korea']
backstrom19_interspeech	['aalto university, department of signal processing and acoustics, finland']
valin19_interspeech	['amazon, palo alto, ca, usa', 'google llc, san francisco, ca, usa']
fuchs19_interspeech	['fraunhofer institut fur integrierte schaltungen (iis), erlangen, germany', 'department of signal processing and acoustics, aalto university, espoo, finland']
li19q_interspeech	['amazon ai']
gupta19e_interspeech	['department of electronics and electrical engg', 'indian institute of technology guwahati', 'guwahati, assam, india']
mittag19_interspeech	['quality and usability lab, technische universitat berlin, berlin, germany', 'deutsches forschungszentrum fur kunstliche intelligenz (dfki), berlin, germany']
chai19b_interspeech	['school of data science, university of science and technology of china, hefei, anhui, p r. china', 'university of science and technology of china, hefei, anhui, p r. china', 'georgia institute of technology, atlanta, ga. usa']
moller19_interspeech	['quality and usability lab, technische universitat berlin, germany', 'deutsches forschungszentrum fur kunstliche intelligenz (dfki), berlin, germany', 'orange, lannion, france', 'nippon telegraph and telephone corporation, japan']
sadhu19_interspeech	
li19r_interspeech	['moe key lab of artificial intelligence', 'speechlab, department of computer science and engineering', 'shanghai jiao tong university, shanghai, china']
agrawal19_interspeech	['learning and extraction of acoustic patterns (leap) lab, dept. of electrical engg.,', 'indian institute of science, bengaluru-560012, india']
ramsay19_interspeech	['mit media laboratory, usa', 'google ai, switzerland']
riviello19_interspeech	['department of electrical engineering']
schneider19_interspeech	['facebook ai research']
cho19b_interspeech	['linguistic data consortium, university of pennsylvania, philadelphia, pa, usa', 'cheongju university, cheongju, south korea']
menon19_interspeech	['department of electrical and electronic engineering, stellenbosch university, south africa', 'un global pulse, kampala, uganda', 'department of computer science, makerere university, uganda', 'school of informatics, university of edinburgh, uk']
loweimi19_interspeech	['centre for speech technology research (cstr), school of informatics, university of edinburgh']
verwimp19_interspeech	['esat – psi, ku leuven, belgium', 'apple inc., usa']
chen19l_interspeech	['∗', ',2 , mahaveer jain2, yongqiang wang2, michael l seltzer2, christian fuegen2', 'speechlab, department of computer science and engineering, shanghai jiao tong university', 'facebook ai, one hacker way, menlo park, ca 94025, usa']
liu19h_interspeech	['institute of acoustics, chinese academy of sciences, china', 'university of chinese academy of sciences, china', 'national computer network emergency response technical team/coordination center of china', 'xinjiang technical institute of physics and chemistry, chinese academy of sciences, china']
pusateri19_interspeech	['apple inc., usa']
khassanov19b_interspeech	['school of computer science and engineering, nanyang technological university, singapore', 'temasek laboratories, nanyang technological university, singapore']
yu19b_interspeech	['the chinese university of hong kong, hong kong sar, china']
agenbag19_interspeech	['department of electrical and electronic engineering', 'stellenbosch university, south africa']
coucheirolimeres19_interspeech	['speech technology group, universidad politecnica de madrid, spain']
gao19d_interspeech	['china mobile research']
ritchie19_interspeech	
sharma19e_interspeech	
sennema19_interspeech	['university of vienna, austria', 'university of amsterdam, the netherlands']
lewis19_interspeech	['department of linguistics, queen mary university of london']
jenne19_interspeech	['institute for natural language processing (ims)', 'universitat stuttgart, germany']
foltz19_interspeech	['department of english studies, university of graz, austria', 'school of languages, literatures and linguistics, bangor university, uk']
bradlow19b_interspeech	['department of linguistics, northwestern university, evanston, il, usa']
graham19_interspeech	['phonetics laboratory, university of cambridge']
xu19c_interspeech	['didi chuxing, beijing, china', 'didi research america, mountain view, ca, usa', 'peking university, beijing, china']
peperkamp19b_interspeech	['laboratoire de sciences cognitives et psycholinguistique, ens - psl university – ehess –', 'cnrs, paris, france']
seidl19_interspeech	"['slhs, purdue university, west lafayette, in, usa', 'university of california, los angeles, ca, usa', ""laboratoire de sciences cognitives et de psycholinguistique, departement d'etudes cognitives,"", 'ens, ehess, cnrs, psl university, paris, france']"
ludusan19b_interspeech	['faculty of linguistics and literary studies, bielefeld university, germany', 'laboratory for language development, riken center for brain science, japan']
marklund19_interspeech	['stockholm babylab, phonetics laboratory, department of linguistics, stockholm university']
rasanen19_interspeech	['faculty of information technology and communication sciences, tampere university, finland', 'department of signal processing and acoustics, aalto university, finland']
du19b_interspeech	['beijing advanced innovation center for language resources', 'beijing language and culture university, beijing, china']
li19s_interspeech	['amazon ai']
cerutti19_interspeech	['ict-irst, fondazione bruno kessler, trento, italy', 'school of information science, manipal academy of higher education, manipal, karnataka, india']
lu19d_interspeech	['national institute of information and communications technology, japan', 'research center for information technology innovation, academic sinica, taiwan']
bai19b_interspeech	['national engineering laboratory of speech and language information processing,', 'university of science and technologoy of china', 'georgia institute of technology']
he19b_interspeech	['department of electronic engineering, tsinghua university, beijing 100084, china']
xia19_interspeech	['center for robust speech systems, university of texas at dallas, tx 75080', 'microsoft corporation, one microsoft way, redmond, wa 98052']
pham19b_interspeech	['school of computing, the university of kent, medway, kent, united kingdom']
shi19c_interspeech	['toyota technological institute at chicago', 'amazon alexa research']
chen19m_interspeech	['hikvision research institute, hangzhou, china']
zhang19k_interspeech	['ibm research - china, beijing 100193']
lu19e_interspeech	['institute for infocomm research, a*star, singapore']
mizgajski19_interspeech	['augustyniak12, mikolaj morzy13, yishay carmiel1, jeff hodson1, lukasz wojciak1,', 'adam wrobel1, bartosz borowik1, adam artajew1, marcin baran1,', 'zyla-hoppe1', 'avaya, santa clara, california, united states', 'wroclaw university of science and technology, wroclaw, poland', 'poznan university of technology, poznan, poland', 'agh university of science and technology, krakow, poland']
an19b_interspeech	['game dev. ai team, narc, netmarble, south korea', 'game contents ai team, narc, netmarble, south korea', 'magellan division, narc, netmarble, south korea']
chylek19_interspeech	['new technologies for the information society (ntis)', 'faculty of applied sciences, university of west bohemia, czech republic']
jelil19_interspeech	
wu19h_interspeech	['department of electrical and computer engineering, national university of singapore, singapore', 'institute for infocomm research, a*star, singapore']
hu19c_interspeech	['the chinese university of hong kong, hong kong sar, china', 'university of cambridge, cambridge, uk']
schiel19_interspeech	['institute of phonetics and speech processing, lmu munich, germany']
voe19_interspeech	['phonetics and phonology work group, bielefeld university, germany', 'center of excellence cognitive interaction technology (citec), bielefeld university, germany']
dominguez19_interspeech	['university pompeu fabra, barcelona, spain', 'universite de nantes, cnrs, laboratoire de linguistique de nantes, umr-6310, france']
levy19_interspeech	['gong.io', 'faculty of industrial engineering and management, technion, israel']
lo19b_interspeech	['department of linguistics', 'university of british columbia, vancouver, bc, canada']
li19t_interspeech	['language technologies institute, carnegie mellon university; pittsburgh, pa; u.s.a.']
gruber19_interspeech	['new technologies for the information society, university of west bohemia, czech republic', 'dept. of cybernetics, faculty of applied sciences, university of west bohemia, czech republic']
perrotin19_interspeech	['univ. grenoble alpes, cnrs, grenoble inp, gipsa-lab, france', 'school of computing, university of kent, medway, uk']
szekely19_interspeech	['division of speech, music and hearing, kth royal institute of technology, stockholm, sweden']
kessler19_interspeech	['rochester institute of technology']
bernardo19_interspeech	['unbabel, lisboa, portugal', 'instituto superior tecnico, universidade de lisboa, lisboa, portugal', 'spoken language systems laboratory, inesc-id lisboa, lisboa, portugal']
rabiee19_interspeech	['kaist institute for artificial intelligence', 'korea advanced institute of technology, daejeon, korea']
nautsch19c_interspeech	
srivastava19_interspeech	['inria, france', 'universite de lille, france', 'universite de lorraine, cnrs, inria, loria, f-54000 nancy, france']
nelus19_interspeech	['ruhr-universitat bochum, institute of communication acoustics, bochum, germany']
nelus19b_interspeech	['ruhr-universitat bochum, institute of communication acoustics, bochum, germany', 'universitat paderborn, fachgebiet nachrichtentechnik, paderborn, germany']
thaine19_interspeech	['department of computer science, university of toronto, canada']
zarazaga19_interspeech	['department of signal processing and acoustics, aalto university, espoo, finland', 'international institute of information technology (iiit), hyderabad, india']
soto19_interspeech	['columbia university, computer science department', 'new york, ny']
lee19d_interspeech	['national university of singapore, singapore', 'university of bremen, germany']
rallabandi19_interspeech	['language technologies institute, carnegie mellon university, pittsburgh, pa, usa']
wang19l_interspeech	['dept. of electrical and computer engineering, national university of singapore, singapore']
biswas19b_interspeech	['department of electrical and electronic engineering, stellenbosch university, south africa', 'department of electrical and computer engineering, national university of singapore, singapore']
ylmaz19b_interspeech	['dept. of electrical and computer engineering, national university of singapore, singapore', 'icis, radboud university, nijmegen, netherlands']
seki19_interspeech	['mitsubishi electric research laboratories (merl), usa', 'toyohashi university of technology, japan', 'johns hopkins university, usa']
mohapatra19_interspeech	['electrical and computer engineering department, university of british columbia, canada']
birkholz19_interspeech	['institute of acoustics and speech communication, tu dresden, germany', 'department of speech science and phonetics, martin luther university of halle-wittenberg']
gao19e_interspeech	['institute of acoustics and speech communication, tu dresden, germany']
shahrebabaki19_interspeech	['department of electronic systems, ntnu', 'department of telematics, kore university of enna']
tuske19_interspeech	['ibm research ai, yorktown heights, usa']
hannun19_interspeech	['facebook ai research, usa']
baskar19_interspeech	['φbrno university of technology, czech republic', 'πibm t j. watson research center, usa', '†johns hopkins university, usa', 'υmerl, usa']
bai19c_interspeech	['nlpr, institute of automation, chinese academy of sciences, china', 'school of artificial intelligence, university of chinese academy of sciences, china', 'cas center for excellence in brain science and intelligence technology']
irie19_interspeech	['human language technology and pattern recognition group, computer science department', 'rwth aachen university, d-52056 aachen, germany', 'google, mountain view, ca 94043, usa']
weninger19b_interspeech	
runarsdottir19_interspeech	['language and voice lab, reykjavik university, menntavegur 1', ' reykjavik, iceland']
fukunaga19_interspeech	['sony corporation, japan']
jorge19_interspeech	['departament de sistemes informatics i computacio, universitat politecnica de valencia, spain']
seki19b_interspeech	['toyohashi university of technology, japan', 'mitsubishi electric research laboratories (merl), usa', 'johns hopkins university, usa']
serrino19_interspeech	['mit csail', 'google']
novitasari19_interspeech	['graduate school of information science, nara institute of science and technology, japan', 'riken, center for advanced intelligence project aip, japan']
lian19b_interspeech	['national laboratory of pattern recognition, casia, beijing, china', 'cas center for excellence in brain science and intelligence technology, beijing, china', 'school of artificial intelligence, university of chinese academy of sciences, beijing, china']
phan19_interspeech	[', oliver y chen2, lam pham1, philipp koch3, maarten de vos2,', 'ian mcloughlin1, alfred mertins3', 'school of computing, university of kent, uk', 'department of engineering science, university of oxford, uk', 'institute for signal processing, university of lubeck, germany']
shi19d_interspeech	['school of computing science and technology,', 'harbin institute of technology, harbin, china']
zhang19l_interspeech	['department of electronic engineering, tsinghua university, china', 'institute of forensic science, ministry of public security, china', 'key laboratory of intelligent speech technology, ministry of public security, china']
song19b_interspeech	['school of computer science and technology, harbin institute of technology, china', 'school of mathematical science, harbin normal university, china']
qi19_interspeech	['school of information management for law, china university of political science and law, china', 'college of computer science and software engineering, shenzhen university, china']
liu19i_interspeech	['school of chinese language and culture, nanjing normal university, china', 'nanjing normal university and the george washington university joint laboratory of speech,', 'hearing and rehabilitation sciences']
morovelazquez19_interspeech	['center for language and speech processing, the johns hopkins university, baltimore, md, usa', 'beckman institute and ece department, university of illinois at urbana-champaign, il, usa', 'multimedia computing group, delft university of technology, the netherlands', 'department of linguistics, university of illinois at urbana-champaign, il, usa']
wang19m_interspeech	"['cas key laboratory of human-machine intelligence-synergy systems, shenzhen institutes of', 'advanced technology, chinese academy of sciences, shenzhen, china', ""department of neurology, shenzhen luohu people's hospital, shenzhen, china"", 'speech science laboratory, university of hong kong, hong kong, china']"
wang19n_interspeech	['department of electronic engineering, the chinese university of hong kong, hong kong']
korzekwa19_interspeech	['amazon tts-research', 'gdansk university of technology, faculty of eti, poland']
noufi19_interspeech	
ogawa19_interspeech	['ntt communication science laboratories, ntt corporation, kyoto, japan']
irie19b_interspeech	['human language technology and pattern recognition group, computer science department', 'rwth aachen university', ' aachen, germany', 'apptek gmbh', ' aachen, germany']
raju19_interspeech	['amazon alexa']
likhomanenko19_interspeech	['facebook ai research, menlo park & new york, usa']
latif19_interspeech	['university of southern queensland, australia', 'distributed sensing systems group, data61, csiro australia', 'university of new south wales, australia']
sarma19_interspeech	
cao19_interspeech	['department of computer science and technology, university of science and technology beijing,', 'beijing, china']
oates19_interspeech	['audeering gmbh, gilching, germany', 'zd.b chair of embedded intelligence for health care and wellbeing, university of augsburg,', 'germany', 'glam – group on language, audio & music, imperial college london, uk']
gosztolya19c_interspeech	['mta-szte research group on artificial intelligence, szeged, hungary']
williams19c_interspeech	['the centre for speech technology research, university of edinburgh, united kingdom']
hsu19c_interspeech	['department of chinese and bilingual studies, hong kong polytechnic university, hong kong', 'department of speech, hearing and phonetic sciences, university college london, uk']
hu19d_interspeech	['institute of linguistics, chinese academy of social sciences', 'department of linguistics, graduate school, university of chinese academy of social sciences', '\x02', '\x02']
zhang19m_interspeech	['department of linguistics, graduate school, university of chinese academy of social sciences', 'institute of linguistics, chinese academy of social sciences']
albuquerque19_interspeech	['ieeta, university of aveiro, portugal', 'cintesis.ua, university of aveiro, portugal', 'school of health science (essua), university of aveiro, portugal', 'dep. electronics, telecommunications and informatics (deti), university of aveiro, portugal', 'cidma/ department of mathematics (dmat), university of aveiro, portugal']
lalhminghlui19_interspeech	['department of humanities and social sciences', 'center for linguistic science and technology', 'indian institute of technology guwahati, assam, india']
rodriguez19_interspeech	['universite sorbonne nouvelle – paris, france']
ibrahim19_interspeech	['urpp language and space, university of zurich, switzerland', 'department of speech music and hearing, kth royal institute of technology, sweden', 'department of comparative linguistics, university of zurich, switzerland', 'department of computational linguistics, university of zurich, switzerland']
wagner19_interspeech	['phonetics and phonology workgroup, faculty of linguistics and literary studies', 'bielefeld university, germany']
betz19_interspeech	['faculty of linguistics and literary studies, bielefeld university, bielefeld, germany', 'division of speech, music and hearing, kth royal institute of technology, stockholm, sweden']
si19_interspeech	['tianjin key laboratory of cognitive computing and application, college of intelligence and', 'computing, tianjin university, tianjin, china', 'japan advanced institute of science and technology, ishikawa, japan', 'institude of linguistics, chinese academy of social science, beijing, china']
metcalf19_interspeech	['apple inc.', ' apple parkway, cupertino, ca', ', usa']
raveh19_interspeech	['language science and technology, saarland university, germany', 'mobile dialog systems, institute for information technology and communications,', 'otto-von-guericke university, magdeburg, germany', 'audeering gmbh, gilching, germany']
wang19o_interspeech	"[""school of computer science, northwestern polytechnical university, xi'an, china"", 'crss: center for robust speech systems, ut-dallas, tx, usa']"
monteiro19_interspeech	['institut national de la recherche scientifique (inrs-emt), quebec, canada', 'centre de recherche informatique de montreal (crim), quebec, canada']
zhang19n_interspeech	['center for speech and language technologies, tsinghua university, china', 'beijing university of posts and telecommunications, china']
mingote19b_interspeech	['vivolab, aragon institute for engineering research (i3a), university of zaragoza, spain', 'speech technology and research laboratory, sri international, california, usa']
jung19c_interspeech	['school of electrical engineering, kaist, daejeon, south korea', 'artificial intelligence lab, lg electronics, seoul, south korea']
heo19b_interspeech	['school of computer science, university of seoul, south korea']
jiang19_interspeech	['national engineering laboratory of speech and language information processing,', 'university of science and technology of china, hefei, china.', 'school of computing, university of kent, medway, uk.']
qin19b_interspeech	['data science research center, duke kunshan university, kunshan, china', 'school of electronics and information technology, sun yat-sen university, guangzhou, china']
ren19_interspeech	['shanghai institute for advanced communication and data science, shanghai university, shanghai,', 'china']
kaminishi19_interspeech	['department of computer science, tokyo metropolitan university, japan']
khan19_interspeech	['talp research center, department of signal theory and communications,', 'universitat politecnica de catalunya barcelona, spain']
zheng19b_interspeech	['machine intelligence technology, alibaba group, china']
taherian19_interspeech	['department of computer science and engineering, the ohio state university, usa', 'center for cognitive and brain sciences, the ohio state university, usa']
yang19g_interspeech	['department of electronics and computer engineering', 'hanyang university, seoul, republic of korea']
miao19b_interspeech	['school of computing, the university of kent, medway, uk', 'key laboratory of speech acoustics and content understanding, institute of acoustics, chinese', 'academy of sciences', 'university of chinese academy of sciences', 'xinjiang key laboratory of minority speech and language information processing,', 'xinjiang technical institute of physics and chemistry, chinese academy of sciences']
chen19n_interspeech	['university of michigan, ann arbor, mi 48109, usa']
ma19b_interspeech	['imperial college london', 'samsung ai center, cambridge']
ooster19_interspeech	['medizinische physik, carl von ossietzky universitat, oldenburg, germany', 'h¨ortech ggmbh, oldenburg, germany', 'institute of hearing technology and audiology, jade university of applied sciences, oldenburg,', 'germany', 'cluster of excellence hearing4all, germany']
eshky19_interspeech	['cstr, school of informatics, university of edinburgh, uk']
pan19_interspeech	['dept. of computer science, university of sheffield, uk', 'academic neurology unit, university of sheffield, uk', 'royal hallamshire hospital, uk', 'sheffield institute for translational neuroscience, university of sheffield, uk']
nallanthighal19_interspeech	['philips research, eindhoven, the netherlands', 'centre for language studies (cls), radboud university nijmegen']
biadsy19_interspeech	['google']
liu19j_interspeech	['the chinese university of hong kong, hong kong sar, china', 'university of cambridge, cambridge, uk', 'shenzhen institutes of advanced technology, chinese academy of sciences, shenzhen, china']
vougioukas19_interspeech	['imperial college london', 'samsung ai center, cambridge', 'figure 1: the speech synthesizer accepts a sequence of frames', 'and produces the corresponding audio sequence.']
liu19k_interspeech	['the chinese university of hong kong, hong kong sar, china']
shillingford19_interspeech	['deepmind', 'google']
razavi19_interspeech	['university of rochester']
bechet19_interspeech	['aix marseille univ, universite de toulon, cnrs, lis, marseille, france', 'insa rennes, irisa, rennes,france']
liu19l_interspeech	['atr hiroshi ishiguro labs, japan', 'graduate school of engineering science, osaka university']
coman19_interspeech	['signals and interactive systems lab, department of information engineering and computer', 'science, university of trento, italy', 'augmented human communication laboratory, graduate school of information science, nara', 'institute of science and technology, japan']
su19b_interspeech	
heldner19_interspeech	['department of linguistics, stockholm university, sweden', 'constantine the philosopher university in nitra, slovakia', 'institute of informatics, slovak academy of sciences, bratislava, slovakia', 'departamento de computacion, fceyn, universidad de buenos aires (uba), argentina', 'instituto de investigacion en ciencias de la computacion (icc), conicet-uba, argentina']
hara19_interspeech	['school of informatics, kyoto university, kyoto, japan']
lala19_interspeech	['kyoto university, graduate school of informatics, kyoto, japan']
horiguchi19_interspeech	['hitachi, ltd.']
su19c_interspeech	['department of computer science and information engineering,', 'national cheng kung university, tainan, taiwan']
tran19_interspeech	['electrical & computer engineering, university of washington', 'laix inc.']
pasad19_interspeech	['toyota technological institute at chicago, usa', 'dept. e&e engineering, stellenbosch university, south africa']
wang19p_interspeech	['educational testing service', 'new montgomery st. #1450, san francisco, ca 94105, usa', 'rosedale rd., princeton, nj 08541, usa']
piunova19_interspeech	['human language technology and pattern recognition, computer science department,', 'rwth aachen university', ' aachen, germany']
segal19_interspeech	['bar-ilan university, ramat gan, israel']
oktem19_interspeech	['col·lectivat sccl, barcelona, spain', 'universitat pompeu fabra, barcelona, spain', 'universitat politecnica de catalunya, barcelona, spain']
tannander19_interspeech	['speech, music and hearing, kth, sweden', 'swedish agency for accessible media, sweden']
chen19o_interspeech	['national engineering laboratory for speech and language information processing university of', 'science and technology of china, hefei, china']
bach19_interspeech	['machine intelligence technology lab, alibaba group']
singh19b_interspeech	['∗department of signal processing and acoustics, aalto university, espoo, finland', '†department of digital humanities, helsinki university, helsinki, finland', '‡inscripta, helsinki, finland']
maekaku19_interspeech	['yahoo japan corporation, japan']
lee19e_interspeech	['department of electrical and computer engineering', 'university of california, san diego']
fazel19_interspeech	['samsung semiconductor inc., usa']
zhang19o_interspeech	['department of computer science and engineering, the ohio state university, usa', 'center for cognitive and brain sciences, the ohio state university, usa']
srensen19_interspeech	['audio analysis lab, create, aalborg university, denmark', 'gn hearing a/s, lautrupbjerg 7, dk-2750, ballerup, denmark']
mamun19b_interspeech	['cochlear implant processing laboratory, center for robust speech systems (crss-cilab),', 'department of electrical & computer engineering, the university of texas at dallas']
srensen19b_interspeech	['audio analysis lab, create, aalborg university, denmark', 'gn hearing a/s, lautrupbjerg 7, dk-2750, ballerup, denmark']
arai19_interspeech	['ntt communication science laboratories, japan', 'graduate school of systems engineering, wakayama university, japan']
bu19_interspeech	['dept. of electrical engineering and computer science, university of missouri-columbia, usa', 'mobvoi ai lab, redmond wa, usa']
lee19f_interspeech	['department of electrical and computer engineering,', 'seoul national university, seoul, south korea']
gu19b_interspeech	['peking university shenzhen graduate school, shenzhen, china', 'tencent ai lab, shenzhen, china', 'tencent ai lab, bellevue wa, usa']
afouras19_interspeech	['visual geometry group, department of engineering science, university of oxford', 'naver corporation']
fujita19_interspeech	['hitachi, ltd. research & development group, japan', 'center for language and speech processing, johns hopkins university, usa']
india19_interspeech	['universitat politecnica de catalunya, barcelona, spain']
vinals19b_interspeech	['vivolab, aragon institute for engineering research (i3a)', 'university of zaragoza, spain']
tu19_interspeech	['department of electronic and information engineering, the hong kong polytechnic university,', 'hong kong sar', 'department of electrical and computer engineering, national chiao tung university, taiwan']
liu19m_interspeech	['department of electrical and computer engineering,', 'national university of singapore, singapore']
nandwana19c_interspeech	['speech technology and research laboratory, sri international, menlo park, california, usa', 'instituto de investigacon en ciencias de la computacion, uba-conicet, argentina']
novotny19_interspeech	
salvati19_interspeech	['department of mathematics, computer science and physics, university of udine']
naini19_interspeech	['electrical engineering, indian institute of science, bangalore 560012, india']
zhu19b_interspeech	['department of computer science & engineering', 'the hong kong university of science & technology', 'department of computer science and engineering', 'south university of science and technology, shenzhen, china']
ferrer19_interspeech	['instituto de investigacion en ciencias de la computacion (icc), conicet-uba, argentina', 'speech technology and research lab (starlab), sri international, usa']
lee19g_interspeech	['nec corporation, japan', 'tokyo institute of technology, japan']
zheng19c_interspeech	['machine intelligence technology, alibaba group']
cai19d_interspeech	['data science research center, duke kunshan university, kunshan, china', 'school of electronics and information technology, sun yat-sen university, guangzhou, china']
cai19e_interspeech	['data science research center, duke kunshan university, kunshan, china', 'school of electronics and information technology, sun yat-sen university, guangzhou, china']
wiesner19_interspeech	['†center for language and speech processing, the johns hopkins university, usa', '‡human language technology center of excellence, the johns hopkins university, usa']
kim19b_interspeech	['electrical & computer engineering', 'language technologies institute, school of computer science', 'carnegie mellon university', 'pittsburgh, pa 15213; u.s.a.']
chorowski19_interspeech	['university of wroclaw, poland']
fan19b_interspeech	['beijing university of posts and telecommunications, beijing, p.r.china', 'department of computer science and technology, tsinghua university, beijing, p.r.china', 'voice interaction technology center, sogou inc., beijing, r.r.china']
tian19b_interspeech	['national laboratory of pattern recognition, institute of automation,', 'chinese academy of sciences, beijing, china', 'school of artificial intelligence, university of chinese academy of sciences, beijing, china', 'cas center for excellence in brain science and intelligence technology, beijing, china']
li19u_interspeech	['national institute of information and communications technology, kyoto, japan', 'kyoto university, kyoto, japan']
bang19_interspeech	['chungbuk national university, south korea', 'electronics and telecommunications research institute, south korea']
moriya19_interspeech	['ntt media intelligence laboratories, ntt corporation, japan', 'graduate school of engineering, the university of tokyo, japan']
parcollet19b_interspeech	['avignon universite, lia, france', 'orkis, aix-en-provence, france', 'mcgill university, montreal, qc, canada']
yi19b_interspeech	['institute of automation, chinese academy of sciences, china', 'university of chinese academy of sciences, china']
denisov19_interspeech	['institute for natural language processing (ims), university of stuttgart']
hayashi19_interspeech	
szekely19b_interspeech	['division of speech, music and hearing, kth royal institute of technology, stockholm, sweden']
klimkov19_interspeech	['amazon research, cambridge']
hussain19_interspeech	['koc university, turkey']
koriyama19_interspeech	['tokyo institute of technology, japan']
nikulasdottir19_interspeech	['reykjavik university, iceland']
guo19e_interspeech	"[""*school of computer science, northwestern polytechnical university, xi'an, china"", '†microsoft china']"
ni19_interspeech	['advanced speech technology laboratory, astrec,', 'national institute of information and communications technology, japan']
aubin19_interspeech	['the centre for speech technology research, university of edinburgh', 'department of information engineering and computer science, university of trento']
tits19_interspeech	['numediart institute, university of mons', 'acapela group']
yang19h_interspeech	['cloud and smart industries group, tencent technology co., ltd. china']
pan19b_interspeech	['databaker (beijing) technology co., ltd, beijing, china']
gokcen19_interspeech	['university of washington, seattle, wa, usa', 'google, new york, ny, usa,']
li19v_interspeech	['department of computer science and technology, tsinghua university', 'ai lab, tal education group', 'the chinese university of hong kong']
shankar19c_interspeech	['department of electrical & computer engineering, johns hopkins university, baltimore md, usa', 'department of applied mathematics & statistics, johns hopkins university, baltimore md, usa']
connaghan19_interspeech	['speech and feeding disorders lab, mgh institute of health professions, usa', 'harvard medical school, school of medicine, usa', 'neurological clinical research institute, department of neurology, massachusetts general', 'hospital, usa', 'department of physical medicine and rehabilitation, spaulding rehabilitation hospital, usa', 'massachusetts general hospital department of biostatistics, usa', 't.h. chan harvard school of public health, usa']
rowe19_interspeech	['massachusetts general hospital institute of health professions']
mayle19_interspeech	['school of electrical engineering and computer science, ohio university, athens, oh, usa', 'department of rehabilitation, first affiliated hospital of jinan university, guangzhou, china', 'school of rehabilitation and communication sciences, ohio university, athens, oh, usa']
sudro19_interspeech	['indian institute of technology guwahati, guwahati, india', 'indian institute of technology dharwad, dharwad, india']
eshghi19_interspeech	['mgh institute of health professions, usa', 'university of kansas, usa', 'vanderbilt university, usa', 'university of toronto, canada']
wang19q_interspeech	"['cas key laboratory of human-machine intelligence-synergy systems, shenzhen institutes of', 'advanced technology, chinese academy of sciences, shenzhen, china', ""department of neurology, shenzhen luohu people's hospital, shenzhen, china"", ""department of neurology, shenzhen people's hospital, shenzhen, china""]"
chen19p_interspeech	['shanghai international studies university, china', 'shenzhen university, china', 'shanghai sunshine rehabilitation center, china']
hermes19_interspeech	['laboratoire de phonetique et phonologie, umr 7018, cnrs/sorbonne-nouvelle, france', 'ifl – phonetics, university of cologne, germany', 'department of neurology, university hospital cologne, germany']
kalita19_interspeech	['indian institute of technology guwahati, guwahati, india', 'indian institute of technology dharwad, dharwad, india']
serrano19_interspeech	['university of the basque country (upv/ehu)']
dubey19b_interspeech	['indian institute of technology guwahati, guwahati, india', 'indian institute of technology dharwad, dharwad, india']
niu19_interspeech	['national laboratory of pattern recognition, casia, beijing, china', 'school of artificial intelligence, university of chinese academy of sciences, beijing, china', 'cas center for excellence in brain science and intelligence technology, beijing, china']
bn19_interspeech	['⋆ee department, indian institute of science, bengaluru 560012, india', '‡ee department, university of southern california, los angeles, ca 90089, usa', '⊙department of speech pathology and audiology, nimhans, bengaluru 560029, india', '∧department of neurology, nimhans, bengaluru 560029, india', '•ece department, indian institute of science, bengaluru 560012, india']
wang19r_interspeech	['tokyo institute of technology, japan', 'ntt communication science laboratories, japan', 'copyright © 2019 isca', 'interspeech 2019', 'september 15–19', ', graz, austria', 'http://dx.doi.org/10.21437/interspeech.2019-3242']
bahmaninezhad19_interspeech	"['university of texas at dallas, richardson tx, usa', ""northwestern polytechnical university, xi'an, china"", 'peking university shenzhen graduate school, shenzhen, china', 'tencent ai lab, shenzhen, china', 'tencent ai lab, bellevue wa, usa']"
inan19_interspeech	['lts2, ecole polytechnique federale de lausanne, lausanne, switzerland', 'logitech europe s.a., lausanne, switzerland', 'zurich university of applied sciences, zurich, switzerland']
ditter19_interspeech	['signal processing, universitat hamburg, germany']
zegers19_interspeech	['ku leuven, dept. esat, belgium']
bear19_interspeech	['school of electronic engineering and computer science, queen mary university of london, uk', 'institute for informatics, technical university munich, germany', 'the alan turing institute, uk']
fan19c_interspeech	['nlpr, institute of automation, chinese academy of sciences, beijing, china', 'cas center for excellence in brain science and intelligence technology, beijing, china', 'school of artificial intelligence, university of chinese academy of sciences, beijing, china']
yousefi19_interspeech	['center for robust speech systems(crss)', 'the university of texas at dallas, richardson, texas, usa']
shi19e_interspeech	['institute of automation, chinese academy of sciences (casia), beijing, china', 'university of chinese academy of sciences, china', 'center for excellence in brain science and intelligence technology, cas, china']
shi19f_interspeech	['fujitsu research and development center', 'fujitsu laboratories ltd.', 'harbin institute of technology']
lluis19_interspeech	['music technology group, universitat pompeu fabra, barcelona.']
foley19_interspeech	['the university of queensland, australia', 'arc centre of excellence for the dynamics of language (coedl), australia']
gruber19b_interspeech	['new technologies for the information society (ntis)', 'faculty of applied sciences, university of west bohemia, czech republic']
huang19k_interspeech	
dikici19_interspeech	['sail labs technology gmbh, austria']
goel19b_interspeech	['go-vivace inc., mclean, va, usa']
